noTrans,ArticleCode,Barcode,sizes,qty,basePrice,salePrice,DiscountType,discountPersen,discountRupiah,DiscExpenses,consignment,consignmentRp,subTotal,payment
01SCS19E010001,BSC.AR-QG0007,00ARQG0093,ALL,1,80000,225000,2,0,125000,1,0,20000,100000,80000
01SCS19E010001,BSC.AR-QG0010,00ARQG0099,ALL,1,80000,240000,2,0,140000,1,0,20000,100000,80000
01SCS19E010001,ESH.AR-QL0004,00ARQL0020,L,1,42000,135000,2,0,67500,1,0,13500,67500,54000
01SCS19E010001,ESH.AR-RE0004,00ARRE0013,S,1,42000,135000,2,0,67500,1,0,13500,67500,54000
01SCS19E010002,ESH.AR-RG0005,00ARRG0100,S,1,94500,135000,2,0,40500,1,0,18900,94500,75600
01SCS19E010003,BSC.AR-SB0007,00ARSB0074,S,1,44500,135000,2,0,40500,1,0,18900,94500,75600
01SCS19E010003,BSC.AR-SC0048,00ARSC0304,S,1,44500,159000,2,0,47700,1,0,22260,111300,89040
01SCS19E010003,ESH.AR-QE0029,00ARQE0161,S,1,110000,325000,2,0,165000,1,0,32000,160000,128000
01SCS19E010004,AR.ASH-RJ014,20ARRJ0499,30,1,292500,450000,2,0,225000,1,0,56250,225000,168750
01SCS19E010004,AR.TUC-SA028,20ARSA0163,ALL,1,100750,155000,2,0,31000,1,0,31000,124000,93000
01SCS19E010004,ESH.AR-RG0004,00ARRG0010,S,1,90000,255000,2,0,76500,1,0,35700,178500,142800
01SCS19E010004,ESH.AR-RL0015,00ARRL0129,S,1,94500,135000,2,0,40500,1,0,18900,94500,75600
01SCS19E010004,ESH.AR-SC0033,00ARSC0284,S,1,44000,135000,2,0,40500,1,0,18900,94500,75600
01SCS19E010005,AR.MKV-SC015,20ARSC0215,XL,1,204750,315000,2,0,63000,1,0,63000,252000,189000
01SCS19E010006,BSC.AR-SA0015,00ARSA0045,L,1,44500,135000,2,0,40500,1,0,18900,94500,75600
01SCS19E010007,BSC.AR-RJ0024,00ARRJ0134,XL,1,43000,135000,2,0,40500,1,0,18900,94500,75600
01SCS19E010008,ARN.AR-SB0001,00ARSB0086,NON,1,107400,179000,2,0,35800,1,0,42960,143200,100240
01SCS19E010009,AR.ESB-SC018,20ARSC0466,L,1,91000,140000,2,0,28000,1,0,28000,112000,84000
01SCS19E010010,AR.KNR-RK006,20ARRK0269,S,1,136500,210000,2,0,63000,1,0,36750,147000,110250
01SCS19E010011,ESH.AR-SC0034,00ARSC0294,L,1,125000,315000,2,0,94500,1,0,44100,220500,176400
01SCS19E010012,BSC.AR-RJ0032,00ARRJ0215,NON,1,18000,75000,2,0,22500,1,0,10500,52500,42000
01SCS19E010012,BSC.AR-SA0009,00ARSA0035,NON,1,47500,140000,2,0,42000,1,0,19600,98000,78400
01SCS19E010012,BSC.AR-SC0050,00ARSC0313,M,1,44000,159000,2,0,47700,1,0,22260,111300,89040
01SCS19E010012,ESH.AR-QG0007,00ARQG0098,ALL,1,70000,205000,2,0,105000,1,0,20000,100000,80000
01SCS19E010012,ESH.AR-QL0004,00ARQL0020,L,1,42000,135000,2,0,67500,1,0,13500,67500,54000
01SCS19E010012,ESH.AR-RE0005,00ARRE0019,L,1,42000,135000,2,0,67500,1,0,13500,67500,54000
01SCS19E010013,BSC.AR-RE0028,00ARRE0303,NON,1,35000,120000,2,0,36000,1,0,16800,84000,67200
01SCS19E010013,ESH.AR-RC0030,00ARRC0191,ALL,1,55000,150000,2,0,100000,1,0,10000,50000,40000
01SCS19E010014,AR.MER-RJ003,20ARRJ0537,ALL,1,120250,185000,2,0,55500,1,0,32375,129500,97125
01SCS19E010015,AR.CPT-RI003,20ARRI0049,M,1,204750,315000,2,0,63000,1,0,63000,252000,189000
01SCS19E010015,AR.CPT-RL003,20ARRL0080,L,1,94250,145000,2,0,29000,1,0,29000,116000,87000
01SCS19E010016,AR.CPT-SC014,20ARSC0488,M,1,94250,145000,2,0,29000,1,0,29000,116000,87000
01SCS19E010016,ESH.AR-RH0004,00ARRH0038,M,1,94500,135000,2,0,40500,1,0,18900,94500,75600
01SCS19E010017,BSC.AR-RK0007,00ARRK0075,L,1,108500,155000,2,0,46500,1,0,21700,108500,86800
01SCS19E010017,BSC.AR-SD0002,00ARSD0005,S,1,44000,159000,2,0,47700,1,0,22260,111300,89040
01SCS19E010017,ESH.AR-RH0017,00ARRH0097,L,1,94500,135000,2,0,40500,1,0,18900,94500,75600
01SCS19E010018,ESH.AR-SA0009,00ARSA0088,M,1,122500,350000,2,0,105000,1,0,49000,245000,196000
01SCS19E010019,BSC.AR-SD0012,00ARSD0105,NON,1,18000,75000,2,0,22500,1,0,10500,52500,42000
01SCS19E010020,BSC.AR-RI0005,00ARRI0016,L,1,94500,135000,2,0,40500,1,0,18900,94500,75600
01SCS19E010021,BSC.AR-RI0027,00ARRI0136,NON,1,43000,140000,2,0,42000,1,0,19600,98000,78400
01SCS19E010022,AR.STY-SC002,20ARSC0201,ALL,1,77350,119000,2,0,23800,1,0,23800,95200,71400
01SCS19E010022,ESH.AR-RJ0021,00ARRJ0213,L,1,245000,350000,2,0,105000,1,0,49000,245000,196000
01SCS19E010023,AR.STY-RK014,20ARRK0536,ALL,1,51350,79000,2,0,15800,1,0,15800,63200,47400
01SCS19E010023,BSC.AR-RJ0020,00ARRJ0115,S,1,44500,135000,2,0,40500,1,0,18900,94500,75600
01SCS19E010024,BSC.AR-RD0001,00ARRD0003,L,1,155,450000,2,0,275000,1,0,35000,175000,140000
01SCS19E010025,BSC.AR-RI0005,00ARRI0016,L,1,94500,135000,2,0,40500,1,0,18900,94500,75600
01SCS19E010026,BSC.AR-RI0016,00ARRI0060,L,1,43000,135000,2,0,40500,1,0,18900,94500,75600
01SCS19E010026,BSC.AR-SA0022,00ARSA0113,NON,1,47500,140000,2,0,42000,1,0,19600,98000,78400
01SCS19E010026,ESH.AR-RH0018,00ARRH0100,M,1,94500,135000,2,0,40500,1,0,18900,94500,75600
01SCS19E010027,BSC.AR-SC0034,00ARSC0228,S,1,125000,315000,2,0,94500,1,0,44100,220500 176400
01SCS19E010028,BSC.AR-RF0004,00ARRF0026,S,1,110000,315000,2,0,155000,1,0,32000,160000,128000
01SCS19E010029,AR.PUB-SD038,20ARSD0354,ALL,1,97500,150000,2,0,30000,1,0,30000,120000,90000
01SCS19E010029,AR.VCS-RI006,20ARRI0293,XL,1,243750,375000,2,0,112500,1,0,65625,262500,196875
01SCS19E010030,ESH.AR-QI0003,00ARQI0036,ALL,1,40000,140000,2,0,90000,1,0,10000,50000,40000
01SCS19E010031,ESH.AR-SD0004,00ARSD0045,S,1,44500,135000,2,0,40500,1,0,18900,94500,75600
01SCS19E010032,BSC.AR-SA0018,00ARSA0059,S,1,44000,135000,2,0,40500,1,0,18900,94500,75600
01SCS19E010032,ESH.AR-SC0010,00ARSC0081,M,1,44500,135000,2,0,40500,1,0,18900,94500,75600
01SCS19E010033,BSC.AR-RK0016,00ARRK0110,M,1,43000,135000,2,0,40500,1,0,18900,94500,75600
01SCS19E010034,BSC.AR-SC0035,00ARSC0233,M,1,125000,315000,2,0,94500,1,0,44100,220500,176400
01SCS19E010035,AR.MDS-RF005,20ARRF0092,L,1,357500,550000,2,0,110000,1,0,110000,440000,330000
01SCS19E010035,BSC.AR-PI0039,00ARPI0045,ALL,1,165000,495000,2,0,320000,1,0,35000,175000,140000
01SCS19E010036,AR.VLD-RK019,20ARRK0354,M,1,91000,140000,2,0,42000,1,0,24500,98000,73500
01SCS19E010037,ESH.AR-RL0012,00ARRL0125,NON,1,47000,130000,2,0,39000,1,0,18200,91000,72800
01SCS19E010038,AR.YD-SD005,20ARSD0274,S,1,91000,140000,2,0,42000,1,0,24500,98000,73500
01SCS19E010039,BSC.AR-RI0005,00ARRI0016,L,1,94500,135000,2,0,40500,1,0,18900,94500,75600
01SCS19E010039,BSC.AR-SA0021,00ARSA0106,M,1,44000,135000,2,0,40500,1,0,18900,94500,75600
01SCS19E010040,ESH.AR-SB0011,00ARSB0051,S,1,125000,315000,2,0,94500,1,0,44100,220500,176400
01SCS19E010041,AR.PUB-SB031,20ARSB0459,XL,1,97500,150000,2,0,30000,1,0,30000,120000,90000
01SCS19E010042,BSC.AR-RI0035,00ARRI0208,S,1,120000,315000,2,0,94500,1,0,44100,220500,176400
01SCS19E010043,BE.RAK-RK017,00BERK0047,ALL,1,87750,135000,2,0,27000,1,0,27000,108000,81000
01SCS19E010044,AR.CPT-RL002,20ARRL0076,L,1,94250,145000,2,0,29000,1,0,29000,116000,87000
01SCS19E010044,BSC.AR-SC0050,00ARSC0314,L,1,44000,159000,2,0,47700,1,0,22260,111300,89040
01SCS19E010045,AR.TUC-SA027,20ARSA0162,ALL,1,100750,155000,2,0,31000,1,0,31000,124000,93000
01SCS19E010046,ESH.AR-SA0006,00ARSA0071,S,1,44500,135000,2,0,40500,1,0,18900,94500,75600
01SCS19E010047,ESH.AR-RC0024,00ARRC0180,M,1,42000,135000,2,0,67500,1,0,13500,67500,54000
01SCS19E010047,ESH.AR-RE0020,00ARRE0210,L,1,42000,135000,2,0,67500,1,0,13500,67500,54000
01SCS19E010048,AR.TUC-SB014,20ARSB0203,S,1,94250,145000,2,0,29000,1,0,29000,116000,87000
01SCS19E010049,BSC.AR-RH0003,00ARRH0015,L,1,94500,135000,2,0,40500,1,0,18900,94500,75600
01SCS19E010049,BSC.AR-RL0019,00ARRL0115,L,1,125000,315000,2,0,94500,1,0,44100,220500,176400
01SCS19E010050,BSC.AR-SC0008,00ARSC0051,NON,1,73000,220000,2,0,66000,1,0,30800,154000,123200
01SCS19E010051,BSC.AR-SA0007,00ARSA0030,S,1,44500,135000,2,0,40500,1,0,18900,94500,75600
01SCS19E010052,AR.YD-RL008,20ARRL0024,ALL,1,87750,135000,2,0,67500,1,0,16875,67500,50625
01SCS19E010053,BSC.AR-SC0021,00ARSC0148,NON,1,73000,220000,2,0,66000,1,0,30800,154000,123200
01SCS19E010054,AR.PUB-SD013,20ARSD0123,ALL,1,97500,150000,2,0,30000,1,0,30000,120000,90000
01SCS19E010054,AR.TUC-SD016,20ARSD0482,M,1,94250,145000,2,0,29000,1,0,29000,116000,87000
01SCS19E010055,BSC.AR-RE0028,00ARRE0303,NON,1,35000,120000,2,0,36000,1,0,16800,84000,67200
01SCS19E010055,BSC.AR-RL0025,00ARRL0166,S,1,44000,135000,2,0,40500,1,0,18900,94500,75600
01SCS19E010056,BSC.AR-RE0027,00ARRE0302,NON,1,84000,120000,2,0,36000,1,0,16800,84000,67200
01SCS19E010057,AR.MPR-SB002,20ARSB0240,L,1,243750,375000,2,0,75000,1,0,75000,300000,225000
01SCS19E010058,BSC.AR-SB0008,00ARSB0079,M,1,44500,135000,2,0,40500,1,0,18900,94500,75600
01SCS19E010059,BSC.AR-RC0024,00ARRC0165,ALL,1,43000,185000,2,0,85000,1,0,20000,100000,80000
01SCS19E010060,AR.PUB-SD013,20ARSD0123,ALL,1,97500,150000,2,0,30000,1,0,30000,120000,90000
01SCS19E010060,ESH.AR-RC0036,00ARRC0212,L,1,42000,135000,2,0,67500,1,0,13500,67500,54000
01SCS19E010060,ESH.AR-RE0020,00ARRE0210,L,1,42000,135000,2,0,67500,1,0,13500,67500,54000
01SCS19E010061,AR.TUC-SD023,20ARSD0510,M,1,204750,315000,2,0,63000,1,0,63000,252000,189000
01SCS19E010062,AR.TUC-SC002,20ARSC0051,XL,1,204750,315000,2,0,63000,1,0,63000,252000,189000
01SCS19E010062,BSC.AR-RD0033,00ARRD0157,XL,1,42000,150000,2,0,82500,1,0,13500,67500,54000
01SCS19E010062,ESH.AR-QI0003,00ARQI0036,ALL,1,40000,140000,2,0,90000,1,0,10000,50000,40000
01SCS19E010062,ESH.AR-RB0014,00ARRB0080,L,1,47000,150000,2,0,82500,1,0,13500,67500,54000
01SCS19E010063,AR.PUB-SC011,20ARSC0298,L,1,97500,150000,2,0,30000,1,0,30000,120000,90000
01SCS19E010064,AR.ESB-RK001,20ARRK0224,M,1,201500,310000,2,0,62000,1,0,62000,248000,186000
01SCS19E010065,AR.ESB-SD005,20ARSD0113,M,1,91000,140000,2,0,28000,1,0,28000,112000,84000
01SCS19E010066,AR.ESB-SA001,20ARSA0205,L,1,87750,135000,2,0,27000,1,0,27000,108000,81000
01SCS19E010067,AR.MPR-SB017,20ARSB0299,M,1,230750,355000,2,0,71000,1,0,71000,284000,213000
01SCS19E010067,ESH.AR-RC0030,00ARRC0191,ALL,1,55000,150000,2,0,100000,1,0,10000,50000,40000
01SCS19E010068,AR.CLB-RE009,20ARRE1096,ALL,1,185250,285000,2,0,57000,1,0,57000,228000,171000
01SCS19E010068,BSC.AR-RD0001,00ARRD0003,L,1,155,450000,2,0,275000,1,0,35000,175000,140000
01SCS19E010069,AR.MKV-RL004,20ARRL0247,M,1,253500,390000,2,0,78000,1,0,78000,312000,234000
01SCS19E010070,BSC.AR-SD0011,00ARSD0104,NON,1,18000,75000,2,0,22500,1,0,10500,52500,42000
01SCS19E010071,AR.TUC-SA027,20ARSA0162,ALL,1,100750,155000,2,0,31000,1,0,31000,124000,93000
01SCS19E010071,BE.RAK-RX194,00BERX0485,40,1,130000,200000,2,0,40000,1,0,40000,160000,120000
01SCS19E010072,AR.CPT-SC009,20ARSC0274,L,1,94250,145000,2,0,29000,1,0,29000,116000,87000
01SCS19E010072,ESH.AR-RI0009,00ARRI0103,M,1,94500,135000,2,0,40500,1,0,18900,94500,75600
01SCS19E010073,AR.PUB-SB009,20ARSB0013,ALL,1,97500,150000,2,0,30000,1,0,30000,120000,90000
01SCS19E010073,AR.PUB-SD011,20ARSD0121,ALL,1,97500,150000,2,0,30000,1,0,30000,120000,90000
01SCS19E010073,AR.YAS-RL001,20ARRL0210,XL,1,317850,489000,2,0,97800,1,0,97800,391200,293400
01SCS19E010073,ESH.AR-QH0026,00ARQH0137,ALL,1,39700,140000,2,0,90000,1,0,10000,50000,40000
01SCS19E010074,THR.AR-QK0008,00ARRE0220,NON,1,415000,415000,2,0,41500,1,0,56025,373500,317475
01SCS19E010075,ESH.AR-SC0017,00ARSC0140,S,1,44000,135000,2,0,40500,1,0,18900,94500,75600
01SCS19E010076,ESH.AR-SC0014,00ARSC0110,L,1,44500,135000,2,0,40500,1,0,18900,94500,75600
01SCS19E010077,ESH.AR-SD0005,00ARSD0050,M,1,44000,135000,2,0,40500,1,0,18900,94500,75600
01SCS19E010078,AR.MPR-SB016,20ARSB0295,M,1,230750,355000,2,0,71000,1,0,71000,284000,213000
01SCS19E010079,AR.YAS-RL009,20ARRL0229,ALL,1,97500,150000,2,0,30000,1,0,30000,120000,90000
01SCS19E010079,ARN.AR-RK0005,00ARRK0235,30,1,110000,350000,2,0,70000,1,0,84000,280000,196000
01SCS19E010080,ESH.AR-RE0005,00ARRE0019,L,1,42000,135000,2,0,67500,1,0,13500,67500,54000
01SCS19E010080,ESH.AR-RE0020,00ARRE0210,L,1,42000,135000,2,0,67500,1,0,13500,67500,54000
01SCS19E010081,ESH.AR-SD0013,00ARSD0081,30,1,145000,375000,2,0,112500,1,0,52500,262500,210000
01SCS19E010082,ESH.AR-RA0015,00ARRA0072,ALL,1,38000,140000,2,0,90000,1,0,10000,50000,40000
01SCS19E010083,ESH.AR-SC0019,00ARSC0150,M,1,125000,315000,2,0,94500,1,0,44100,220500,176400
01SCS19E010084,BSC.AR-RJ0008,00ARRJ0068,M,1,94500,135000,2,0,40500,1,0,18900,94500,75600
01SCS19E010085,ESH.AR-SC0005,00ARSC0028,L,1,125000,315000,2,0,94500,1,0,44100,220500,176400
01SCS19E010086,AR.YD-SB005,20ARSB0508,S,1,195000,300000,2,0,90000,1,0,52500,210000,157500
01SCS19E010086,BSC.AR-RJ0032,00ARRJ0215,NON,1,18000,75000,2,0,22500,1,0,10500,52500,42000
01SCS19E010086,BSC.AR-RK0024,00ARRK0216,NON,1,157500,225000,2,0,67500,1,0,31500,157500,126000
01SCS19E010087,BSC.AR-RJ0030,00ARRJ0197,S,1,120000,315000,2,0,94500,1,0,44100,220500,176400
01SCS19E010088,AR.TUC-RK008,20ARRK0104,ALL,1,87750,135000,2,0,27000,1,0,27000,108000,81000
01SCS19E010088,BSC.AR-RL0020,00ARRL0119,L,1,125000,315000,2,0,94500,1,0,44100,220500,176400
01SCS19E010089,BSC.AR-PI0025,00ARPI0025,ALL,1,43334,130000,2,0,80000,1,0,10000,50000,40000
01SCS19E010090,ESH.AR-RF0004,00ARRF0031,M,1,110000,315000,2,0,155000,1,0,32000,160000,128000
01SCS19E010091,ESH.AR-QK0001,00ARQK0003,L,1,90000,310000,2,0,150000,1,0,32000,160000,128000
01SCS19E010092,AR.ASH-SD005,20ARSD0397,S,1,243750,375000,2,0,112500,1,0,65625,262500,196875
01SCS19E010092,AR.ESB-RE021,20ARRE0397,M,1,91000,140000,2,0,70000,1,0,17500,70000,52500
01SCS19E010092,AR.TUC-RE037,20ARRE1185,L,1,87750,135000,2,0,67500,1,0,16875,67500,50625
01SCS19E010093,ESH.AR-RD0021,00ARRD0193,L,1,42000,135000,2,0,67500,1,0,13500,67500,54000
01SCS19E010093,ESH.AR-RE0020,00ARRE0210,L,1,42000,135000,2,0,67500,1,0,13500,67500,54000
01SCS19E010094,BSC.AR-SB0010,00ARSB0094,L,1,125000,315000,2,0,94500,1,0,44100,220500,176400
01SCS19E010094,BSC.AR-SD0010,00ARSD0103,NON,1,18000,75000,2,0,22500,1,0,10500,52500,42000
01SCS19E010094,BSC.AR-SD0024,00ARSD0147,NON,1,89000,225000,2,0,67500,1,0,31500,157500,126000
01SCS19E010095,BSC.AR-SC0008,00ARSC0051,NON,1,73000,220000,2,0,66000,1,0,30800,154000,123200
01SCS19E010095,BSC.AR-SC0029,00ARSC0199,S,1,125000,315000,2,0,94500,1,0,44100,220500,176400
01SCS19E010095,BSC.AR-SC0050,00ARSC0313,M,1,44000,159000,2,0,47700,1,0,22260,111300,89040
01SCS19E010096,ESH.AR-RC0026,00ARRC0187,ALL,1,55000,150000,2,0,100000,1,0,10000,50000,40000
01SCS19E010097,ESH.AR-RD0018,00ARRD0185,NON,1,55000,150000,2,0,100000,1,0,10000,50000,40000
01SCS19E010098,AR.ESB-QF012,20ARQF0039,M,1,91000,140000,2,0,70000,1,0,17500,70000,52500
01SCS19E010098,AR.YD-RL002,20ARRL0018,ALL,1,91000,140000,2,0,70000,1,0,17500,70000,52500
01SCS19E010098,AR.YD-SD001,20ARSD0262,M,1,87750,135000,2,0,67500,1,0,16875,67500,50625
01SCS19E010099,BSC.AR-SC0010,00ARSC0056,S,1,125000,315000,2,0,94500,1,0,44100,220500,176400
01SCS19E010100,AR.MKV-RL002,20ARRL0239,S,1,204750,315000,2,0,63000,1,0,63000,252000,189000
01SCS19E010101,AR.TUC-SC006,20ARSC0064,28,1,204750,315000,2,0,63000,1,0,63000,252000,189000
01SCS19E010102,BSC.AR-SB0005,00ARSB0061,NON,1,47500,140000,2,0,42000,1,0,19600,98000,78400
01SCS19E010103,AR.PUB-RJ012,20ARRJ0033,32,1,211250,325000,2,0,65000,1,0,65000,260000,195000
01SCS19E010104,BSC.AR-SB0016,00ARSB0131,S,1,44500,135000,2,0,40500,1,0,18900,94500,75600
01SCS19E010105,ESH.AR-RC0029,00ARRC0190,ALL,1,45000,150000,2,0,100000,1,0,10000,50000,40000
01SCS19E010106,AR.HMR-SB023,20ARSB0407,32,1,204750,315000,2,0,63000,1,0,63000,252000,189000
01SCS19E010106,AR.MKV-SD012,20ARSD0423,32,1,204750,315000,2,0,157500,1,0,39375,157500,118125
01SCS19E010106,BSC.AR-RH0020,00ARRH0116,M,1,108500,155000,2,0,46500,1,0,21700,108500,86800
01SCS19E010106,BSC.AR-RL0020,00ARRL0117,S,1,125000,315000,2,0,94500,1,0,44100,220500,176400
01SCS19E010107,BE.RAK-SA022,00BESA0088,L,1,91000,140000,2,0,28000,1,0,28000,112000,84000
01SCS19E010108,BSC.AR-SC0021,00ARSC0148,NON,1,73000,220000,2,0,66000,1,0,30800,154000,123200
01SCS19E010109,AR.PUB-RJ016,20ARRJ0233,S,1,97500,150000,2,0,30000,1,0,30000,120000,90000
01SCS19E010110,ESH.AR-RL0018,00ARRL0146,30,1,122500,175000,2,0,52500,1,0,24500,122500,98000
01SCS19E010110,ESH.AR-SA0016,00ARSA0115,NON,1,55000,150000,2,0,45000,1,0,21000,105000,84000
01SCS19E010111,AR.ESB-SB003,20ARSB0101,M,1,100750,155000,2,0,31000,1,0,31000,124000,93000
01SCS19E010112,BE.RAK-RL031,00BERL0111,M,1,259350,399000,2,0,79800,1,0,79800,319200,239400
01SCS19E010113,BSC.AR-RK0025,00ARRK0217,NON,1,75000,225000,2,0,67500,1,0,31500,157500,126000
01SCS19E010114,AR.TUC-SD014,20ARSD0474,M,1,94250,145000,2,0,29000,1,0,29000,116000,87000
01SCS19E010115,AR.HMR-SD007,20ARSD0544,S,1,243750,375000,2,0,75000,1,0,75000,300000,225000
01SCS19E010115,AR.HMR-SD007,20ARSD0546,L,1,243750,375000,2,0,75000,1,0,75000,300000,225000
01SCS19E010115,AR.YRX-RH001,20ARRH0718,ALL,1,172250,265000,2,0,53000,1,0,53000,212000,159000
01SCS19E010116,BSC.AR-SC0013,00ARSC0093,M,1,44000,135000,2,0,40500,1,0,18900,94500,75600
01SCS19E010117,AR.ESB-SB005,20ARSB0108,S,1,91000,140000,2,0,28000,1,0,28000,112000,84000
01SCS19E010117,AR.PUB-SC017,20ARSC0369,M,1,204750,315000,2,0,63000,1,0,63000,252000,189000
01SCS19E010117,AR.VLD-SA007,20ARSA0185,ALL,1,120250,185000,2,0,55500,1,0,32375,129500,97125
01SCS19E010118,AR.STY-RJ003,20ARRJ0052,ALL,1,55250,85000,2,0,17000,1,0,17000,68000,51000
01SCS19E010119,BSC.AR-SC0029,00ARSC0199,S,1,125000,315000,2,0,94500,1,0,44100,220500,176400
01SCS19E010120,BSC.AR-PI0025,00ARPI0025,ALL,1,43334,130000,2,0,80000,1,0,10000,50000,40000
01SCS19E010121,AR.PUB-RI008,20ARRI0121,S,2,191750,295000,2,0,59000,1,0,59000,472000,354000
01SCS19E010122,BSC.AR-RK0023,00ARRK0212,M,1,120000,315000,2,0,94500,1,0,44100,220500,176400
01SCS19E010123,AR.YD-SC001,20ARSC0018,M,1,195000,300000,2,0,90000,1,0,52500,210000,157500
01SCS19E010124,BSC.AR-RD0021,00ARRD0108,L,1,42000,135000,2,0,67500,1,0,13500,67500,54000
01SCS19E010124,ESH.AR-RE0004,00ARRE0013,S,1,42000,135000,2,0,67500,1,0,13500,67500,54000
01SCS19E010125,AR.CPT-RE010,20ARRE0706,M,1,204750,315000,2,0,63000,1,0,63000,252000,189000
01SCS19E010125,AR.TUC-SD003,20ARSD0148,S,1,204750,315000,2,0,63000,1,0,63000,252000,189000
01SCS19E010126,ESH.AR-RC0005,00ARRC0066,M,1,95000,310000,2,0,150000,1,0,32000,160000,128000
01SCS19E010127,BSC.AR-QE0012,00ARQE0097,XL,1,125000,375000,2,0,200000,1,0,35000,175000,140000
01SCS19E010128,ESH.AR-RB0030,00ARRB0163,32,1,130000,350000,2,0,175000,1,0,35000,175000,140000
01SCS19E010129,AR.ESB-SB004,20ARSB0105,M,1,91000,140000,2,0,28000,1,0,28000,112000,84000
01SCS19E010129,AR.TUC-SC006,20ARSC0065,30,1,204750,315000,2,0,63000,1,0,63000,252000,189000
01SCS19E010130,AR.PUB-RI016,20ARRI0258,M,1,97500,150000,2,0,30000,1,0,30000,120000,90000
01SCS19E010131,AR.BPH-RK005,20ARRK0055,M,1,103350,159000,2,0,47700,1,0,27825,111300,83475
01SCS19E010131,AR.CLK-RH002,20ARRH0737,ALL,1,91000,140000,2,0,28000,1,0,28000,112000,84000
01SCS19E010131,AR.SMD-SA002,20ARSA0225,L,1,87750,135000,2,0,27000,1,0,27000,108000,81000
01SCS19E010132,AR.MER-SB003,20ARSB0219,M,1,97500,150000,2,0,45000,1,0,26250,105000,78750
01SCS19E010132,AR.PUB-RH007,20ARRH0014,M,1,97500,150000,2,0,30000,1,0,30000,120000,90000
01SCS19E010132,AR.TUC-SB023,20ARSB0487,ALL,1,87750,135000,2,0,27000,1,0,27000,108000,81000
01SCS19E010133,AR.MKV-SB013,20ARSB0549,L,1,172250,265000,2,0,53000,1,0,53000,212000,159000
01SCS19E010134,BSC.AR-RK0022,00ARRK0210,XL,1,120000,315000,2,0,94500,1,0,44100,220500,176400
01SCS19E010135,BSC.AR-RH0024,00ARRH0157,L,1,245000,350000,2,0,105000,1,0,49000,245000,196000
01SCS19E010136,AR.VCS-SC003,20ARSC0380,S,1,97500,150000,2,0,45000,1,0,26250,105000,78750
01SCS19E010137,AR.VCS-RL005,20ARRL0309,L,1,97500,150000,2,0,45000,1,0,26250,105000,78750
01SCS19E010138,AR.MKV-SC005,20ARSC0083,M,1,253500,390000,2,0,78000,1,0,78000,312000,234000
01SCS19E010139,AR.MKV-SC003,20ARSC0077,ALL,1,87750,135000,2,0,27000,1,0,27000,108000,81000
01SCS19E010140,AR.TUC-RI009,20ARRI0360,L,1,87750,135000,2,0,27000,1,0,27000,108000,81000
01SCS19E010140,ESH.AR-QH0026,00ARQH0137,ALL,1,39700,140000,2,0,90000,1,0,10000,50000,40000
01SCS19E010140,ESH.AR-SB0030,00ARSB0201,M,1,44000,135000,2,0,40500,1,0,18900,94500,75600
01SCS19E010141,AR.ASH-RE009,20ARRE1374,32,1,273000,420000,2,0,210000,1,0,52500,210000,157500
01SCS19E010142,BSC.AR-RH0017,00ARRH0075,M,1,120000,315000,2,0,94500,1,0,44100,220500,176400
01SCS19E010143,AR.RDC-RK008,20ARRK0483,M,1,97500,150000,2,0,30000,1,0,30000,120000,90000
01SCS19E010144,ESH.AR-QL0004,00ARQL0020,L,1,42000,135000,2,0,67500,1,0,13500,67500,54000
01SCS19E010144,ESH.AR-RD0021,00ARRD0193,L,1,42000,135000,2,0,67500,1,0,13500,67500,54000
01SCS19E010145,ESH.AR-SB0016,00ARSB0068,L,1,125000,315000,2,0,94500,1,0,44100,220500,176400
01SCS19E010146,AR.MKV-SC019,20ARSC0224,ALL,1,91000,140000,2,0,70000,1,0,17500,70000,52500
01SCS19E010147,BSC.AR-RI0033,00ARRI0155,L,1,120000,315000,2,0,94500,1,0,44100,220500,176400
01SCS19E010148,AR.MKV-RJ008,20ARRJ0177,L,1,91000,140000,2,0,28000,1,0,28000,112000,84000
01SCS19E010148,AR.TUC-SB013,20ARSB0201,L,1,94250,145000,2,0,29000,1,0,29000,116000,87000
01SCS19E010149,ESH.AR-RA0017,00ARRA0074,ALL,1,40000,140000,2,0,90000,1,0,10000,50000,40000
01SCS19E010150,ESH.AR-SC0024,00ARSC0211,S,1,119000,350000,2,0,105000,1,0,49000,245000,196000
01SCS19E010151,BSC.AR-SD0018,00ARSD0123,NON,1,45000,150000,2,0,45000,1,0,21000,105000,84000
01SCS19E010152,BSC.AR-SC0007,00ARSC0045,XL,1,44000,135000,2,0,40500,1,0,18900,94500,75600
01SCS19E010152,BSC.AR-SC0050,00ARSC0315,XL,1,44000,159000,2,0,47700,1,0,22260,111300,89040
01SCS19E010153,BSC.AR-SA0008,00ARSA0034,NON,1,47500,140000,2,0,42000,1,0,19600,98000,78400
01SCS19E010154,ESH.AR-RA0015,00ARRA0072,ALL,1,38000,140000,2,0,90000,1,0,10000,50000,40000
01SCS19E010154,ESH.AR-SC0027,00ARSC0262,M,1,125000,315000,2,0,94500,1,0,44100,220500,176400
01SCS19E010155,BSC.AR-SC0025,00ARSC0184,XL,1,125000,315000,2,0,94500,1,0,44100,220500,176400
01SCS19E010156,ESH.AR-RD0020,00ARRD0189,L,1,43000,150000,2,0,82500,1,0,13500,67500,54000
01SCS19E010156,ESH.AR-RE0004,00ARRE0013,S,1,42000,135000,2,0,67500,1,0,13500,67500,54000
01SCS19E010157,AR.HMR-SD001,20ARSD0527,M,1,273000,420000,2,0,84000,1,0,84000,336000,252000
01SCS19E010158,AR.VCS-RI007,20ARRI0295,M,1,243750,375000,2,0,112500,1,0,65625,262500,196875
01SCS19E010158,AR.YAS-RL001,20ARRL0210,XL,1,317850,489000,2,0,97800,1,0,97800,391200,293400
01SCS19E010158,BSC.AR-RI0037,00ARRI0213,NON,1,273000,390000,2,0,117000,1,0,54600,273000,218400
01SCS19E010159,BSC.AR-SC0026,00ARSC0186,M,1,106400,350000,2,0,105000,1,0,49000,245000,196000
01SCS19E010160,BSC.AR-RD0021,00ARRD0108,L,1,42000,135000,2,0,67500,1,0,13500,67500,54000
01SCS19E010160,ESH.AR-RC0039,00ARRC0224,L,1,42000,135000,2,0,67500,1,0,13500,67500,54000
01SCS19E010161,ESH.AR-SA0017,00ARSA0116,S,1,122500,350000,2,0,105000,1,0,49000,245000,196000
01SCS19E010162,ESH.AR-SB0034,00ARSB0217,M,1,125000,315000,2,0,94500,1,0,44100,220500,176400
01SCS19E010163,ESH.AR-SA0005,00ARSA0068,M,1,44000,135000,2,0,40500,1,0,18900,94500,75600
01SCS19E010164,ESH.AR-RA0017,00ARRA0074,ALL,1,40000,140000,2,0,90000,1,0,10000,50000,40000
01SCS19E010165,BSC.AR-RD0001,00ARRD0003,L,1,155,450000,2,0,275000,1,0,35000,175000,140000
01SCS19E010166,ESH.AR-PL0018,00ARPL0137,S,1,110000,325000,2,0,165000,1,0,32000,160000,128000
01SCS19E010167,AR.CPT-SB001,20ARSB0084,L,1,204750,315000,2,0,63000,1,0,63000,252000,189000
01SCS19E010168,AR.PCT-RJ005,20ARRJ0286,ALL,1,178750,275000,2,0,55000,1,0,55000,220000,165000
01SCS19E010168,AR.PUB-RG024,20ARRG0128,ALL,1,97500,150000,2,0,30000,1,0,30000,120000,90000
01SCS19E010169,BSC.AR-SD0024,00ARSD0147,NON,1,89000,225000,2,0,67500,1,0,31500,157500,126000
01SCS19E010170,AR.MKV-RL001,20ARRL0236,M,1,204750,315000,2,0,63000,1,0,63000,252000,189000
01SCS19E010171,BE.RAK-RL020,00BERL0062,M,1,211250,325000,2,0,65000,1,0,65000,260000,195000
01SCS19E010172,BSC.AR-RD0021,00ARRD0108,L,1,42000,135000,2,0,67500,1,0,13500,67500,54000
01SCS19E010172,ESH.AR-RE0008,00ARRE0031,L,1,42000,135000,2,0,67500,1,0,13500,67500,54000
01SCS19E010173,ESH.AR-RC0040,00ARRC0228,L,1,42000,135000,2,0,67500,1,0,13500,67500,54000
01SCS19E010173,ESH.AR-RE0019,00ARRE0206,L,1,43000,150000,2,0,82500,1,0,13500,67500,54000
01SCS19E010174,ESH.AR-SA0015,00ARSA0109,S,1,122500,350000,2,0,105000,1,0,49000,245000,196000
01SCS19E010175,AR.BPH-RH033,20ARRH0811,L,1,220350,339000,2,0,169500,1,0,42375,169500,127125
01SCS19E010176,AR.VRS-SB002,20ARSB0183,32,1,324350,499000,2,0,149700,1,0,87325,349300,261975
01SCS19E010177,BSC.AR-RF0007,00ARRF0092,XL,1,110000,315000,2,0,155000,1,0,32000,160000,128000
01SCS19E010177,BSC.AR-SD0018,00ARSD0123,NON,1,45000,150000,2,0,45000,1,0,21000,105000,84000
01SCS19E010178,ESH.AR-RJ0005,00ARRJ0028,M,1,94500,135000,2,0,40500,1,0,18900,94500,75600
01SCS19E010178,ESH.AR-SD0009,00ARSD0066,M,1,44500,135000,2,0,40500,1,0,18900,94500,75600
01SCS19E010179,AR.PUB-SD008,20ARSD0094,ALL,1,97500,150000,2,0,30000,1,0,30000,120000,90000
01SCS19E010180,AR.MKV-SA006,20ARSA0197,32,1,243750,375000,2,0,75000,1,0,75000,300000,225000
01SCS19E010180,AR.TUC-SD021,20ARSD0503,L,1,94250,145000,2,0,29000,1,0,29000,116000,87000
01SCS19E010181,ESH.AR-SB0002,00ARSB0002,NON,1,40000,115000,2,0,34500,1,0,16100,80500,64400
01SCS19E010182,BSC.AR-PI0018,00ARPI0018,ALL,1,58334,175000,2,0,75000,1,0,20000,100000,80000
01SCS19E010183,BSC.AR-RL0018,00ARRL0110,M,1,125000,315000,2,0,94500,1,0,44100,220500,176400
01SCS19E010184,ESH.AR-SB0001,00ARSB0001,NON,1,40000,115000,2,0,34500,1,0,16100,80500,64400
01SCS19E010185,AR.CPT-RI004,20ARRI0052,S,1,94250,145000,2,0,29000,1,0,29000,116000,87000
01SCS19E010185,ESH.AR-SC0032,00ARSC0280,S,1,44500,135000,2,0,40500,1,0,18900,94500,75600
01SCS19E010186,BSC.AR-RK0022,00ARRK0209,L,1,120000,315000,2,0,94500,1,0,44100,220500,176400
01SCS19E010187,BSC.AR-SB0003,00ARSB0044,M,1,125000,315000,2,0,94500,1,0,44100,220500,176400
01SCS19E010188,AR.YD-RL002,20ARRL0018,ALL,1,91000,140000,2,0,70000,1,0,17500,70000,52500
01SCS19E010189,ESH.AR-SB0033,00ARSB0212,S,1,44500,135000,2,0,40500,1,0,18900,94500,75600
01SCS19E010190,AR.MKV-RB023,20ARRB0110,ALL,1,91000,140000,2,0,70000,1,0,17500,70000,52500
01SCS19E010191,BSC.AR-SB0010,00ARSB0095,XL,1,125000,315000,2,0,94500,1,0,44100,220500,176400
01SCS19E010192,AR.CPT-RL014,20ARRL0311,ALL,1,94250,145000,2,0,29000,1,0,29000,116000,87000
01SCS19E010192,ESH.AR-SB0033,00ARSB0214,L,1,44500,135000,2,0,40500,1,0,18900,94500,75600
01SCS19E010193,AR.ESB-SC001,20ARSC0305,M,1,204750,315000,2,0,63000,1,0,63000,252000,189000
01SCS19E010193,AR.YD-RL002,20ARRL0018,ALL,1,91000,140000,2,0,70000,1,0,17500,70000,52500
01SCS19E010194,AR.MKV-SC005,20ARSC0085,XL,1,253500,390000,2,0,78000,1,0,78000,312000,234000
01SCS19E010195,BSC.AR-SC0013,00ARSC0093,M,1,44000,135000,2,0,40500,1,0,18900,94500,75600
01SCS19E010196,AR.CPT-RL016,20ARRL0313,ALL,1,94250,145000,2,0,29000,1,0,29000,116000,87000
01SCS19E010197,AR.ASH-SD005,20ARSD0398,M,1,243750,375000,2,0,112500,1,0,65625,262500,196875
01SCS19E010198,ESH.AR-SC0006,00ARSC0046,S,1,125000,350000,2,0,105000,1,0,49000,245000,196000
01SCS19E010199,AR.SMD-QD005,20ARQD0100,M,1,84500,130000,2,0,39000,1,0,22750,91000,68250
01SCS19E010200,ESH.AR-PK0043,00ARPK0199,M,1,110000,325000,2,0,165000,1,0,32000,160000,128000
01SCS19E010201,AR.PUB-SC017,20ARSC0369,M,1,204750,315000,2,0,63000,1,0,63000,252000,189000
01SCS19E010201,BSC.AR-RK0023,00ARRK0212,M,1,120000,315000,2,0,94500,1,0,44100,220500,176400
01SCS19E010202,AR.CPT-SD006,20ARSD0433,S,1,200850,309000,2,0,61800,1,0,61800,247200,185400
01SCS19E010202,BSC.AR-SD0012,00ARSD0105,NON,1,18000,75000,2,0,22500,1,0,10500,52500,42000
01SCS19E010203,AR.STY-SC007,20ARSC0206,ALL,1,77350,119000,2,0,23800,1,0,23800,95200,71400
01SCS19E010203,AR.STY-SC008,20ARSC0207,ALL,1,77350,119000,2,0,23800,1,0,23800,95200,71400
01SCS19E010204,ESH.AR-SC0027,00ARSC0262,M,1,125000,315000,2,0,94500,1,0,44100,220500,176400
01SCS19E010205,ESH.AR-RI0016,00ARRI0144,NON,1,65000,185000,2,0,55500,1,0,25900,129500,103600
01SCS19E010205,ESH.AR-RI0017,00ARRI0145,NON,1,129500,185000,2,0,55500,1,0,25900,129500,103600
01SCS19E010206,ESH.AR-QH0026,00ARQH0137,ALL,1,39700,140000,2,0,90000,1,0,10000,50000,40000
01SCS19E010207,AR.MDS-RF005,20ARRF0092,L,1,357500,550000,2,0,110000,1,0,110000,440000,330000
01SCS19E010207,AR.SMD-QE001,20ARQE0002,M,1,87750,135000,2,0,40500,1,0,23625,94500,70875
01SCS19E010207,AR.SMD-SD013,20ARSD0572,XL,1,87750,135000,2,0,27000,1,0,27000,108000,81000
01SCS19E010207,ESH.AR-QH0019,00ARQH0124,36,1,125000,350000,2,0,175000,1,0,35000,175000,140000
01SCS19E010208,BSC.AR-PI0039,00ARPI0045,ALL,1,165000,495000,2,0,320000,1,0,35000,175000,140000
01SCS19E010209,ESH.AR-QK0011,00ARQK0069,34,1,130000,375000,2,0,200000,1,0,35000,175000,140000
01SCS19E010210,BSC.AR-SD0012,00ARSD0105,NON,1,18000,75000,2,0,22500,1,0,10500,52500,42000
01SCS19E010211,AR.ESB-SB003,20ARSB0101,M,1,100750,155000,2,0,31000,1,0,31000,124000,93000
01SCS19E010212,ESH.AR-SC0019,00ARSC0149,S,1,125000,315000,2,0,94500,1,0,44100,220500,176400
01SCS19E010213,BSC.AR-RJ0013,00ARRJ0087,S,1,44500,135000,2,0,40500,1,0,18900,94500,75600
01SCS19E010214,AR.MKV-RJ029,20ARRJ0443,M,1,165750,255000,2,0,51000,1,0,51000,204000,153000
01SCS19E010215,AR.TUC-SD020,20ARSD0499,L,1,94250,145000,2,0,29000,1,0,29000,116000,87000
01SCS19E010216,BSC.AR-RL0019,00ARRL0114,M,1,125000,315000,2,0,94500,1,0,44100,220500,176400
01SCS19E010217,ESH.AR-RD0024,00ARRD0228,M,1,145000,435000,2,0,260000,1,0,35000,175000,140000
01SCS19E010218,AR.TUC-SD025,20ARSD0518,30,1,211250,325000,2,0,65000,1,0,65000,260000,195000
01SCS19E010219,AR.MKV-RJ018,20ARRJ0201,ALL,1,107250,165000,2,0,33000,1,0,33000,132000,99000
01SCS19E010220,AR.ESB-SB003,20ARSB0101,M,1,100750,155000,2,0,31000,1,0,31000,124000,93000
01SCS19E010221,AR.MKV-QH011,20ARQH0216,ALL,1,175500,270000,2,0,135000,1,0,33750,135000,101250
01SCS19E010222,AR.PUB-SD031,20ARSD0214,30,1,211250,325000,2,0,65000,1,0,65000,260000,195000
01SCS19E010222,AR.REC-SD003,20ARSD0010,M,1,120250,185000,2,0,55500,1,0,32375,129500,97125
01SCS19E010222,BSC.AR-SB0019,00ARSB0164,M,1,125000,315000,2,0,94500,1,0,44100,220500,176400
01SCS19E010223,AR.STY-RK010,20ARRK0532,ALL,1,61750,95000,2,0,19000,1,0,19000,76000,57000
01SCS19E010224,AR.PUB-SD011,20ARSD0121,ALL,1,97500,150000,2,0,30000,1,0,30000,120000,90000
01SCS19E010225,BSC.AR-SC0046,00ARSC0298,NON,1,45000,150000,2,0,45000,1,0,21000,105000,84000
01SCS19E010225,ESH.AR-SC0002,00ARSC0007,L,1,44500,135000,2,0,40500,1,0,18900,94500,75600
01SCS19E010226,AR.PUB-SD035,20ARSD0345,M,1,204750,315000,2,0,63000,1,0,63000,252000,189000
01SCS19E010227,AR.CPT-RL019,20ARRL0387,L,1,94250,145000,2,0,29000,1,0,29000,116000,87000
01SCS19E010227,AR.TUC-SA028,20ARSA0163,ALL,1,100750,155000,2,0,31000,1,0,31000,124000,93000
01SCS19E010228,AR.PUB-SB004,20ARSB0008,ALL,1,97500,150000,2,0,30000,1,0,30000,120000,90000
01SCS19E010229,ARN.AR-SB0002,00ARSB0087,NON,1,149400,249000,2,0,49800,1,0,59760,199200,139440
01SCS19E010230,ESH.AR-RC0024,00ARRC0180,M,1,42000,135000,2,0,67500,1,0,13500,67500,54000
01SCS19E010230,ESH.AR-RD0020,00ARRD0188,M,1,43000,150000,2,0,82500,1,0,13500,67500,54000
01SCS19E010231,AR.HLW-SA020,20ARSA0125,28,1,243750,375000,2,0,112500,1,0,65625,262500,196875
01SCS19E010232,BSC.AR-RC0039,00ARRC0290,XL,1,155000,450000,2,0,275000,1,0,35000,175000,140000
01SCS19E010233,BSC.AR-RJ0020,00ARRJ0115,S,1,44500,135000,2,0,40500,1,0,18900,94500,75600
01SCS19E010233,ESH.AR-SB0031,00ARSB0206,L,1,44500,135000,2,0,40500,1,0,18900,94500,75600
01SCS19E010234,AR.PUB-SD017,20ARSD0136,XL,1,204750,315000,2,0,63000,1,0,63000,252000,189000
01SCS19E010235,AR.PUB-SD030,20ARSD0208,28,1,211250,325000,2,0,65000,1,0,65000,260000,195000
01SCS19E010236,AR.CPT-RL016,20ARRL0313,ALL,1,94250,145000,2,0,29000,1,0,29000,116000,87000
01SCS19E010236,BSC.AR-QJ0014,00ARQJ0114,L,1,100000,310000,2,0,150000,1,0,32000,160000,128000
01SCS19E010237,AR.PUB-SB035,20ARSB0466,ALL,1,81250,125000,2,0,25000,1,0,25000,100000,75000
01SCS19E010238,BSC.AR-SA0011,00ARSA0037,NON,1,42000,140000,2,0,42000,1,0,19600,98000,78400
01SCS19E010239,BSC.AR-SA0001,00ARSA0001,S,1,220500,315000,2,0,94500,1,0,44100,220500,176400
01SCS19E010240,AR.FHL-SC002,20ARSC0331,M,1,91000,140000,2,0,28000,1,0,28000,112000,84000
01SCS19E010241,AR.MPR-SB005,20ARSB0252,L,1,230750,355000,2,0,71000,1,0,71000,284000,213000
01SCS19E010242,AR.MKV-RJ023,20ARRJ0217,ALL,1,97500,150000,2,0,30000,1,0,30000,120000,90000
01SCS19E010242,ESH.AR-RL0012,00ARRL0125,NON,1,47000,130000,2,0,39000,1,0,18200,91000,72800
01SCS19E010243,BSC.AR-SC0010,00ARSC0057,M,1,125000,315000,2,0,94500,1,0,44100,220500,176400
01SCS19E010243,BSC.AR-SC0045,00ARSC0297,NON,1,45000,150000,2,0,45000,1,0,21000,105000,84000
01SCS19E010244,BSC.AR-SC0014,00ARSC0098,L,1,44000,159000,2,0,47700,1,0,22260,111300,89040
01SCS19E010245,AR.SMD-SA002,20ARSA0225,L,1,87750,135000,2,0,27000,1,0,27000,108000,81000
01SCS19E010245,AR.TUC-SD018,20ARSD0490,M,1,94250,145000,2,0,29000,1,0,29000,116000,87000
01SCS19E010246,AR.ASH-RJ013,20ARSD0388,XL,1,94250,145000,2,0,43500,1,0,25375,101500,76125
01SCS19E010246,AR.SMD-RH008,20ARRH0756,L,1,87750,135000,2,0,40500,1,0,23625,94500,70875
01SCS19E010247,BSC.AR-SC0021,00ARSC0148,NON,1,73000,220000,2,0,66000,1,0,30800,154000,123200
01SCS19E010248,AR.PUB-SD033,20ARSD0244,L,1,204750,315000,2,0,63000,1,0,63000,252000,189000
01SCS19E010249,BSC.AR-SA0005,00ARSA0023,M,1,94500,135000,2,0,40500,1,0,18900,94500,75600
01SCS19E010249,BSC.AR-SA0018,00ARSA0060,M,1,44000,135000,2,0,40500,1,0,18900,94500,75600
01SCS19E010249,ESH.AR-RI0001,00ARRI0071,M,1,94500,135000,2,0,40500,1,0,18900,94500,75600
01SCS19E010250,AR.ESB-SD015,20ARSD0334,M,1,91000,140000,2,0,28000,1,0,28000,112000,84000
01SCS19E010250,AR.SMD-RH004,20ARRH0416,M,1,87750,135000,2,0,40500,1,0,23625,94500,70875
01SCS19E010251,ESH.AR-SC0011,00ARSC0084,S,1,44000,135000,2,0,40500,1,0,18900,94500,75600
01SCS19E010252,ESH.AR-SC0014,00ARSC0110,L,1,44500,135000,2,0,40500,1,0,18900,94500,75600
01SCS19E010253,AR.MDG-SC001,20ARSC0152,M,1,94250,145000,2,0,43500,1,0,25375,101500,76125
01SCS19E010254,AR.PCT-QE002,20ARQE0011,M,1,78000,120000,2,0,60000,1,0,15000,60000,45000
01SCS19E010254,ESH.AR-QJ0013,00ARQJ0047,L,1,100000,345000,2,0,170000,1,0,35000,175000,140000
01SCS19E020001,AR.BPH-RH027,20ARRH0787,L,1,187850,289000,2,0,144500,1,0,36125,144500,108375
01SCS19E020001,ESH.AR-RE0004,00ARRE0014,M,1,42000,135000,2,0,67500,1,0,13500,67500,54000
01SCS19E020001,ESH.AR-RE0008,00ARRE0030,M,1,42000,135000,2,0,67500,1,0,13500,67500,54000
01SCS19E020002,BSC.AR-SA0002,00ARSA0005,S,1,120000,315000,2,0,94500,1,0,44100,220500,176400
01SCS19E020002,ESH.AR-RI0009,00ARRI0102,S,1,94500,135000,2,0,40500,1,0,18900,94500,75600
01SCS19E020003,AR.SMD-SA002,20ARSA0224,M,1,87750,135000,2,0,27000,1,0,27000,108000,81000
01SCS19E020003,BSC.AR-SC0012,00ARSC0073,M,1,44000,159000,2,0,47700,1,0,22260,111300,89040
01SCS19E020003,ESH.AR-RH0005,00ARRH0042,M,1,94500,135000,2,0,40500,1,0,18900,94500,75600
01SCS19E020003,ESH.AR-SC0011,00ARSC0085,M,1,44000,135000,2,0,40500,1,0,18900,94500,75600
01SCS19E020003,ESH.AR-SD0023,00ARSD0169,NON,1,43000,120000,2,0,36000,1,0,16800,84000,67200
01SCS19E020004,BSC.AR-QE0012,00ARQE0095,M,1,125000,375000,2,0,200000,1,0,35000,175000,140000
01SCS19E020005,ESH.AR-RJ0013,00ARRJ0178,XL,1,94500,135000,2,0,40500,1,0,18900,94500,75600
01SCS19E020006,BSC.AR-SB0019,00ARSB0164,M,1,125000,315000,2,0,94500,1,0,44100,220500,176400
01SCS19E020007,AR.TUC-RL015,20ARRL0339,ALL,1,87750,135000,2,0,27000,1,0,27000,108000,81000
01SCS19E020008,AR.STY-RJ004,20ARRJ0053,ALL,1,55250,85000,2,0,17000,1,0,17000,68000,51000
01SCS19E020008,AR.STY-SC007,20ARSC0206,ALL,1,77350,119000,2,0,23800,1,0,23800,95200,71400
01SCS19E020008,ESH.AR-SB0012,00ARSB0057,34,1,90,285000,2,0,85500,1,0,39900,199500,159600
01SCS19E020009,AR.MKV-RJ028,20ARRJ0225,28,1,214500,330000,2,0,66000,1,0,66000,264000,198000
01SCS19E020009,AR.TUC-SD026,20ARSD0521,ALL,1,35750,55000,2,0,11000,1,0,11000,44000,33000
01SCS19E020010,AR.PUB-SC014,20ARSC0358,L,1,97500,150000,2,0,30000,1,0,30000,120000,90000
01SCS19E020011,AR.PUB-SD017,20ARSD0134,M,1,204750,315000,2,0,63000,1,0,63000,252000,189000
01SCS19E020012,BSC.AR-RF0004,00ARRF0029,XL,1,110000,315000,2,0,155000,1,0,32000,160000,128000
01SCS19E020013,AR.MKV-RJ030,20ARRJ0448,L,1,165750,255000,2,0,51000,1,0,51000,204000,153000
01SCS19E020014,BSC.AR-RD0008,00ARRD0042,34,1,110000,350000,2,0,175000,1,0,35000,175000,140000
01SCS19E020014,BSC.AR-RL0025,00ARRL0166,S,1,44000,135000,2,0,40500,1,0,18900,94500,75600
01SCS19E020014,BSC.AR-SD0019,00ARSD0124,NON,1,45000,150000,2,0,45000,1,0,21000,105000,84000
01SCS19E020014,ESH.AR-QK0012,00ARQK0073,L,1,100000,310000,2,0,150000,1,0,32000,160000,128000
01SCS19E020015,ESH.AR-SB0034,00ARSB0217,M,1,125000,315000,2,0,94500,1,0,44100,220500,176400
01SCS19E020016,BSC.AR-RC0026,00ARRC0171,ALL,1,55000,150000,2,0,100000,1,0,10000,50000,40000
01SCS19E020017,AR.CPT-SC003,20ARSC0250,32,1,227500,350000,2,0,70000,1,0,70000,280000,210000
01SCS19E020017,ESH.AR-SD0022,00ARSD0168,NON,1,43000,120000,2,0,36000,1,0,16800,84000,67200
01SCS19E020018,AR.PUB-RG007,20ARRG0042,S,1,97500,150000,2,0,30000,1,0,30000,120000,90000
01SCS19E020018,AR.TUC-SB020,20ARSB0484,ALL,1,87750,135000,2,0,27000,1,0,27000,108000,81000
01SCS19E020019,ESH.AR-RH0024,00ARRH0140,M,1,115000,315000,2,0,155000,1,0,32000,160000,128000
01SCS19E020020,BSC.AR-RL0018,00ARRL0109,S,1,125000,315000,2,0,94500,1,0,44100,220500,176400
01SCS19E020020,ESH.AR-RD0001,00ARRD0022,36,1,110000,350000,2,0,175000,1,0,35000,175000,140000
01SCS19E020021,ESH.AR-QI0003,00ARQI0036,ALL,1,40000,140000,2,0,90000,1,0,10000,50000,40000
01SCS19E020021,ESH.AR-RD0001,00ARRD0021,34,1,110000,350000,2,0,175000,1,0,35000,175000,140000
01SCS19E020022,AR.VCS-RI006,20ARRI0293,XL,1,243750,375000,2,0,112500,1,0,65625,262500,196875
01SCS19E020023,AR.TUC-SD004,20ARSD0153,M,1,204750,315000,2,0,63000,1,0,63000,252000,189000
01SCS19E020024,AR.ESB-SB007,20ARSB0118,L,1,91000,140000,2,0,28000,1,0,28000,112000,84000
01SCS19E020024,AR.TUC-SB020,20ARSB0484,ALL,1,87750,135000,2,0,27000,1,0,27000,108000,81000
01SCS19E020024,ESH.AR-RD0001,00ARRD0020,32,1,110000,350000,2,0,175000,1,0,35000,175000,140000
01SCS19E020025,AR.CPT-SC012,20ARSC0481,L,1,204750,315000,2,0,63000,1,0,63000,252000,189000
01SCS19E020026,AR.PCT-RK001,20ARRK0249,ALL,1,178750,275000,2,0,55000,1,0,55000,220000,165000
01SCS19E020027,AR.YD-RL015,20ARRL0039,M,1,91000,140000,2,0,70000,1,0,17500,70000,52500
01SCS19E020027,BSC.AR-QJ0014,00ARQJ0113,M,1,100000,310000,2,0,150000,1,0,32000,160000,128000
01SCS19E020028,BSC.AR-RE0028,00ARRE0303,NON,1,35000,120000,2,0,36000,1,0,16800,84000,67200
01SCS19E020029,BSC.AR-SC0042,00ARSC0276,S,1,135000,375000,2,0,112500,1,0,52500,262500,210000
01SCS19E020030,BSC.AR-RE0028,00ARRE0303,NON,1,35000,120000,2,0,36000,1,0,16800,84000,67200
01SCS19E020031,AR.CPT-RE012,20ARRE0714,M,1,94250,145000,2,0,29000,1,0,29000,116000,87000
01SCS19E020032,AR.HMR-SB003,20ARSB0346,L,1,194350,299000,2,0,59800,1,0,59800,239200,179400
01SCS19E020033,ESH.AR-RE0008,00ARRE0030,M,1,42000,135000,2,0,67500,1,0,13500,67500,54000
01SCS19E020033,ESH.AR-RE0013,00ARRE0091,L,1,42000,135000,2,0,67500,1,0,13500,67500,54000
01SCS19E020034,BSC.AR-RK0002,00ARRK0055,L,1,94500,135000,2,0,40500,1,0,18900,94500,75600
01SCS19E020035,BSC.AR-RJ0012,00ARRJ0085,L,1,44500,135000,2,0,40500,1,0,18900,94500,75600
01SCS19E020036,ESH.AR-QD0016,00ARQD0150,M,1,110000,325000,2,0,165000,1,0,32000,160000,128000
01SCS19E020037,AR.ESB-SB001,20ARSB0020,S,1,204750,315000,2,0,63000,1,0,63000,252000,189000
01SCS19E020037,AR.TUC-SD013,20ARSD0470,M,1,94250,145000,2,0,29000,1,0,29000,116000,87000
01SCS19E020038,AR.GTW-SB002,20ARSB0154,L,1,214500,330000,2,0,99000,1,0,57750,231000,173250
01SCS19E020038,ESH.AR-SC0030,00ARSC0274,NON,1,90000,250000,2,0,75000,1,0,35000,175000,140000
01SCS19E020039,BSC.AR-RI0016,00ARRI0060,L,1,43000,135000,2,0,40500,1,0,18900,94500,75600
01SCS19E020039,BSC.AR-SB0011,00ARSB0097,M,1,44500,135000,2,0,40500,1,0,18900,94500,75600
01SCS19E020040,ESH.AR-PL0018,00ARPL0138,M,1,110000,325000,2,0,165000,1,0,32000,160000,128000
01SCS19E020040,ESH.AR-QH0026,00ARQH0137,ALL,1,39700,140000,2,0,90000,1,0,10000,50000,40000
01SCS19E020041,AR.ESB-SB007,20ARSB0117,M,1,91000,140000,2,0,28000,1,0,28000,112000,84000
01SCS19E020042,ESH.AR-RC0024,00ARRC0180,M,1,42000,135000,2,0,67500,1,0,13500,67500,54000
01SCS19E020042,ESH.AR-RC0024,00ARRC0181,L,1,42000,135000,2,0,67500,1,0,13500,67500,54000
01SCS19E020043,ESH.AR-RD0024,00ARRD0227,S,1,145000,435000,2,0,260000,1,0,35000,175000,140000
01SCS19E020044,ESH.AR-SB0024,00ARSB0156,NON,1,35300,120000,2,0,36000,1,0,16800,84000,67200
01SCS19E020045,THR.AR-RK0007,00ARRK0181,L,1,332000,415000,2,0,41500,1,0,56025,373500,317475
01SCS19E020046,BSC.AR-RD0021,00ARRD0108,L,1,42000,135000,2,0,67500,1,0,13500,67500,54000
01SCS19E020046,ESH.AR-RC0039,00ARRC0224,L,1,42000,135000,2,0,67500,1,0,13500,67500,54000
01SCS19E020047,BSC.AR-SC0017,00ARSC0117,M,1,44500,135000,2,0,40500,1,0,18900,94500,75600
01SCS19E020048,BSC.AR-RC0026,00ARRC0171,ALL,1,55000,150000,2,0,100000,1,0,10000,50000,40000
01SCS19E020048,BSC.AR-RI0032,00ARRI0149,S,1,120000,315000,2,0,94500,1,0,44100,220500,176400
01SCS19E020048,BSC.AR-SA0002,00ARSA0005,S,1,120000,315000,2,0,94500,1,0,44100,220500,176400
01SCS19E020048,BSC.AR-SC0025,00ARSC0182,M,1,125000,315000,2,0,94500,1,0,44100,220500,176400
01SCS19E020048,BSC.AR-SC0034,00ARSC0228,S,1,125000,315000,2,0,94500,1,0,44100,220500,176400
01SCS19E020048,ESH.AR-PL0015,00ARPL0126,M,1,110000,325000,2,0,165000,1,0,32000,160000,128000
01SCS19E020048,ESH.AR-QD0016,00ARQD0149,S,1,110000,325000,2,0,165000,1,0,32000,160000,128000
01SCS19E020048,ESH.AR-QE0002,00ARQE0021,ALL,1,50000,140000,2,0,90000,1,0,10000,50000,40000
01SCS19E020048,ESH.AR-QK0001,00ARQK0003,L,1,90000,310000,2,0,150000,1,0,32000,160000,128000
01SCS19E020048,ESH.AR-QK0012,00ARQK0073,L,1,100000,310000,2,0,150000,1,0,32000,160000,128000
01SCS19E020048,ESH.AR-RA0017,00ARRA0074,ALL,1,40000,140000,2,0,90000,1,0,10000,50000,40000
01SCS19E020048,ESH.AR-RE0008,00ARRE0031,L,1,42000,135000,2,0,67500,1,0,13500,67500,54000
01SCS19E020048,ESH.AR-RE0010,00ARRE0078,M,1,42000,135000,2,0,67500,1,0,13500,67500,54000
01SCS19E020048,ESH.AR-RE0010,00ARRE0080,XL,1,42000,135000,2,0,67500,1,0,13500,67500,54000
01SCS19E020048,ESH.AR-RE0013,00ARRE0091,L,1,42000,135000,2,0,67500,1,0,13500,67500,54000
01SCS19E020048,ESH.AR-RH0024,00ARRH0140,M,1,115000,315000,2,0,155000,1,0,32000,160000,128000
01SCS19E020049,ESH.AR-SB0025,00ARSB0157,NON,1,35300,120000,2,0,36000,1,0,16800,84000,67200
01SCS19E020050,BSC.AR-SB0005,00ARSB0061,NON,1,47500,140000,2,0,42000,1,0,19600,98000,78400
01SCS19E020051,ESH.AR-RB0028,00ARRB0152,30,1,130000,350000,2,0,175000,1,0,35000,175000,140000
01SCS19E020051,ESH.AR-SB0029,00ARSB0197,M,1,125000,315000,2,0,94500,1,0,44100,220500,176400
01SCS19E020052,AR.BPH-SA005,20ARSA0250,ALL,1,103350,159000,2,0,47700,1,0,27825,111300,83475
01SCS19E020052,AR.MKV-RJ029,20ARRJ0443,M,1,165750,255000,2,0,51000,1,0,51000,204000,153000
01SCS19E020052,AR.MKV-SD015,20ARSD0427,34,1,214500,330000,2,0,165000,1,0,41250,165000,123750
01SCS19E020052,ESH.AR-QH0026,00ARQH0137,ALL,1,39700,140000,2,0,90000,1,0,10000,50000,40000
01SCS19E020053,AR.PUB-RK001,20ARRK0068,XL,1,97500,150000,2,0,30000,1,0,30000,120000,90000
01SCS19E020053,BE.RAK-SA019,00BESA0074,XL,1,91000,140000,2,0,28000,1,0,28000,112000,84000
01SCS19E020054,AR.ESB-SB003,20ARSB0101,M,1,100750,155000,2,0,31000,1,0,31000,124000,93000
01SCS19E020054,ESH.AR-QK0012,00ARQK0073,L,1,100000,310000,2,0,150000,1,0,32000,160000,128000
01SCS19E020055,BSC.AR-SC0001,00ARSC0014,M,1,125000,315000,2,0,94500,1,0,44100,220500,176400
01SCS19E020056,AR.PUB-SC014,20ARSC0358,L,1,97500,150000,2,0,30000,1,0,30000,120000,90000
01SCS19E020057,AR.ASH-RJ007,20ARRJ0271,M,1,91000,140000,2,0,42000,1,0,24500,98000,73500
01SCS19E020057,AR.REC-SD013,20ARSD0049,M,1,120250,185000,2,0,55500,1,0,32375,129500,97125
01SCS19E020058,AR.GTW-SC004,20ARSC0033,ALL,1,97500,150000,2,0,45000,1,0,26250,105000,78750
01SCS19E020059,AR.STY-SC001,20ARSC0200,ALL,1,77350,119000,2,0,23800,1,0,23800,95200,71400
01SCS19E020060,ARN.AR-RK0004,00ARRK0231,M,1,150000,450000,2,0,90000,1,0,108000,360000,252000
01SCS19E020061,AR.ESB-RE046,20ARRE0810,ALL,1,91000,140000,2,0,42000,1,0,24500,98000,73500
01SCS19E020061,BSC.AR-SC0029,00ARSC0200,M,1,125000,315000,2,0,94500,1,0,44100,220500,176400
01SCS19E020062,BE.RAK-RL031,00BERL0111,M,1,259350,399000,2,0,79800,1,0,79800,319200,239400
01SCS19E020062,ESH.AR-RH0005,00ARRH0041,S,1,94500,135000,2,0,40500,1,0,18900,94500,75600
01SCS19E020063,AR.HLW-SA010,20ARSA0097,ALL,1,120250,185000,2,0,37000,1,0,37000,148000,111000
01SCS19E020063,BSC.AR-RL0018,00ARRL0110,M,1,125000,315000,2,0,94500,1,0,44100,220500,176400
01SCS19E020063,ESH.AR-RH0007,00ARRH0059,NON,1,45000,150000,2,0,45000,1,0,21000,105000,84000
01SCS19E020064,AR.CPT-SC003,20ARSC0250,32,1,227500,350000,2,0,70000,1,0,70000,280000,210000
01SCS19E020065,BSC.AR-SA0023,00ARSA0114,NON,1,47500,140000,2,0,42000,1,0,19600,98000,78400
01SCS19E020066,BSC.AR-RD0040,00ARRD0205,L,1,110000,315000,2,0,155000,1,0,32000,160000,128000
01SCS19E020067,AR.TUC-SD022,20ARSD0508,XL,1,94250,145000,2,0,29000,1,0,29000,116000,87000
01SCS19E020068,AR.TUC-SD013,20ARSD0470,M,1,94250,145000,2,0,29000,1,0,29000,116000,87000
01SCS19E020069,AR.TUC-SB013,20ARSB0202,XL,1,94250,145000,2,0,29000,1,0,29000,116000,87000
01SCS19E020069,AR.TUC-SB014,20ARSB0206,XL,1,94250,145000,2,0,29000,1,0,29000,116000,87000
01SCS19E020070,AR.MKV-QB034,20ARQB0423,M,1,165750,255000,2,0,127500,1,0,31875,127500,95625
01SCS19E020070,ESH.AR-RD0024,00ARRD0227,S,1,145000,435000,2,0,260000,1,0,35000,175000,140000
01SCS19E020071,AR.PUB-SA001,20ARSA0078,S,1,97500,150000,2,0,30000,1,0,30000,120000,90000
01SCS19E020072,AR.ESB-SA001,20ARSA0204,M,1,87750,135000,2,0,27000,1,0,27000,108000,81000
01SCS19E020072,AR.PUB-SC011,20ARSC0298,L,1,97500,150000,2,0,30000,1,0,30000,120000,90000
01SCS19E020072,ESH.AR-QL0004,00ARQL0021,XL,1,42000,135000,2,0,67500,1,0,13500,67500,54000
01SCS19E020072,ESH.AR-RE0013,00ARRE0091,L,1,42000,135000,2,0,67500,1,0,13500,67500,54000
01SCS19E020073,ESH.AR-SC0027,00ARSC0263,L,1,125000,315000,2,0,94500,1,0,44100,220500,176400
01SCS19E020074,AR.TUC-RK053,20ARRK0219,XL,1,278850,429000,2,0,85800,1,0,85800,343200,257400
01SCS19E020075,AR.PUB-SD035,20ARSD0347,XL,1,204750,315000,2,0,63000,1,0,63000,252000,189000
01SCS19E020075,AR.VCS-SC013,20ARSC0417,ALL,1,110500,170000,2,0,51000,1,0,29750,119000,89250
01SCS19E020075,BSC.AR-RJ0032,00ARRJ0215,NON,1,18000,75000,2,0,22500,1,0,10500,52500,42000
01SCS19E020076,AR.HLW-SA006,20ARSA0093,ALL,1,71500,110000,2,0,22000,1,0,22000,88000,66000
01SCS19E020077,AR.ESB-SD005,20ARSD0113,M,1,91000,140000,2,0,28000,1,0,28000,112000,84000
01SCS19E020077,AR.PUB-RJ016,20ARRJ0233,S,1,97500,150000,2,0,30000,1,0,30000,120000,90000
01SCS19E020078,ESH.AR-RH0006,00ARRH0058,NON,1,45000,150000,2,0,45000,1,0,21000,105000,84000
01SCS19E020079,ESH.AR-SB0015,00ARSB0063,M,1,125000,315000,2,0,94500,1,0,44100,220500,176400
01SCS19E020079,ESH.AR-SC0005,00ARSC0027,M,1,125000,315000,2,0,94500,1,0,44100,220500,176400
01SCS19E020079,ESH.AR-SC0038,00ARSC0303,NON,1,45000,140000,2,0,42000,1,0,19600,98000,78400
01SCS19E020080,ESH.AR-QE0029,00ARQE0163,L,1,110000,325000,2,0,165000,1,0,32000,160000,128000
01SCS19E020081,BSC.AR-QJ0014,00ARQJ0113,M,1,100000,310000,2,0,150000,1,0,32000,160000,128000
01SCS19E020082,AR.TUC-SD021,20ARSD0502,M,1,94250,145000,2,0,29000,1,0,29000,116000,87000
01SCS19E020082,BSC.AR-SA0006,00ARSA0026,S,1,44500,135000,2,0,40500,1,0,18900,94500,75600
01SCS19E020083,ESH.AR-PL0018,00ARPL0138,M,1,110000,325000,2,0,165000,1,0,32000,160000,128000
01SCS19E020084,AR.PUB-SE017,20ARSE0065,S,1,159250,245000,2,0,49000,1,0,49000,196000,147000
01SCS19E020084,AR.TUC-SD014,20ARSD0475,L,1,94250,145000,2,0,29000,1,0,29000,116000,87000
01SCS19E020084,ESH.AR-RH0008,00ARRH0060,NON,1,45000,150000,2,0,45000,1,0,21000,105000,84000
01SCS19E020084,ESH.AR-SB0017,00ARSB0100,NON,1,41000,120000,2,0,36000,1,0,16800,84000,67200
01SCS19E020085,AR.TUC-RK042,20ARRK0181,M,1,211250,325000,2,0,65000,1,0,65000,260000,195000
01SCS19E020086,AR.CPT-RL019,20ARRL0385,S,1,94250,145000,2,0,29000,1,0,29000,116000,87000
01SCS19E020086,AR.VRS-SC003,20ARSC0170,S,1,96850,149000,2,0,44700,1,0,26075,104300,78225
01SCS19E020087,AR.TUC-SA009,20ARSA0027,ALL,1,87750,135000,2,0,27000,1,0,27000,108000,81000
01SCS19E020087,AR.TUC-SA027,20ARSA0162,ALL,1,100750,155000,2,0,31000,1,0,31000,124000,93000
01SCS19E020088,AR.MYA-SD005,20ARSD0259,M,1,285350,439000,2,0,219500,1,0,54875,219500,164625
01SCS19E020088,AR.PUB-SA010,20ARSA0335,32,1,211250,325000,2,0,65000,1,0,65000,260000,195000
01SCS19E020088,AR.TUC-SB019,20ARSB0481,M,1,87750,135000,2,0,27000,1,0,27000,108000,81000
01SCS19E020088,BE.RAK-RL029,00BERL0103,M,1,259350,399000,2,0,79800,1,0,79800,319200,239400
01SCS19E020089,AR.PUB-RH009,20ARRH0022,M,1,97500,150000,2,0,30000,1,0,30000,120000,90000
01SCS19E020089,ARN.AR-SB0001,00ARSB0086,NON,1,107400,179000,2,0,35800,1,0,42960,143200,100240
01SCS19E020090,BSC.AR-RD0021,00ARRD0108,L,1,42000,135000,2,0,67500,1,0,13500,67500,54000
01SCS19E020090,BSC.AR-SA0021,00ARSA0105,S,1,44000,135000,2,0,40500,1,0,18900,94500,75600
01SCS19E020090,ESH.AR-PI0154,00ARPI1087,XL,1,50000,150000,2,0,82500,1,0,13500,67500,54000
01SCS19E020091,ARN.AR-RK0005,00ARRK0235,30,1,110000,350000,2,0,70000,1,0,84000,280000,196000
01SCS19E020092,AR.TUC-SD023,20ARSD0510,M,1,204750,315000,2,0,63000,1,0,63000,252000,189000
01SCS19E020092,BE.RAK-SB012,00BESB0058,L,1,201500,310000,2,0,62000,1,0,62000,248000,186000
01SCS19E020093,AR.KNR-RK008,20ARRK0277,S,1,152750,235000,2,0,70500,1,0,41125,164500,123375
01SCS19E020094,ESH.AR-SC0005,00ARSC0027,M,1,125000,315000,2,0,94500,1,0,44100,220500,176400
01SCS19E020095,ESH.AR-SD0001,00ARSD0030,M,1,44500,135000,2,0,40500,1,0,18900,94500,75600
01SCS19E020096,ESH.AR-RF0017,00ARRF0127,L,1,140000,395000,2,0,220000,1,0,35000,175000,140000
01SCS19E020097,AR.PUB-RG007,20ARRG0044,L,1,97500,150000,2,0,30000,1,0,30000,120000,90000
01SCS19E020097,AR.PUB-RG008,20ARRG0048,L,1,97500,150000,2,0,30000,1,0,30000,120000,90000
01SCS19E020098,BSC.AR-RK0006,00ARRK0070,M,1,52000,155000,2,0,46500,1,0,21700,108500,86800
01SCS19E020099,AR.ESB-SA001,20ARSA0204,M,1,87750,135000,2,0,27000,1,0,27000,108000,81000
01SCS19E020099,AR.MPR-SB002,20ARSB0239,M,1,243750,375000,2,0,75000,1,0,75000,300000,225000
01SCS19E020099,ESH.AR-RK0017,00ARRK0193,NON,1,105000,150000,2,0,45000,1,0,21000,105000,84000
01SCS19E020100,AR.CLK-RK002,20ARRK0244,ALL,1,91000,140000,2,0,28000,1,0,28000,112000,84000
01SCS19E020100,AR.MKV-QJ007,20ARQJ0032,30,1,227500,350000,2,0,175000,1,0,43750,175000,131250
01SCS19E020101,AR.TUC-SD014,20ARSD0475,L,1,94250,145000,2,0,29000,1,0,29000,116000,87000
01SCS19E020102,AR.MKV-PL032,20ARPL0506,32,1,214500,330000,2,0,165000,1,0,41250,165000,123750
01SCS19E020103,BSC.AR-SA0018,00ARSA0059,S,1,44000,135000,2,0,40500,1,0,18900,94500,75600
01SCS19E020104,THR.AR-RG0010,00ARRG0068,L,1,1030000,1030000,2,0,103000,1,0,139050,927000,787950
01SCS19E020105,BSC.AR-SA0007,00ARSA0030,S,1,44500,135000,2,0,40500,1,0,18900,94500,75600
01SCS19E020106,AR.MYA-SC001,20ARSC0038,M,1,220350,339000,2,0,101700,1,0,59325,237300,177975
01SCS19E020106,AR.TUC-SD022,20ARSD0507,L,1,94250,145000,2,0,29000,1,0,29000,116000,87000
01SCS19E020107,AR.TUC-SD023,20ARSD0510,M,1,204750,315000,2,0,63000,1,0,63000,252000,189000
01SCS19E020108,AR.SMD-RL001,20ARRL0265,ALL,1,22750,35000,2,0,7000,1,0,7000,28000,21000
01SCS19E020109,ESH.AR-PL0018,00ARPL0138,M,1,110000,325000,2,0,165000,1,0,32000,160000,128000
01SCS19E020110,AR.CPT-SD006,20ARSD0435,L,1,200850,309000,2,0,61800,1,0,61800,247200,185400
01SCS19E020110,AR.STY-SC002,20ARSC0201,ALL,1,77350,119000,2,0,23800,1,0,23800,95200,71400
01SCS19E020110,AR.TUC-SD007,20ARSD0166,L,1,185250,285000,2,0,57000,1,0,57000,228000,171000
01SCS19E020111,AR.PUB-SA009,20ARSA0329,S,1,224250,345000,2,0,69000,1,0,69000,276000,207000
01SCS19E020111,ESH.AR-SD0004,00ARSD0045,S,1,44500,135000,2,0,40500,1,0,18900,94500,75600
01SCS19E020112,AR.MDS-RL005,20ARRL0370,S,1,117000,180000,2,0,36000,1,0,36000,144000,108000
01SCS19E020113,AR.GTW-SB001,20ARSB0150,L,1,94250,145000,2,0,43500,1,0,25375,101500,76125
01SCS19E020113,AR.PUB-SD024,20ARSD0195,L,1,97500,150000,2,0,30000,1,0,30000,120000,90000
01SCS19E020114,AR.TUC-SD019,20ARSD0495,L,1,94250,145000,2,0,29000,1,0,29000,116000,87000
01SCS19E020115,AR.GTW-SA002,20ARSA0299,S,1,107250,165000,2,0,49500,1,0,28875,115500,86625
01SCS19E020116,AR.ASH-RJ007,20ARRJ0271,M,1,91000,140000,2,0,42000,1,0,24500,98000,73500
01SCS19E020116,AR.YD-SD003,20ARSD0267,M,1,87750,135000,2,0,67500,1,0,16875,67500,50625
01SCS19E020117,AR.SMD-SD017,20ARSD0579,ALL,1,97500,150000,2,0,30000,1,0,30000,120000,90000
01SCS19E020118,BSC.AR-SB0018,00ARSB0140,S,1,44500,135000,2,0,40500,1,0,18900,94500,75600
01SCS19E020118,ESH.AR-SB0010,00ARSB0040,M,1,44500,135000,2,0,40500,1,0,18900,94500,75600
01SCS19E020119,AR.SMD-SD016,20ARSD0578,ALL,1,97500,150000,2,0,30000,1,0,30000,120000,90000
01SCS19E020120,ESH.AR-RB0014,00ARRB0081,XL,1,47000,150000,2,0,82500,1,0,13500,67500,54000
01SCS19E020120,ESH.AR-RC0024,00ARRC0180,M,1,42000,135000,2,0,67500,1,0,13500,67500,54000
01SCS19E020120,ESH.AR-RD0020,00ARRD0189,L,1,43000,150000,2,0,82500,1,0,13500,67500,54000
01SCS19E020120,ESH.AR-RE0019,00ARRE0204,S,1,43000,150000,2,0,82500,1,0,13500,67500,54000
01SCS19E020121,BSC.AR-QG0010,00ARQG0099,ALL,1,80000,240000,2,0,140000,1,0,20000,100000,80000
01SCS19E020122,BSC.AR-SC0046,00ARSC0298,NON,1,45000,150000,2,0,45000,1,0,21000,105000,84000
01SCS19E020123,AR.MKV-SC015,20ARSC0214,L,1,204750,315000,2,0,63000,1,0,63000,252000,189000
01SCS19E020124,AR.PUB-SD010,20ARSD0120,ALL,1,97500,150000,2,0,30000,1,0,30000,120000,90000
01SCS19E020125,AR.HLW-SC004,20ARSC0126,S,1,195000,300000,2,0,90000,1,0,52500,210000,157500
01SCS19E020126,AR.MKV-PL032,20ARPL0506,32,1,214500,330000,2,0,165000,1,0,41250,165000,123750
01SCS19E020127,AR.PUB-SD016,20ARSD0130,M,1,97500,150000,2,0,30000,1,0,30000,120000,90000
01SCS19E020127,AR.TUC-SD012,20ARSD0466,M,1,94250,145000,2,0,29000,1,0,29000,116000,87000
01SCS19E020128,AR.ESB-RL004,20ARRL0013,S,1,100750,155000,2,0,31000,1,0,31000,124000,93000
01SCS19E020129,AR.SMD-SD009,20ARSD0308,L,1,243750,375000,2,0,112500,1,0,65625,262500,196875
01SCS19E020129,AR.TUC-RK013,20ARRK0109,ALL,1,87750,135000,2,0,27000,1,0,27000,108000,81000
01SCS19E020130,AR.PUB-SD001,20ARSD0083,L,1,204750,315000,2,0,63000,1,0,63000,252000,189000
01SCS19E020131,BSC.AR-SB0014,00ARSB0113,XL,1,44000,135000,2,0,40500,1,0,18900,94500,75600
01SCS19E020132,AR.MKV-RG004,20ARRG0090,ALL,1,78000,120000,2,0,24000,1,0,24000,96000,72000
01SCS19E020133,AR.CLK-RK002,20ARRK0244,ALL,1,91000,140000,2,0,28000,1,0,28000,112000,84000
01SCS19E020134,AR.PUB-SB032,20ARSB0461,M,1,204750,315000,2,0,63000,1,0,63000,252000,189000
01SCS19E020135,AR.TUC-SD012,20ARSD0466,M,1,94250,145000,2,0,29000,1,0,29000,116000,87000
01SCS19E020136,AR.ASH-RJ011,20ARRJ0490,M,1,91000,140000,2,0,42000,1,0,24500,98000,73500
01SCS19E020136,AR.SMD-RI006,20ARRL0063,S,1,87750,135000,2,0,40500,1,0,23625,94500,70875
01SCS19E020136,ESH.AR-SA0012,00ARSA0093,S,1,44000,135000,2,0,40500,1,0,18900,94500,75600
01SCS19E020137,AR.HMR-SB023,20ARSB0405,28,1,204750,315000,2,0,63000,1,0,63000,252000,189000
01SCS19E020137,AR.PUB-SE017,20ARSE0066,M,1,159250,245000,2,0,49000,1,0,49000,196000,147000
01SCS19E020137,AR.PUB-SE018,20ARSE0069,S,1,159250,245000,2,0,49000,1,0,49000,196000,147000
01SCS19E020137,AR.PUB-SE020,20ARSE0077,M,1,159250,245000,2,0,49000,1,0,49000,196000,147000
01SCS19E020138,AR.PUB-SE018,20ARSE0070,M,1,159250,245000,2,0,49000,1,0,49000,196000,147000
01SCS19E020138,AR.TUC-SD023,20ARSD0511,L,1,204750,315000,2,0,63000,1,0,63000,252000,189000
01SCS19E020139,AR.ASH-RJ007,20ARRJ0272,L,1,91000,140000,2,0,42000,1,0,24500,98000,73500
01SCS19E020140,AR.ESB-SA002,20ARSA0207,S,1,204750,315000,2,0,63000,1,0,63000,252000,189000
01SCS19E020140,AR.MKV-RC019,20ARRC0461,S,1,312000,480000,2,0,240000,1,0,60000,240000,180000
01SCS19E020140,BSC.AR-RD0021,00ARRD0108,L,1,42000,135000,2,0,67500,1,0,13500,67500,54000
01SCS19E020140,ESH.AR-PI0154,00ARPI1087,XL,1,50000,150000,2,0,82500,1,0,13500,67500,54000
01SCS19E020141,ESH.AR-QJ0013,00ARQJ0046,M,1,100000,345000,2,0,170000,1,0,35000,175000,140000
01SCS19E030001,ESH.AR-RK0014,00ARRK0189,L,1,245000,350000,2,0,105000,1,0,49000,245000,196000
01SCS19E030002,AR.PUB-RL006,20ARRL0128,M,1,97500,150000,2,0,30000,1,0,30000,120000,90000
01SCS19E030002,AR.PUB-SD025,20ARSD0198,M,1,97500,150000,2,0,30000,1,0,30000,120000,90000
01SCS19E030002,ESH.AR-PL0018,00ARPL0139,L,1,110000,325000,2,0,165000,1,0,32000,160000,128000
01SCS19E030003,BSC.AR-RJ0031,00ARRJ0203,L,1,220500,315000,2,0,94500,1,0,44100,220500,176400
01SCS19E030004,ESH.AR-PK0043,00ARPK0198,S,1,110000,325000,2,0,165000,1,0,32000,160000,128000
01SCS19E030005,AR.CPT-RI009,20ARRI0073,M,1,94251,169000,2,0,33800,1,0,33800,135200,101400
01SCS19E030006,BSC.AR-RK0016,00ARRK0110,M,1,43000,135000,2,0,40500,1,0,18900,94500,75600
01SCS19E030006,ESH.AR-SA0012,00ARSA0093,S,1,44000,135000,2,0,40500,1,0,18900,94500,75600
01SCS19E030007,AR.CPT-SC011,20ARSC0476,M,1,204750,315000,2,0,63000,1,0,63000,252000,189000
01SCS19E030008,BSC.AR-SC0003,00ARSC0025,NON,1,73000,220000,2,0,66000,1,0,30800,154000,123200
01SCS19E030009,BSC.AR-SD0018,00ARSD0123,NON,1,45000,150000,2,0,45000,1,0,21000,105000,84000
01SCS19E030009,ESH.AR-RJ0011,00ARRJ0053,L,1,94500,135000,2,0,40500,1,0,18900,94500,75600
01SCS19E030010,AR.PUB-RI021,20ARRI0279,32,1,224250,345000,2,0,69000,1,0,69000,276000,207000
01SCS19E030010,AR.SMD-SD010,20ARSD0310,28,1,211250,325000,2,0,65000,1,0,65000,260000,195000
01SCS19E030010,AR.STY-SE004,20ARSE0122,ALL,1,55250,85000,2,0,17000,1,0,17000,68000,51000
01SCS19E030010,AR.STY-SE006,20ARSE0124,ALL,1,55250,85000,2,0,17000,1,0,17000,68000,51000
01SCS19E030010,AR.STY-SE007,20ARSE0125,ALL,1,55250,85000,2,0,17000,1,0,17000,68000,51000
01SCS19E030010,AR.TUC-SC003,20ARSC0053,M,1,87750,135000,2,0,27000,1,0,27000,108000,81000
01SCS19E030010,AR.TUC-SD025,20ARSD0518,30,1,211250,325000,2,0,65000,1,0,65000,260000,195000
01SCS19E030010,ESH.AR-SC0011,00ARSC0084,S,1,44000,135000,2,0,40500,1,0,18900,94500,75600
01SCS19E030011,AR.MYA-RE005,20ARRE1307,30,1,207350,319000,2,0,159500,1,0,39875,159500,119625
01SCS19E030012,AR.STY-RK003,20ARRK0525,ALL,1,61750,95000,2,0,19000,1,0,19000,76000,57000
01SCS19E030012,AR.STY-SC002,20ARSC0201,ALL,1,77350,119000,2,0,23800,1,0,23800,95200,71400
01SCS19E030012,AR.STY-SE009,20ARSE0127,ALL,1,55250,85000,2,0,17000,1,0,17000,68000,51000
01SCS19E030012,ESH.AR-RE0022,00ARRE0237,NON,1,20000,75000,2,0,22500,1,0,10500,52500,42000
01SCS19E030013,ESH.AR-RH0006,00ARRH0058,NON,1,45000,150000,2,0,45000,1,0,21000,105000,84000
01SCS19E030014,ESH.AR-SA0006,00ARSA0073,L,1,44500,135000,2,0,40500,1,0,18900,94500,75600
01SCS19E030015,AR.TUC-SD024,20ARSD0514,M,1,204750,315000,2,0,63000,1,0,63000,252000,189000
01SCS19E030016,ESH.AR-RD0003,00ARRD0051,36,1,110000,350000,2,0,175000,1,0,35000,175000,140000
01SCS19E030016,ESH.AR-RJ0022,00ARRJ0217,NON,1,18000,75000,2,0,22500,1,0,10500,52500,42000
01SCS19E030017,AR.ASH-RJ011,20ARRJ0490,M,1,91000,140000,2,0,42000,1,0,24500,98000,73500
01SCS19E030017,AR.CPT-SD006,20ARSD0434,M,1,200850,309000,2,0,61800,1,0,61800,247200,185400
01SCS19E030017,AR.MKV-SA006,20ARSA0196,30,1,243750,375000,2,0,75000,1,0,75000,300000,225000
01SCS19E030017,AR.STY-SB006,20ARSB0493,ALL,1,55250,85000,2,0,17000,1,0,17000,68000,51000
01SCS19E030017,AR.STY-SE009,20ARSE0127,ALL,1,55250,85000,2,0,17000,1,0,17000,68000,51000
01SCS19E030017,ESH.AR-SC0006,00ARSC0048,L,1,125000,350000,2,0,105000,1,0,49000,245000,196000
01SCS19E030017,ESH.AR-SD0010,00ARSD0070,M,1,44500,135000,2,0,40500,1,0,18900,94500,75600
01SCS19E030018,AR.CPS-SC005,20ARSC0005,ALL,1,130000,200000,2,0,60000,1,0,35000,140000,105000
01SCS19E030019,AR.MKV-RG003,20ARRG0089,ALL,1,78000,120000,2,0,24000,1,0,24000,96000,72000
01SCS19E030020,AR.REC-SD020,20ARSD0058,28,1,208000,320000,2,0,96000,1,0,56000,224000,168000
01SCS19E030021,AR.PUB-RL007,20ARRL0133,L,1,97500,150000,2,0,30000,1,0,30000,120000,90000
01SCS19E030021,AR.REC-SD010,20ARSD0040,XL,1,178750,275000,2,0,82500,1,0,48125,192500,144375
01SCS19E030022,AR.BPH-RH029,20ARRH0794,M,1,220350,339000,2,0,169500,1,0,42375,169500,127125
01SCS19E030022,AR.PUB-RL014,20ARRL0159,M,1,191750,295000,2,0,59000,1,0,59000,236000,177000
01SCS19E030022,AR.STY-SC004,20ARSC0203,ALL,1,64350,99000,2,0,19800,1,0,19800,79200,59400
01SCS19E030023,ESH.AR-SD0003,00ARSD0042,M,1,44000,135000,2,0,40500,1,0,18900,94500,75600
01SCS19E030024,AR.MKV-RJ016,20ARRJ0199,ALL,1,117000,180000,2,0,36000,1,0,36000,144000,108000
01SCS19E030025,BSC.AR-SC0028,00ARSC0195,S,1,125000,315000,2,0,94500,1,0,44100,220500,176400
01SCS19E030026,AR.STY-SE001,20ARSE0119,ALL,1,83850,129000,2,0,25800,1,0,25800,103200,77400
01SCS19E030027,BSC.AR-RD0021,00ARRD0108,L,1,42000,135000,2,0,67500,1,0,13500,67500,54000
01SCS19E030027,BSC.AR-SC0015,00ARSC0101,M,1,44000,159000,2,0,47700,1,0,22260,111300,89040
01SCS19E030027,ESH.AR-RC0024,00ARRC0180,M,1,42000,135000,2,0,67500,1,0,13500,67500,54000
01SCS19E030027,ESH.AR-RC0026,00ARRC0187,ALL,1,55000,150000,2,0,100000,1,0,10000,50000,40000
01SCS19E030028,ESH.AR-RA0017,00ARRA0074,ALL,1,40000,140000,2,0,90000,1,0,10000,50000,40000
01SCS19E030029,BE.RAK-RX194,00BERX0485,40,1,130000,200000,2,0,40000,1,0,40000,160000,120000
01SCS19E030029,BSC.AR-SC0028,00ARSC0195,S,1,125000,315000,2,0,94500,1,0,44100,220500,176400
01SCS19E030030,AR.HLW-SA010,20ARSA0097,ALL,1,120250,185000,2,0,37000,1,0,37000,148000,111000
01SCS19E030031,BSC.AR-RI0029,00ARRI0138,NON,1,43000,140000,2,0,42000,1,0,19600,98000,78400
01SCS19E030032,AR.CPT-RI004,20ARRI0053,M,1,94250,145000,2,0,29000,1,0,29000,116000,87000
01SCS19E030032,BSC.AR-SC0009,00ARSC0052,S,1,125000,315000,2,0,94500,1,0,44100,220500,176400
01SCS19E030033,AR.MKV-RJ016,20ARRJ0199,ALL,1,117000,180000,2,0,36000,1,0,36000,144000,108000
01SCS19E030034,ESH.AR-SB0033,00ARSB0212,S,1,44500,135000,2,0,40500,1,0,18900,94500,75600
01SCS19E030034,ESH.AR-SC0010,00ARSC0081,M,1,44500,135000,2,0,40500,1,0,18900,94500,75600
01SCS19E030035,AR.MYA-SC001,20ARSC0037,S,1,220350,339000,2,0,101700,1,0,59325,237300,177975
01SCS19E030035,AR.TUC-SD024,20ARSD0514,M,1,204750,315000,2,0,63000,1,0,63000,252000,189000
01SCS19E030035,BSC.AR-SC0017,00ARSC0117,M,1,44500,135000,2,0,40500,1,0,18900,94500,75600
01SCS19E030035,BSC.AR-SD0008,00ARSD0033,S,1,44500,159000,2,0,47700,1,0,22260,111300,89040
01SCS19E030036,BSC.AR-SC0004,00ARSC0032,L,1,125000,315000,2,0,94500,1,0,44100,220500,176400
01SCS19E030037,AR.MPR-SB002,20ARSB0241,XL,1,243750,375000,2,0,75000,1,0,75000,300000,225000
01SCS19E030038,AR.CPT-SC003,20ARSC0249,30,1,227500,350000,2,0,70000,1,0,70000,280000,210000
01SCS19E030038,AR.TUC-SB011,20ARSB0039,ALL,1,97500,150000,2,0,30000,1,0,30000,120000,90000
01SCS19E030038,AR.YD-RL020,20ARRL0058,ALL,1,94250,145000,2,0,72500,1,0,18125,72500,54375
01SCS19E030038,BE.RAK-SA023,00BESA0092,M,1,91000,140000,2,0,28000,1,0,28000,112000,84000
01SCS19E030039,AR.PUB-SB032,20ARSB0463,XL,1,204750,315000,2,0,63000,1,0,63000,252000,189000
01SCS19E030040,BE.RAK-RX624,00BERX2667,L,1,110500,170000,2,0,34000,1,0,34000,136000,102000
01SCS19E030041,AR.STY-RJ003,20ARRJ0052,ALL,1,55250,85000,2,0,17000,1,0,17000,68000,51000
01SCS19E030042,AR.STY-SA018,20ARSA0077,ALL,1,51350,79000,2,0,15800,1,0,15800,63200,47400
01SCS19E030043,BSC.AR-SC0003,00ARSC0025,NON,1,73000,220000,2,0,66000,1,0,30800,154000,123200
01SCS19E030044,BSC.AR-SD0002,00ARSD0005,S,1,44000,159000,2,0,47700,1,0,22260,111300,89040
01SCS19E030045,AR.CPT-SC012,20ARSC0481,L,1,204750,315000,2,0,63000,1,0,63000,252000,189000
01SCS19E030045,AR.TUC-SD014,20ARSD0475,L,1,94250,145000,2,0,29000,1,0,29000,116000,87000
01SCS19E030046,AR.PUB-RJ002,20ARRJ0006,M,1,97500,150000,2,0,30000,1,0,30000,120000,90000
01SCS19E030046,AR.PUB-RJ002,20ARRJ0007,L,1,97500,150000,2,0,30000,1,0,30000,120000,90000
01SCS19E030046,AR.TUC-SB013,20ARSB0201,L,1,94250,145000,2,0,29000,1,0,29000,116000,87000
01SCS19E030046,THR.AR-RB0016,00ARRE0219,NON,1,415000,415000,2,0,41500,1,0,56025,373500,317475
01SCS19E030047,BSC.AR-SC0050,00ARSC0314,L,1,44000,159000,2,0,47700,1,0,22260,111300,89040
01SCS19E030048,AR.RDC-SB002,20ARSB0168,ALL,1,94250,145000,2,0,29000,1,0,29000,116000,87000
01SCS19E030049,ESH.AR-RB0028,00ARRB0153,32,1,130000,350000,2,0,175000,1,0,35000,175000,140000
01SCS19E030050,AR.ESB-RE019,20ARRE0391,M,1,87750,135000,2,0,67500,1,0,16875,67500,50625
01SCS19E030050,BSC.AR-RC0025,00ARRC0166,ALL,1,43000,185000,2,0,85000,1,0,20000,100000,80000
01SCS19E030050,BSC.AR-SC0048,00ARSC0305,M,1,44500,159000,2,0,47700,1,0,22260,111300,89040
01SCS19E030051,AR.SMD-RL001,20ARRL0265,ALL,1,22750,35000,2,0,7000,1,0,7000,28000,21000
01SCS19E030052,ESH.AR-RI0016,00ARRI0144,NON,1,65000,185000,2,0,55500,1,0,25900,129500,103600
01SCS19E030052,ESH.AR-SD0012,00ARSD0078,32,1,145000,375000,2,0,112500,1,0,52500,262500,210000
01SCS19E030053,AR.BPH-RB017,20ARRB0487,ALL,1,103350,159000,2,0,47700,1,0,27825,111300,83475
01SCS19E030053,AR.TUC-SB013,20ARSB0201,L,1,94250,145000,2,0,29000,1,0,29000,116000,87000
01SCS19E030053,BSC.AR-RJ0020,00ARRJ0115,S,1,44500,135000,2,0,40500,1,0,18900,94500,75600
01SCS19E030053,ESH.AR-SC0038,00ARSC0303,NON,1,45000,140000,2,0,42000,1,0,19600,98000,78400
01SCS19E030054,AR.TUC-SD015,20ARSD0478,M,1,145000,145000,2,0,29000,1,0,29000,116000,87000
01SCS19E030055,AR.CPT-SD006,20ARSD0434,M,1,200850,309000,2,0,61800,1,0,61800,247200,185400
01SCS19E030056,AR.FHL-SC002,20ARSC0331,M,1,91000,140000,2,0,28000,1,0,28000,112000,84000
01SCS19E030057,BSC.AR-RL0026,00ARRL0170,S,1,94500,135000,2,0,40500,1,0,18900,94500,75600
01SCS19E030057,ESH.AR-RI0001,00ARRI0070,S,1,94500,135000,2,0,40500,1,0,18900,94500,75600
01SCS19E030058,BSC.AR-SC0009,00ARSC0053,M,1,125000,315000,2,0,94500,1,0,44100,220500,176400
01SCS19E030059,AR.ESB-SB001,20ARSB0023,XL,1,204750,315000,2,0,63000,1,0,63000,252000,189000
01SCS19E030060,AR.MDG-SA008,20ARSA0298,XL,1,195000,300000,2,0,90000,1,0,52500,210000,157500
01SCS19E030060,AR.TUC-SB023,20ARSB0487,ALL,1,87750,135000,2,0,27000,1,0,27000,108000,81000
01SCS19E030060,BSC.AR-RD0021,00ARRD0109,XL,1,42000,135000,2,0,67500,1,0,13500,67500,54000
01SCS19E030060,BSC.AR-RD0040,00ARRD0206,XL,1,110000,315000,2,0,155000,1,0,32000,160000,128000
01SCS19E030060,ESH.AR-RE0008,00ARRE0032,XL,1,42000,135000,2,0,67500,1,0,13500,67500,54000
01SCS19E030061,AR.BPH-RK003,20ARRK0049,XL,1,103350,159000,2,0,47700,1,0,27825,111300,83475
01SCS19E030061,AR.VCS-SC005,20ARSC0391,XL,1,97500,150000,2,0,45000,1,0,26250,105000,78750
01SCS19E030061,BSC.AR-PI0019,00ARPI0019,ALL,1,58334,175000,2,0,75000,1,0,20000,100000,80000
01SCS19E030061,BSC.AR-SC0048,00ARSC0305,M,1,44500,159000,2,0,47700,1,0,22260,111300,89040
01SCS19E030062,ESH.AR-RD0007,00ARRD0054,NON,1,80500,115000,2,0,34500,1,0,16100,80500,64400
01SCS19E030062,ESH.AR-SD0004,00ARSD0046,M,1,44500,135000,2,0,40500,1,0,18900,94500,75600
01SCS19E030063,AR.MKV-RE036,20ARRE1405,S,1,165750,255000,2,0,51000,1,0,51000,204000,153000
01SCS19E030063,ESH.AR-SC0005,00ARSC0026,S,1,125000,315000,2,0,94500,1,0,44100,220500,176400
01SCS19E030064,BSC.AR-RC0034,00ARRC0237,XL,1,120000,360000,2,0,185000,1,0,35000,175000,140000
01SCS19E030065,AR.MKV-SD004,20ARSD0230,28,1,117000,180000,2,0,36000,1,0,36000,144000,108000
01SCS19E030065,AR.SMD-QF005,20ARQF0702,S,1,104000,160000,2,0,48000,1,0,28000,112000,84000
01SCS19E030066,ESH.AR-SB0017,00ARSB0100,NON,1,41000,120000,2,0,36000,1,0,16800,84000,67200
01SCS19E030067,BSC.AR-RL0027,00ARRL0177,XL,1,94500,135000,2,0,40500,1,0,18900,94500,75600
01SCS19E030067,BSC.AR-SB0020,00ARSB0170,XL,1,44000,135000,2,0,40500,1,0,18900,94500,75600
01SCS19E030068,AR.CLK-RK002,20ARRK0244,ALL,1,91000,140000,2,0,28000,1,0,28000,112000,84000
01SCS19E030068,AR.TUC-SD008,20ARSD0168,ALL,1,81250,125000,2,0,25000,1,0,25000,100000,75000
01SCS19E030069,AR.CPT-RI006,20ARRI0061,M,1,94250,145000,2,0,29000,1,0,29000,116000,87000
01SCS19E030070,AR.MDG-SC002,20ARSC0157,XL,1,94250,145000,2,0,43500,1,0,25375,101500,76125
01SCS19E030071,AR.MKV-RC001,20ARRC0203,M,1,214500,330000,2,0,66000,1,0,66000,264000,198000
01SCS19E030072,AR.MYA-SD003,20ARSD0255,34,1,207350,319000,2,0,159500,1,0,39875,159500,119625
01SCS19E030073,ESH.AR-SD0029,00ARSD0278,NON,1,58000,175000,2,0,52500,1,0,24500,122500,98000
01SCS19E030074,AR.MKV-RL002,20ARRL0239,S,1,204750,315000,2,0,63000,1,0,63000,252000,189000
01SCS19E030074,BSC.AR-PI0088,00ARPI0253,S,1,95000,285000,2,0,125000,1,0,32000,160000,128000
01SCS19E030075,BSC.AR-RL0018,00ARRL0109,S,1,125000,315000,2,0,94500,1,0,44100,220500,176400
01SCS19E030076,AR.PUB-SB028,20ARSB0146,L,1,224250,345000,2,0,69000,1,0,69000,276000,207000
01SCS19E030076,BSC.AR-RH0024,00ARRH0157,L,1,245000,350000,2,0,105000,1,0,49000,245000,196000
01SCS19E030076,BSC.AR-RJ0012,00ARRJ0085,L,1,44500,135000,2,0,40500,1,0,18900,94500,75600
01SCS19E030076,BSC.AR-SD0063,00ARSD0338,NON,1,60000,180000,2,0,54000,1,0,25200,126000,100800
01SCS19E030077,BSC.AR-SD0055,00ARSD0288,NON,1,50000,150000,2,0,45000,1,0,21000,105000,84000
01SCS19E030078,AR.PUB-SB001,20ARSB0005,ALL,1,97500,150000,2,0,30000,1,0,30000,120000,90000
01SCS19E030079,AR.PUB-RG024,20ARRG0128,ALL,1,97500,150000,2,0,30000,1,0,30000,120000,90000
01SCS19E030080,ESH.AR-RK0014,00ARRK0189,L,1,245000,350000,2,0,105000,1,0,49000,245000,196000
01SCS19E030081,AR.ESB-SB001,20ARSB0020,S,1,204750,315000,2,0,63000,1,0,63000,252000,189000
01SCS19E030082,AR.SMD-RL001,20ARRL0265,ALL,1,22750,35000,2,0,7000,1,0,7000,28000,21000
01SCS19E030082,THR.AR-RG0016,00ARRG0081,NON,1,45000,45000,2,0,4500,1,0,6075,40500,34425
01SCS19E030082,THR.AR-RG0019,00ARRG0084,NON,1,45000,45000,2,0,4500,1,0,6075,40500,34425
01SCS19E030083,AR.TUC-SB016,20ARSB0471,L,1,87750,135000,2,0,27000,1,0,27000,108000,81000
01SCS19E030084,AR.YD-SC001,20ARSC0019,L,1,195000,300000,2,0,90000,1,0,52500,210000,157500
01SCS19E030085,BE.RAK-SB013,00BESB0063,L,1,201500,310000,2,0,62000,1,0,62000,248000,186000
01SCS19E030086,BE.RAK-SB012,00BESB0058,L,1,201500,310000,2,0,62000,1,0,62000,248000,186000
01SCS19E030086,BE.RAK-SC009,00BESC0020,L,1,91000,140000,2,0,28000,1,0,28000,112000,84000
01SCS19E030087,ESH.AR-SC0028,00ARSC0265,S,1,44500,135000,2,0,40500,1,0,18900,94500,75600
01SCS19E030088,AR.MPR-SB005,20ARSB0252,L,1,230750,355000,2,0,71000,1,0,71000,284000,213000
01SCS19E030089,BSC.AR-SC0050,00ARSC0314,L,1,44000,159000,2,0,47700,1,0,22260,111300,89040
01SCS19E030090,ESH.AR-QH0004,00ARQH0004,ALL,1,37800,140000,2,0,90000,1,0,10000,50000,40000
01SCS19E030090,ESH.AR-RD0021,00ARRD0192,M,1,42000,135000,2,0,67500,1,0,13500,67500,54000
01SCS19E030090,ESH.AR-RE0008,00ARRE0031,L,1,42000,135000,2,0,67500,1,0,13500,67500,54000
01SCS19E030091,BSC.AR-PI0088,00ARPI0255,L,1,95000,285000,2,0,125000,1,0,32000,160000,128000
01SCS19E030092,BSC.AR-RH0026,00ARRH0165,32,1,245000,350000,2,0,105000,1,0,49000,245000,196000
01SCS19E030093,AR.FHL-SB001,20ARSB0095,XL,1,292500,450000,2,0,90000,1,0,90000,360000,270000
01SCS19E030094,AR.KNR-RK008,20ARRK0279,L,1,152750,235000,2,0,70500,1,0,41125,164500,123375
01SCS19E030094,BSC.AR-SC0001,00ARSC0014,M,1,125000,315000,2,0,94500,1,0,44100,220500,176400
01SCS19E030095,BSC.AR-QE0012,00ARQE0095,M,1,125000,375000,2,0,200000,1,0,35000,175000,140000
01SCS19E030096,BE.RAK-RL025,00BERL0087,L,1,195000,300000,2,0,60000,1,0,60000,240000,180000
01SCS19E030097,ESH.AR-SD0021,00ARSD0165,M,1,125000,315000,2,0,94500,1,0,44100,220500,176400
01SCS19E030098,AR.TUC-SD011,20ARSD0462,M,1,94250,145000,2,0,29000,1,0,29000,116000,87000
01SCS19E030099,BSC.AR-RH0017,00ARRH0076,L,1,120000,315000,2,0,94500,1,0,44100,220500,176400
01SCS19E030100,BSC.AR-SD0038,00ARSD0209,L,1,125000,315000,2,0,94500,1,0,44100,220500,176400
01SCS19E030101,AR.MKV-SA003,20ARSA0189,ALL,1,87750,135000,2,0,27000,1,0,27000,108000,81000
01SCS19E030101,AR.YD-RL010,20ARRL0026,ALL,1,55250,85000,2,0,25500,1,0,14875,59500,44625
01SCS19E030101,BSC.AR-SD0042,00ARSD0230,XL,1,44500,159000,2,0,47700,1,0,22260,111300,89040
01SCS19E030102,AR.CPT-SD003,20ARSD0139,ALL,1,94250,145000,2,0,29000,1,0,29000,116000,87000
01SCS19E030102,BSC.AR-SA0009,00ARSA0035,NON,1,47500,140000,2,0,42000,1,0,19600,98000,78400
01SCS19E030103,ESH.AR-RH0008,00ARRH0060,NON,1,45000,150000,2,0,45000,1,0,21000,105000,84000
01SCS19E030104,BSC.AR-RI0027,00ARRI0136,NON,1,43000,140000,2,0,42000,1,0,19600,98000,78400
01SCS19E030105,BSC.AR-SB0019,00ARSB0165,L,1,125000,315000,2,0,94500,1,0,44100,220500,176400
01SCS19E030105,BSC.AR-SD0058,00ARSD0294,NON,1,50000,150000,2,0,45000,1,0,21000,105000,84000
01SCS19E030106,AR.PUB-SB022,20ARSB0121,M,1,97500,150000,2,0,30000,1,0,30000,120000,90000
01SCS19E030106,BSC.AR-SC0001,00ARSC0014,M,1,125000,315000,2,0,94500,1,0,44100,220500,176400
01SCS19E030107,ESH.AR-SD0022,00ARSD0168,NON,1,43000,120000,2,0,36000,1,0,16800,84000,67200
01SCS19E030108,BSC.AR-RL0020,00ARRL0117,S,1,125000,315000,2,0,94500,1,0,44100,220500,176400
01SCS19E030109,BE.RAK-SA019,00BESA0074,XL,1,91000,140000,2,0,28000,1,0,28000,112000,84000
01SCS19E030110,AR.YD-RL014,20ARRL0035,L,1,195000,300000,2,0,150000,1,0,37500,150000,112500
01SCS19E030111,BSC.AR-SA0015,00ARSA0043,S,1,44500,135000,2,0,40500,1,0,18900,94500,75600
01SCS19E030112,AR.TUC-SA009,20ARSA0027,ALL,1,87750,135000,2,0,27000,1,0,27000,108000,81000
01SCS19E030113,ESH.AR-SD0039,00ARSD0350,XL,1,122500,350000,2,0,105000,1,0,49000,245000,196000
01SCS19E030114,BE.RAK-SB030,00BESB0095,ALL,1,104000,160000,2,0,32000,1,0,32000,128000,96000
01SCS19E030115,ESH.AR-SA0008,00ARSA0084,M,1,113450,350000,2,0,105000,1,0,49000,245000,196000
01SCS19E030116,AR.PUB-SE013,20ARSE0050,M,1,159250,245000,2,0,49000,1,0,49000,196000,147000
01SCS19E030117,BSC.AR-SA0015,00ARSA0045,L,1,44500,135000,2,0,40500,1,0,18900,94500,75600
01SCS19E030117,BSC.AR-SC0011,00ARSC0066,L,1,44000,159000,2,0,47700,1,0,22260,111300,89040
01SCS19E030118,AR.TUC-SB016,20ARSB0469,S,1,87750,135000,2,0,27000,1,0,27000,108000,81000
01SCS19E030119,BE.RAK-SC001,00BESC0001,ALL,1,22750,35000,2,0,7000,1,0,7000,28000,21000
01SCS19E030120,BSC.AR-SB0003,00ARSB0043,S,1,125000,315000,2,0,94500,1,0,44100,220500,176400
01SCS19E030121,ESH.AR-QE0029,00ARQE0163,L,1,110000,325000,2,0,165000,1,0,32000,160000,128000
01SCS19E030122,ESH.AR-SD0012,00ARSD0078,32,1,145000,375000,2,0,112500,1,0,52500,262500,210000
01SCS19E030123,AR.CPT-SC001,20ARSC0243,ALL,1,97500,150000,2,0,30000,1,0,30000,120000,90000
01SCS19E030124,BSC.AR-SC0009,00ARSC0052,S,1,125000,315000,2,0,94500,1,0,44100,220500,176400
01SCS19E030125,AR.HMR-SB029,20ARSB0435,34,1,96850,149000,2,0,29800,1,0,29800,119200,89400
01SCS19E030125,AR.PUB-RK011,20ARSD0351,XL,1,113750,175000,2,0,35000,1,0,35000,140000,105000
01SCS19E030125,BSC.AR-SC0009,00ARSC0054,L,1,125000,315000,2,0,94500,1,0,44100,220500,176400
01SCS19E030126,AR.VCS-SC004,20ARSC0385,M,1,97500,150000,2,0,45000,1,0,26250,105000,78750
01SCS19E030127,AR.PUB-SD030,20ARSD0209,30,1,211250,325000,2,0,65000,1,0,65000,260000,195000
01SCS19E030128,ESH.AR-RE0014,00ARRE0094,M,1,105000,330000,2,0,155000,1,0,35000,175000,140000
01SCS19E030129,BSC.AR-SB0019,00ARSB0165,L,1,125000,315000,2,0,94500,1,0,44100,220500,176400
01SCS19E030130,BSC.AR-RJ0030,00ARRJ0199,L,1,220500,315000,2,0,94500,1,0,44100,220500,176400
01SCS19E030131,ESH.AR-QJ0013,00ARQJ0047,L,1,100000,345000,2,0,170000,1,0,35000,175000,140000
01SCS19E030132,AR.PUB-RJ039,20ARRJ0508,XL,1,97500,150000,2,0,30000,1,0,30000,120000,90000
01SCS19E030133,BSC.AR-RJ0013,00ARRJ0088,M,1,44500,135000,2,0,40500,1,0,18900,94500,75600
01SCS19E030133,BSC.AR-RK0007,00ARRK0074,M,1,52000,155000,2,0,46500,1,0,21700,108500,86800
01SCS19E030134,ESH.AR-SD0040,00ARSD0366,S,1,122500,350000,2,0,105000,1,0,49000,245000,196000
01SCS19E030135,AR.ESB-SB003,20ARSB0102,L,1,100750,155000,2,0,31000,1,0,31000,124000,93000
01SCS19E030136,AR.ESB-RE015,20ARRE0379,M,1,87750,135000,2,0,67500,1,0,16875,67500,50625
01SCS19E030137,AR.PUB-RI025,20ARRI0312,L,1,97500,150000,2,0,30000,1,0,30000,120000,90000
01SCS19E030138,AR.MKV-RJ005,20ARRJ0161,M,1,91000,140000,2,0,28000,1,0,28000,112000,84000
01SCS19E030138,AR.VRS-SC004,20ARSC0175,M,1,96850,149000,2,0,44700,1,0,26075,104300,78225
01SCS19E030139,ESH.AR-RH0024,00ARRH0142,XL,1,115000,315000,2,0,155000,1,0,32000,160000,128000
01SCS19E030140,AR.ASH-RJ002,20ARRJ0123,30,1,273000,420000,2,0,210000,1,0,52500,210000,157500
01SCS19E030141,AR.CPT-RK010,20ARRK0032,ALL,1,48750,75000,2,0,15000,1,0,15000,60000,45000
01SCS19E030142,BSC.AR-SD0028,00ARSD0163,XL,1,125000,315000,2,0,94500,1,0,44100,220500,176400
01SCS19E030143,BSC.AR-SB0015,00ARSB0127,S,1,125000,315000,2,0,94500,1,0,44100,220500,176400
01SCS19E030144,AR.YD-SC001,20ARSC0017,S,1,195000,300000,2,0,90000,1,0,52500,210000,157500
01SCS19E030145,AR.MKV-SD002,20ARSD0222,S,1,97500,150000,2,0,30000,1,0,30000,120000,90000
01SCS19E030146,BSC.AR-SA0004,00ARSA0019,M,1,125000,315000,2,0,94500,1,0,44100,220500,176400
01SCS19E030147,AR.PUB-SE025,20ARSE0096,M,1,159250,245000,2,0,49000,1,0,49000,196000,147000
01SCS19E030147,ESH.AR-RG0003,00ARRG0006,S,1,90000,255000,2,0,76500,1,0,35700,178500,142800
01SCS19E030147,ESH.AR-RJ0014,00ARRJ0180,M,1,44500,135000,2,0,40500,1,0,18900,94500,75600
01SCS19E030148,AR.PUB-SB033,20ARSB0464,ALL,1,97500,150000,2,0,30000,1,0,30000,120000,90000
01SCS19E030149,ESH.AR-RC0029,00ARRC0190,ALL,1,45000,150000,2,0,100000,1,0,10000,50000,40000
01SCS19E030150,AR.CPT-RE012,20ARRE0715,L,1,94250,145000,2,0,29000,1,0,29000,116000,87000
01SCS19E030151,ESH.AR-RD0021,00ARRD0191,S,1,42000,135000,2,0,67500,1,0,13500,67500,54000
01SCS19E030151,ESH.AR-RE0004,00ARRE0014,M,1,42000,135000,2,0,67500,1,0,13500,67500,54000
01SCS19E030152,BSC.AR-RI0025,00ARRI0134,NON,1,98000,140000,2,0,42000,1,0,19600,98000,78400
01SCS19E030152,ESH.AR-SA0012,00ARSA0094,M,1,44000,135000,2,0,40500,1,0,18900,94500,75600
01SCS19E030153,AR.CPT-SD003,20ARSD0139,ALL,1,94250,145000,2,0,29000,1,0,29000,116000,87000
01SCS19E030154,AR.PCT-RJ007,20ARRJ0288,ALL,1,178750,275000,2,0,55000,1,0,55000,220000,165000
01SCS19E030155,AR.CPT-RI007,20ARRI0066,L,1,94250,145000,2,0,29000,1,0,29000,116000,87000
01SCS19E030156,BE.RAK-SB001,00BESB0004,XL,1,217750,335000,2,0,67000,1,0,67000,268000,201000
01SCS19E030157,AR.ESB-RE015,20ARRE0379,M,1,87750,135000,2,0,67500,1,0,16875,67500,50625
01SCS19E030157,AR.SMD-RL001,20ARRL0265,ALL,1,22750,35000,2,0,7000,1,0,7000,28000,21000
01SCS19E030157,ESH.AR-RD0020,00ARRD0189,L,1,43000,150000,2,0,82500,1,0,13500,67500,54000
01SCS19E030157,ESH.AR-RD0021,00ARRD0193,L,1,42000,135000,2,0,67500,1,0,13500,67500,54000
01SCS19E030158,BSC.AR-SD0019,00ARSD0124,NON,1,45000,150000,2,0,45000,1,0,21000,105000,84000
01SCS19E030159,AR.MYA-SD005,20ARSD0261,XL,1,285350,439000,2,0,219500,1,0,54875,219500,164625
01SCS19E030160,AR.TUC-SC006,20ARSC0064,28,1,204750,315000,2,0,63000,1,0,63000,252000,189000
01SCS19E030161,BSC.AR-SD0060,00ARSD0332,NON,1,45000,140000,2,0,42000,1,0,19600,98000,78400
01SCS19E030162,BE.RAK-RX538,00BERX2230,M,1,91000,140000,2,0,28000,1,0,28000,112000,84000
01SCS19E030163,AR.MKV-SC004,20ARSC0079,M,1,253500,390000,2,0,78000,1,0,78000,312000,234000
01SCS19E030163,ESH.AR-PL0015,00ARPL0126,M,1,110000,325000,2,0,165000,1,0,32000,160000,128000
01SCS19E030163,ESH.AR-SD0029,00ARSD0278,NON,1,58000,175000,2,0,52500,1,0,24500,122500,98000
01SCS19E030164,AR.CPT-SC001,20ARSC0243,ALL,1,97500,150000,2,0,30000,1,0,30000,120000,90000
01SCS19E030165,ESH.AR-SC0010,00ARSC0081,M,1,44500,135000,2,0,40500,1,0,18900,94500,75600
01SCS19E030166,AR.ESB-RH012,20ARRH0479,M,1,198250,305000,2,0,61000,1,0,61000,244000,183000
01SCS19E030166,AR.TUC-SD003,20ARSD0149,M,1,204750,315000,2,0,63000,1,0,63000,252000,189000
01SCS19E040001,AR.MKV-QF025,20ARQF0806,34,1,224250,345000,2,0,172500,1,0,43125,172500,129375
01SCS19E040002,ESH.AR-SE0001,00ARSE0002,M,1,44000,135000,2,0,40500,1,0,18900,94500,75600
01SCS19E040003,AR.MKV-SC017,20ARSC0221,L,1,117000,180000,2,0,36000,1,0,36000,144000,108000
01SCS19E040004,AR.PUB-SD019,20ARSD0188,ALL,1,97500,150000,2,0,30000,1,0,30000,120000,90000
01SCS19E040004,AR.STY-SE007,20ARSE0125,ALL,1,55250,85000,2,0,17000,1,0,17000,68000,51000
01SCS19E040005,BSC.AR-RD0040,00ARRD0205,L,1,110000,315000,2,0,155000,1,0,32000,160000,128000
01SCS19E040005,ESH.AR-QJ0013,00ARQJ0047,L,1,100000,345000,2,0,170000,1,0,35000,175000,140000
01SCS19E040006,BSC.AR-RK0010,00ARRK0088,XL,1,94500,135000,2,0,40500,1,0,18900,94500,75600
01SCS19E040006,BSC.AR-SD0022,00ARSD0131,XL,1,44000,159000,2,0,47700,1,0,22260,111300,89040
01SCS19E040007,ESH.AR-RC0024,00ARRC0181,L,1,42000,135000,2,0,67500,1,0,13500,67500,54000
01SCS19E040007,ESH.AR-RC0026,00ARRC0187,ALL,1,55000,150000,2,0,100000,1,0,10000,50000,40000
01SCS19E040007,ESH.AR-RC0039,00ARRC0224,L,1,42000,135000,2,0,67500,1,0,13500,67500,54000
01SCS19E040008,ESH.AR-RK0006,00ARRK0026,M,1,43000,135000,2,0,40500,1,0,18900,94500,75600
01SCS19E040009,AR.PUB-RG005,20ARRG0037,XL,1,97500,150000,2,0,30000,1,0,30000,120000,90000
01SCS19E040010,AR.CPT-RE010,20ARRE0706,M,1,204750,315000,2,0,63000,1,0,63000,252000,189000
01SCS19E040010,ESH.AR-QH0026,00ARQH0137,ALL,1,39700,140000,2,0,90000,1,0,10000,50000,40000
01SCS19E040011,ESH.AR-SD0021,00ARSD0164,S,1,125000,315000,2,0,94500,1,0,44100,220500,176400
01SCS19E040012,AR.TUC-RI002,20ARRI0095,ALL,1,87750,135000,2,0,27000,1,0,27000,108000,81000
01SCS19E040013,AR.SMD-RE007,20ARRE0786,XL,1,87750,135000,2,0,40500,1,0,23625,94500,70875
01SCS19E040013,AR.TUC-QH027,20ARQH0349,XL,1,97500,150000,2,0,30000,1,0,30000,120000,90000
01SCS19E040014,AR.FHL-SC005,20ARSC0345,XL,1,110500,170000,2,0,34000,1,0,34000,136000,102000
01SCS19E040014,BSC.AR-SD0012,00ARSD0105,NON,1,18000,75000,2,0,22500,1,0,10500,52500,42000
01SCS19E040014,ESH.AR-SD0008,00ARSD0064,XL,1,44500,135000,2,0,40500,1,0,18900,94500,75600
01SCS19E040015,BSC.AR-SB0006,00ARSB0071,M,1,44000,135000,2,0,40500,1,0,18900,94500,75600
01SCS19E040016,AR.ESB-RK001,20ARRK0224,M,1,201500,310000,2,0,62000,1,0,62000,248000,186000
01SCS19E040017,AR.FHL-RJ002,20ARRJ0422,L,1,91000,140000,2,0,28000,1,0,28000,112000,84000
01SCS19E040017,AR.MER-SB005,20ARSB0228,L,1,97500,150000,2,0,45000,1,0,26250,105000,78750
01SCS19E040017,AR.VCS-SC002,20ARSC0378,L,1,97500,150000,2,0,45000,1,0,26250,105000,78750
01SCS19E040017,AR.VRS-SC003,20ARSC0173,XL,1,96850,149000,2,0,44700,1,0,26075,104300,78225
01SCS19E040018,BSC.AR-SC0007,00ARSC0043,M,1,44000,135000,2,0,40500,1,0,18900,94500,75600
01SCS19E040018,BSC.AR-SC0033,00ARSC0224,S,1,125000,315000,2,0,94500,1,0,44100,220500,176400
01SCS19E040019,ESH.AR-SB0028,00ARSB0171,S,1,44000,135000,2,0,40500,1,0,18900,94500,75600
01SCS19E040020,BSC.AR-SC0017,00ARSC0117,M,1,44500,135000,2,0,40500,1,0,18900,94500,75600
01SCS19E040021,AR.TUC-SB004,20ARSB0032,ALL,1,61750,95000,2,0,19000,1,0,19000,76000,57000
01SCS19E040021,BSC.AR-RH0009,00ARRH0053,NON,1,98000,140000,2,0,42000,1,0,19600,98000,78400
01SCS19E040021,BSC.AR-SD0043,00ARSD0232,M,1,44500,159000,2,0,47700,1,0,22260,111300,89040
01SCS19E040022,AR.ESB-RH012,20ARRH0479,M,1,198250,305000,2,0,61000,1,0,61000,244000,183000
01SCS19E040022,AR.RDC-RI003,20ARRI0241,ALL,1,94250,145000,2,0,29000,1,0,29000,116000,87000
01SCS19E040022,BSC.AR-RH0018,00ARRH0079,M,1,120000,315000,2,0,94500,1,0,44100,220500,176400
01SCS19E040022,ESH.AR-SB0024,00ARSB0156,NON,1,35300,120000,2,0,36000,1,0,16800,84000,67200
01SCS19E040023,AR.TUC-SD014,20ARSD0476,XL,1,94250,145000,2,0,29000,1,0,29000,116000,87000
01SCS19E040024,AR.TUC-SD007,20ARSD0165,M,1,185250,285000,2,0,57000,1,0,57000,228000,171000
01SCS19E040024,BSC.AR-SA0008,00ARSA0034,NON,1,47500,140000,2,0,42000,1,0,19600,98000,78400
01SCS19E040025,ESH.AR-SD0018,00ARSD0136,S,1,125000,315000,2,0,94500,1,0,44100,220500,176400
01SCS19E040026,ESH.AR-SA0008,00ARSA0083,S,1,113450,350000,2,0,105000,1,0,49000,245000,196000
01SCS19E040027,AR.PUB-SB032,20ARSB0461,M,1,204750,315000,2,0,63000,1,0,63000,252000,189000
01SCS19E040028,AR.CPT-SD008,20ARSD0442,M,1,204750,315000,2,0,63000,1,0,63000,252000,189000
01SCS19E040029,AR.MKV-QH011,20ARQH0216,ALL,1,175500,270000,2,0,135000,1,0,33750,135000,101250
01SCS19E040030,ESH.AR-RG0005,00ARRG0100,S,1,94500,135000,2,0,40500,1,0,18900,94500,75600
01SCS19E040031,AR.HMR-SB023,20ARSB0408,36,1,204750,315000,2,0,63000,1,0,63000,252000,189000
01SCS19E040032,BE.RAK-SB031,00BESB0096,ALL,1,97500,150000,2,0,30000,1,0,30000,120000,90000
01SCS19E040032,ESH.AR-SA0010,00ARSA0091,NON,1,53000,155000,2,0,46500,1,0,21700,108500,86800
01SCS19E040033,AR.TUC-SB022,20ARSB0486,ALL,1,87750,135000,2,0,27000,1,0,27000,108000,81000
01SCS19E040034,AR.PUB-SE021,20ARSE0079,S,1,159250,245000,2,0,49000,1,0,49000,196000,147000
01SCS19E040035,BSC.AR-RI0001,00ARRI0002,M,1,315000,450000,2,0,135000,1,0,63000,315000,252000
01SCS19E040036,AR.CPT-SB001,20ARSB0084,L,1,204750,315000,2,0,63000,1,0,63000,252000,189000
01SCS19E040036,ESH.AR-QH0004,00ARQH0004,ALL,1,37800,140000,2,0,90000,1,0,10000,50000,40000
01SCS19E040036,ESH.AR-RE0002,00ARRE0006,M,1,42000,135000,2,0,67500,1,0,13500,67500,54000
01SCS19E040036,ESH.AR-RE0019,00ARRE0205,M,1,43000,150000,2,0,82500,1,0,13500,67500,54000
01SCS19E040037,AR.TUC-RJ002,20ARRJ0106,ALL,1,22750,35000,2,0,7000,1,0,7000,28000,21000
01SCS19E040038,BSC.AR-SC0024,00ARSC0178,M,1,125000,315000,2,0,94500,1,0,44100,220500,176400
01SCS19E040038,BSC.AR-SC0044,00ARSC0296,NON,1,45000,150000,2,0,45000,1,0,21000,105000,84000
01SCS19E040039,ESH.AR-SC0019,00ARSC0150,M,1,125000,315000,2,0,94500,1,0,44100,220500,176400
01SCS19E040040,AR.YAS-RL009,20ARRL0229,ALL,1,97500,150000,2,0,30000,1,0,30000,120000,90000
01SCS19E040041,ESH.AR-QH0026,00ARQH0137,ALL,1,39700,140000,2,0,90000,1,0,10000,50000,40000
01SCS19E040042,ESH.AR-SE0001,00ARSE0001,S,1,44000,135000,2,0,40500,1,0,18900,94500,75600
01SCS19E040043,AR.TUC-RK038,20ARRK0165,M,1,94250,145000,2,0,72500,1,0,18125,72500,54375
01SCS19E040044,ESH.AR-QJ0013,00ARQJ0047,L,1,100000,345000,2,0,170000,1,0,35000,175000,140000
01SCS19E040045,BSC.AR-SD0043,00ARSD0231,S,1,44500,159000,2,0,47700,1,0,22260,111300,89040
01SCS19E040045,ESH.AR-SB0007,00ARSB0027,S,1,44000,135000,2,0,40500,1,0,18900,94500,75600
01SCS19E040046,ESH.AR-SC0016,00ARSC0138,L,1,44000,135000,2,0,40500,1,0,18900,94500,75600
01SCS19E040047,AR.STY-RK003,20ARRK0525,ALL,1,61750,95000,2,0,19000,1,0,19000,76000,57000
01SCS19E040048,BSC.AR-RH0009,00ARRH0053,NON,1,98000,140000,2,0,42000,1,0,19600,98000,78400
01SCS19E040049,BSC.AR-RI0035,00ARRI0209,M,1,120000,315000,2,0,94500,1,0,44100,220500,176400
01SCS19E040050,ESH.AR-SB0024,00ARSB0156,NON,1,35300,120000,2,0,36000,1,0,16800,84000,67200
01SCS19E040051,AR.TUC-RL025,20ARRL0349,ALL,1,87750,135000,2,0,27000,1,0,27000,108000,81000
01SCS19E040051,ESH.AR-SC0034,00ARSC0293,M,1,125000,315000,2,0,94500,1,0,44100,220500,176400
01SCS19E040052,AR.MKV-PL013,20ARPL0441,XL,1,91000,140000,2,0,70000,1,0,17500,70000,52500
01SCS19E040052,AR.TUC-SD017,20ARSD0486,M,1,94250,145000,2,0,29000,1,0,29000,116000,87000
01SCS19E040052,AR.TUC-SD021,20ARSD0503,L,1,94250,145000,2,0,29000,1,0,29000,116000,87000
01SCS19E040053,ESH.AR-SA0001,00ARSA0013,28,1,122500,175000,2,0,52500,1,0,24500,122500,98000
01SCS19E040054,BSC.AR-RJ0011,00ARRJ0081,L,1,44500,135000,2,0,40500,1,0,18900,94500,75600
01SCS19E040055,ESH.AR-SB0021,00ARSB0119,S,1,44500,135000,2,0,40500,1,0,18900,94500,75600
01SCS19E040056,AR.STY-SC002,20ARSC0201,ALL,1,77350,119000,2,0,23800,1,0,23800,95200,71400
01SCS19E040057,AR.MKV-RJ031,20ARRJ0453,34,1,214500,330000,2,0,66000,1,0,66000,264000,198000
01SCS19E040057,AR.STY-SE007,20ARSE0125,ALL,1,55250,85000,2,0,17000,1,0,17000,68000,51000
01SCS19E040058,BSC.AR-RL0022,00ARRL0141,S,1,94500,135000,2,0,40500,1,0,18900,94500,75600
01SCS19E040058,BSC.AR-SD0010,00ARSD0103,NON,1,18000,75000,2,0,22500,1,0,10500,52500,42000
01SCS19E040059,AR.MKV-SC018,20ARSC0223,ALL,1,91000,140000,2,0,70000,1,0,17500,70000,52500
01SCS19E040059,BSC.AR-RJ0013,00ARRJ0087,S,1,44500,135000,2,0,40500,1,0,18900,94500,75600
01SCS19E040060,BSC.AR-SC0017,00ARSC0117,M,1,44500,135000,2,0,40500,1,0,18900,94500,75600
01SCS19E040061,BSC.AR-SA0021,00ARSA0105,S,1,44000,135000,2,0,40500,1,0,18900,94500,75600
01SCS19E040061,ESH.AR-RG0003,00ARRG0006,S,1,90000,255000,2,0,76500,1,0,35700,178500,142800
01SCS19E040062,BE.RAK-SA027,00BESA0112,M,1,104000,160000,2,0,32000,1,0,32000,128000,96000
01SCS19E040062,BE.RAK-SB035,00BESB0106,L,1,91000,140000,2,0,28000,1,0,28000,112000,84000
01SCS19E040063,AR.MKV-SC003,20ARSC0077,ALL,1,87750,135000,2,0,27000,1,0,27000,108000,81000
01SCS19E040064,ESH.AR-QH0026,00ARQH0137,ALL,1,39700,140000,2,0,90000,1,0,10000,50000,40000
01SCS19E040065,AR.PCT-RJ002,20ARRJ0281,M,1,211250,325000,2,0,97500,1,0,56875,227500,170625
01SCS19E040066,AR.BPH-RL003,20ARRL0189,M,1,291850,449000,2,0,224500,1,0,56125,224500,168375
01SCS19E040066,AR.PUB-SC004,20ARSC0114,ALL,1,48750,75000,2,0,15000,1,0,15000,60000,45000
01SCS19E040066,AR.PUB-SE017,20ARSE0066,M,1,159250,245000,2,0,49000,1,0,49000,196000,147000
01SCS19E040066,AR.SMD-SD017,20ARSD0579,ALL,1,97500,150000,2,0,30000,1,0,30000,120000,90000
01SCS19E040066,AR.TUC-SA013,20ARSA0032,M,1,204750,315000,2,0,63000,1,0,63000,252000,189000
01SCS19E040066,AR.TUC-SB009,20ARSB0037,ALL,1,97500,150000,2,0,30000,1,0,30000,120000,90000
01SCS19E040066,ESH.AR-SD0022,00ARSD0168,NON,1,43000,120000,2,0,36000,1,0,16800,84000,67200
01SCS19E040066,ESH.AR-SE0001,00ARSE0001,S,1,44000,135000,2,0,40500,1,0,18900,94500,75600
01SCS19E040067,BSC.AR-RL0018,00ARRL0109,S,1,125000,315000,2,0,94500,1,0,44100,220500,176400
01SCS19E040068,AR.MKV-RB001,20ARRB0024,L,1,312000,480000,2,0,240000,1,0,60000,240000,180000
01SCS19E040069,AR.ESB-SD009,20ARSD0181,L,1,91000,140000,2,0,28000,1,0,28000,112000,84000
01SCS19E040069,BSC.AR-SB0007,00ARSB0075,M,1,44500,135000,2,0,40500,1,0,18900,94500,75600
01SCS19E040070,ESH.AR-SB0032,00ARSB0208,S,1,125000,315000,2,0,94500,1,0,44100,220500,176400
01SCS19E040071,ESH.AR-SC0001,00ARSC0002,M,1,125000,315000,2,0,94500,1,0,44100,220500,176400
01SCS19E040072,AR.MKV-SA005,20ARSA0193,32,1,243750,375000,2,0,75000,1,0,75000,300000,225000
01SCS19E040073,ESH.AR-QH0026,00ARQH0137,ALL,1,39700,140000,2,0,90000,1,0,10000,50000,40000
01SCS19E040074,ESH.AR-SA0013,00ARSA0097,S,1,44000,135000,2,0,40500,1,0,18900,94500,75600
01SCS19E040074,ESH.AR-SA0013,00ARSA0098,M,2,44000,135000,2,0,40500,1,0,18900,189000,151200
01SCS19E040074,ESH.AR-SA0013,00ARSA0099,L,2,44000,135000,2,0,40500,1,0,18900,189000,151200
01SCS19E040074,ESH.AR-SB0028,00ARSB0172,M,2,44000,135000,2,0,40500,1,0,18900,189000,151200
01SCS19E040074,ESH.AR-SB0028,00ARSB0173,L,2,44000,135000,2,0,40500,1,0,18900,189000,151200
01SCS19E040074,ESH.AR-SB0028,00ARSB0174,XL,1,44000,135000,2,0,40500,1,0,18900,94500,75600
01SCS19E040075,BSC.AR-RJ0013,00ARRJ0088,M,1,44500,135000,2,0,40500,1,0,18900,94500,75600
01SCS19E040075,ESH.AR-RA0015,00ARRA0072,ALL,1,38000,140000,2,0,90000,1,0,10000,50000,40000
01SCS19E040076,BSC.AR-RI0001,00ARRI0003,L,1,315000,450000,2,0,135000,1,0,63000,315000,252000
01SCS19E040076,ESH.AR-QK0012,00ARQK0073,L,1,100000,310000,2,0,150000,1,0,32000,160000,128000
01SCS19E040076,ESH.AR-SC0004,00ARSC0023,L,1,44500,135000,2,0,40500,1,0,18900,94500,75600
01SCS19E040077,BSC.AR-SD0043,00ARSD0232,M,1,44500,159000,2,0,47700,1,0,22260,111300,89040
01SCS19E040078,ESH.AR-PK0043,00ARPK0199,M,1,110000,325000,2,0,165000,1,0,32000,160000,128000
01SCS19E040079,ESH.AR-SC0005,00ARSC0026,S,1,125000,315000,2,0,94500,1,0,44100,220500,176400
01SCS19E040080,BSC.AR-RL0028,00ARRL0178,S,1,94500,135000,2,0,40500,1,0,18900,94500,75600
01SCS19E040080,ESH.AR-SD0008,00ARSD0061,S,1,44500,135000,2,0,40500,1,0,18900,94500,75600
01SCS19E040081,AR.PUB-SE013,20ARSE0051,L,1,159250,245000,2,0,49000,1,0,49000,196000,147000
01SCS19E040082,ESH.AR-SC0037,00ARSC0302,NON,1,40000,140000,2,0,42000,1,0,19600,98000,78400
01SCS19E040083,BSC.AR-RK0022,00ARRK0209,L,1,120000,315000,2,0,94500,1,0,44100,220500,176400
01SCS19E040083,BSC.AR-SA0006,00ARSA0028,L,1,44500,135000,2,0,40500,1,0,18900,94500,75600
01SCS19E040084,AR.MYA-SC001,20ARSC0037,S,1,220350,339000,2,0,101700,1,0,59325,237300,177975
01SCS19E040084,AR.RDC-RK009,20ARRK0488,M,1,97500,150000,2,0,30000,1,0,30000,120000,90000
01SCS19E040085,AR.FHL-SC008,20ARSC0351,ALL,1,110500,170000,2,0,34000,1,0,34000,136000,102000
01SCS19E040085,AR.TUC-SD002,20ARSD0146,L,1,204750,315000,2,0,63000,1,0,63000,252000,189000
01SCS19E040085,ESH.AR-RD0008,00ARRD0055,NON,1,80500,115000,2,0,34500,1,0,16100,80500,64400
01SCS19E040086,BSC.AR-SD0027,00ARSD0156,S,1,125000,315000,2,0,94500,1,0,44100,220500,176400
01SCS19E040086,BSC.AR-SD0062,00ARSD0337,NON,1,45000,150000,2,0,45000,1,0,21000,105000,84000
01SCS19E040087,ESH.AR-SA0014,00ARSA0102,M,1,44000,135000,2,0,40500,1,0,18900,94500,75600
01SCS19E040088,AR.HMR-SB003,20ARSB0345,M,1,194350,299000,2,0,59800,1,0,59800,239200,179400
01SCS19E040088,BSC.AR-SD0038,00ARSD0207,S,1,125000,315000,2,0,94500,1,0,44100,220500,176400
01SCS19E040089,AR.CLK-RH002,20ARRH0737,ALL,1,91000,140000,2,0,28000,1,0,28000,112000,84000
01SCS19E040090,BSC.AR-SD0042,00ARSD0227,S,1,44500,159000,2,0,47700,1,0,22260,111300,89040
01SCS19E040091,BSC.AR-SC0012,00ARSC0072,S,1,44000,159000,2,0,47700,1,0,22260,111300,89040
01SCS19E040091,BSC.AR-SE0001,00ARSE0057,S,1,44500,159000,2,0,47700,1,0,22260,111300,89040
01SCS19E040092,BE.RAK-SB036,00BESB0110,M,1,91000,140000,2,0,28000,1,0,28000,112000,84000
01SCS19E040092,ESH.AR-SB0031,00ARSB0205,M,1,44500,135000,2,0,40500,1,0,18900,94500,75600
01SCS19E040093,BSC.AR-SB0015,00ARSB0128,M,1,125000,315000,2,0,94500,1,0,44100,220500,176400
01SCS19E040094,AR.TUC-SC006,20ARSC0067,34,1,204750,315000,2,0,63000,1,0,63000,252000,189000
01SCS19E040095,ESH.AR-RK0018,00ARRK0194,NON,1,105000,150000,2,0,45000,1,0,21000,105000,84000
01SCS19E040096,AR.PUB-SA001,20ARSA0081,XL,1,97500,150000,2,0,30000,1,0,30000,120000,90000
01SCS19E040096,AR.PUB-SE017,20ARSE0067,L,1,159250,245000,2,0,49000,1,0,49000,196000,147000
01SCS19E040096,AR.REC-SD006,20ARSD0023,L,1,107250,165000,2,0,49500,1,0,28875,115500,86625
01SCS19E040096,AR.SMD-RH009,20ARRH0760,L,1,87750,135000,2,0,40500,1,0,23625,94500,70875
01SCS19E040096,ESH.AR-SD0015,00ARSD0090,M,1,106400,350000,2,0,105000,1,0,49000,245000,196000
01SCS19E040097,AR.STY-RK002,20ARRK0524,ALL,1,61750,95000,2,0,19000,1,0,19000,76000,57000
01SCS19E040098,BSC.AR-RL0019,00ARRL0114,M,1,125000,315000,2,0,94500,1,0,44100,220500,176400
01SCS19E040099,AR.MKV-SC003,20ARSC0077,ALL,1,87750,135000,2,0,27000,1,0,27000,108000,81000
01SCS19E040100,AR.CPT-SC001,20ARSC0243,ALL,1,97500,150000,2,0,30000,1,0,30000,120000,90000
01SCS19E040100,BSC.AR-SC0033,00ARSC0225,M,1,125000,315000,2,0,94500,1,0,44100,220500,176400
01SCS19E040101,ESH.AR-SB0024,00ARSB0156,NON,1,35300,120000,2,0,36000,1,0,16800,84000,67200
01SCS19E040102,AR.PUB-RL015,20ARRL0162,ALL,1,97500,150000,2,0,30000,1,0,30000,120000,90000
01SCS19E040102,AR.SMD-RD001,20ARRD0128,XL,1,87750,135000,2,0,40500,1,0,23625,94500,70875
01SCS19E040102,ESH.AR-RL0012,00ARRL0125,NON,1,47000,130000,2,0,39000,1,0,18200,91000,72800
01SCS19E040102,ESH.AR-SA0004,00ARSA0057,L,1,44500,135000,2,0,40500,1,0,18900,94500,75600
01SCS19E040103,AR.SLT-RB018,20ARRB0654,XL,1,332000,415000,2,0,41500,1,0,56025,373500,317475
01SCS19E040104,ESH.AR-SD0018,00ARSD0136,S,1,125000,315000,2,0,94500,1,0,44100,220500,176400
01SCS19E040105,ESH.AR-QE0002,00ARQE0021,ALL,1,50000,140000,2,0,90000,1,0,10000,50000,40000
01SCS19E040106,AR.BPH-SA006,20ARSA0251,ALL,1,96850,149000,2,0,44700,1,0,26075,104300,78225
01SCS19E040106,AR.MDS-RE004,20ARRE0642,M,1,117000,180000,2,0,36000,1,0,36000,144000,108000
01SCS19E040106,AR.PUB-RI017,20ARRI0261,S,1,97500,150000,2,0,30000,1,0,30000,120000,90000
01SCS19E040106,AR.PUB-SE025,20ARSE0095,S,1,159250,245000,2,0,49000,1,0,49000,196000,147000
01SCS19E040106,BSC.AR-RE0018,00ARRE0118,NON,1,36837,115000,2,0,15000,1,0,20000,100000,80000
01SCS19E040106,BSC.AR-SC0037,00ARSC0245,S,1,190000,475000,2,0,142500,1,0,66500,332500,266000
01SCS19E040107,AR.MKV-RJ027,20ARRJ0222,30,1,214500,330000,2,0,66000,1,0,66000,264000,198000
01SCS19E040108,BSC.AR-RK0009,00ARRK0081,S,1,52000,155000,2,0,46500,1,0,21700,108500,86800
01SCS19E040108,ESH.AR-RH0016,00ARRH0091,S,1,43000,135000,2,0,40500,1,0,18900,94500,75600
01SCS19E040109,BSC.AR-SB0004,00ARSB0047,S,1,44000,135000,2,0,40500,1,0,18900,94500,75600
01SCS19E040109,BSC.AR-SC0003,00ARSC0025,NON,1,73000,220000,2,0,66000,1,0,30800,154000,123200
01SCS19E040109,BSC.AR-SD0046,00ARSD0243,S,1,44500,159000,2,0,47700,1,0,22260,111300,89040
01SCS19E040110,AR.ESB-SC016,20ARSC0457,M,1,91000,140000,2,0,28000,1,0,28000,112000,84000
01SCS19E040111,BSC.AR-SE0001,00ARSE0057,S,1,44500,159000,2,0,47700,1,0,22260,111300,89040
01SCS19E040112,ESH.AR-SD0016,00ARSD0094,S,1,106400,350000,2,0,105000,1,0,49000,245000,196000
01SCS19E040113,AR.MDS-RL003,20ARRL0362,S,1,117000,180000,2,0,36000,1,0,36000,144000,108000
01SCS19E040113,AR.SMD-RI006,20ARRI0327,M,1,87750,135000,2,0,40500,1,0,23625,94500,70875
01SCS19E040114,ESH.AR-RC0026,00ARRC0187,ALL,1,55000,150000,2,0,100000,1,0,10000,50000,40000
01SCS19E040115,BSC.AR-RK0003,00ARRK0060,XL,1,94500,135000,2,0,40500,1,0,18900,94500,75600
01SCS19E040115,BSC.AR-SC0028,00ARSC0198,XL,1,125000,315000,2,0,94500,1,0,44100,220500,176400
01SCS19E040115,BSC.AR-SC0046,00ARSC0298,NON,1,45000,150000,2,0,45000,1,0,21000,105000,84000
01SCS19E040116,ESH.AR-QJ0013,00ARQJ0047,L,1,100000,345000,2,0,170000,1,0,35000,175000,140000
01SCS19E040116,ESH.AR-RC0024,00ARRC0181,L,1,42000,135000,2,0,67500,1,0,13500,67500,54000
01SCS19E040116,ESH.AR-RC0039,00ARRC0225,XL,1,42000,135000,2,0,67500,1,0,13500,67500,54000
01SCS19E040117,ESH.AR-RA0015,00ARRA0072,ALL,1,38000,140000,2,0,90000,1,0,10000,50000,40000
01SCS19E040117,ESH.AR-RC0029,00ARRC0190,ALL,1,45000,150000,2,0,100000,1,0,10000,50000,40000
01SCS19E040118,BSC.AR-RH0018,00ARRH0079,M,1,120000,315000,2,0,94500,1,0,44100,220500,176400
01SCS19E040119,ESH.AR-SD0014,00ARSD0087,34,1,145000,375000,2,0,112500,1,0,52500,262500,210000
01SCS19E040119,ESH.AR-SD0014,00ARSD0088,36,1,145000,375000,2,0,112500,1,0,52500,262500,210000
01SCS19E040120,AR.CLB-RE001,20ARRE1088,ALL,1,185250,285000,2,0,57000,1,0,57000,228000,171000
01SCS19E040121,AR.PCT-RH003,20ARRH0305,ALL,1,97500,150000,2,0,30000,1,0,30000,120000,90000
01SCS19E040121,AR.VLD-RK007,20ARRK0326,ALL,1,123500,190000,2,0,57000,1,0,33250,133000,99750
01SCS19E040122,AR.MKV-RC024,20ARRC0596,ALL,1,78000,120000,2,0,24000,1,0,24000,96000,72000
01SCS19E040123,AR.TUC-SB012,20ARSB0198,XL,1,204750,315000,2,0,63000,1,0,63000,252000,189000
01SCS19E040124,AR.MKV-RE036,20ARRE1407,L,1,165750,255000,2,0,51000,1,0,51000,204000,153000
01SCS19E040125,BNV.AR-RI0005,00ARRI0169,32,1,625000,625000,2,0,62500,1,0,84375,562500,478125
01SCS19E040125,ESH.AR-RG0001,00ARRG0001,NON,1,157500,225000,2,0,67500,1,0,31500,157500,126000
01SCS19E040125,ESH.AR-RK0021,00ARRK0215,NON,1,129500,185000,2,0,55500,1,0,25900,129500,103600
01SCS19E040126,BSC.AR-SC0035,00ARSC0234,L,1,125000,315000,2,0,94500,1,0,44100,220500,176400
01SCS19E040127,AR.ESB-SD015,20ARSD0333,S,1,91000,140000,2,0,28000,1,0,28000,112000,84000
01SCS19E040128,BSC.AR-RJ0031,00ARRJ0202,M,1,220500,315000,2,0,94500,1,0,44100,220500,176400
01SCS19E040129,BSC.AR-RI0032,00ARRI0150,M,1,120000,315000,2,0,94500,1,0,44100,220500,176400
01SCS19E040129,BSC.AR-RK0014,00ARRK0103,L,1,43000,135000,2,0,40500,1,0,18900,94500,75600
01SCS19E040130,AR.PUB-RK001,20ARRK0067,L,1,97500,150000,2,0,30000,1,0,30000,120000,90000
01SCS19E040130,AR.TUC-SA042,20ARSA0310,ALL,1,100750,155000,2,0,31000,1,0,31000,124000,93000
01SCS19E040131,AR.YD-RL015,20ARRL0041,XL,1,91000,140000,2,0,70000,1,0,17500,70000,52500
01SCS19E040131,AR.YD-RL017,20ARRL0049,XL,1,91000,140000,2,0,70000,1,0,17500,70000,52500
01SCS19E040131,ESH.AR-RD0024,00ARRD0230,XL,1,145000,435000,2,0,260000,1,0,35000,175000,140000
01SCS19E040132,BSC.AR-QJ0014,00ARQJ0114,L,1,100000,310000,2,0,150000,1,0,32000,160000,128000
01SCS19E040133,BSC.AR-RI0017,00ARRI0063,M,1,43000,135000,2,0,40500,1,0,18900,94500,75600
01SCS19E040134,ESH.AR-SC0022,00ARSC0163,L,1,125000,315000,2,0,94500,1,0,44100,220500,176400
01SCS19E040135,AR.TUC-SA024,20ARSA0151,M,1,87750,135000,2,0,27000,1,0,27000,108000,81000
01SCS19E040135,ESH.AR-SC0004,00ARSC0022,M,1,44500,135000,2,0,40500,1,0,18900,94500,75600
01SCS19E040136,AR.CPT-SD003,20ARSD0139,ALL,1,94250,145000,2,0,29000,1,0,29000,116000,87000
01SCS19E040136,ESH.AR-RK0014,00ARRK0189,L,1,245000,350000,2,0,105000,1,0,49000,245000,196000
01SCS19E040137,AR.HLW-SA020,20ARSA0126,30,1,243750,375000,2,0,112500,1,0,65625,262500,196875
01SCS19E040138,AR.CPT-RL004,20ARRL0084,L,1,94250,145000,2,0,29000,1,0,29000,116000,87000
01SCS19E040138,AR.PUB-RH016,20ARRH0267,S,1,191750,295000,2,0,59000,1,0,59000,236000,177000
01SCS19E040139,ESH.AR-RC0029,00ARRC0190,ALL,1,45000,150000,2,0,100000,1,0,10000,50000,40000
01SCS19E040140,AR.SMD-SD018,20ARSD0580,ALL,1,97500,150000,2,0,30000,1,0,30000,120000,90000
01SCS19E040141,AR.CPT-RI007,20ARRI0066,L,1,94250,145000,2,0,29000,1,0,29000,116000,87000
01SCS19E040141,AR.MYA-RE005,20ARRE1308,32,1,207350,319000,2,0,159500,1,0,39875,159500,119625
01SCS19E040142,AR.CPT-RL016,20ARRL0313,ALL,1,94250,145000,2,0,29000,1,0,29000,116000,87000
01SCS19E040143,AR.TUC-SD025,20ARSD0518,30,1,211250,325000,2,0,65000,1,0,65000,260000,195000
01SCS19E040144,AR.PUB-RE002,20ARRE0205,M,1,97500,150000,2,0,30000,1,0,30000,120000,90000
01SCS19E040144,ESH.AR-SD0026,00ARSD0269,XL,1,44500,135000,2,0,40500,1,0,18900,94500,75600
01SCS19E040145,BSC.AR-SB0004,00ARSB0050,XL,1,44000,135000,2,0,40500,1,0,18900,94500,75600
01SCS19E040146,AR.HMR-SB009,20ARSB0370,L,1,90350,139000,2,0,27800,1,0,27800,111200,83400
01SCS19E040147,AR.ESB-SD005,20ARSD0114,L,1,91000,140000,2,0,28000,1,0,28000,112000,84000
01SCS19E040147,ESH.AR-SD0026,00ARSD0266,S,1,44500,135000,2,0,40500,1,0,18900,94500,75600
01SCS19E040148,ESH.AR-SB0024,00ARSB0156,NON,1,35300,120000,2,0,36000,1,0,16800,84000,67200
01SCS19E040149,AR.CPT-RH008,20ARRH0870,L,1,204750,315000,2,0,63000,1,0,63000,252000,189000
01SCS19E040150,AR.MKV-RC024,20ARRC0596,ALL,1,78000,120000,2,0,24000,1,0,24000,96000,72000
01SCS19E040150,AR.PUB-SC006,20ARSC0279,XL,1,97500,150000,2,0,30000,1,0,30000,120000,90000
01SCS19E040151,AR.TRF-RJ009,20ARRJ0089,L,1,195000,300000,2,0,90000,1,0,52500,210000,157500
01SCS19E040152,AR.PUB-SE021,20ARSE0079,S,1,159250,245000,2,0,49000,1,0,49000,196000,147000
01SCS19E040152,BSC.AR-RI0026,00ARRI0135,NON,1,98000,140000,2,0,42000,1,0,19600,98000,78400
01SCS19E040152,BSC.AR-RJ0020,00ARRJ0116,M,1,44500,135000,2,0,40500,1,0,18900,94500,75600
01SCS19E040152,BSC.AR-SC0038,00ARSC0249,S,1,190000,475000,2,0,142500,1,0,66500,332500,266000
01SCS19E040152,BSC.AR-SD0041,00ARSD0224,M,1,44500,159000,2,0,47700,1,0,22260,111300,89040
01SCS19E040153,ESH.AR-SA0010,00ARSA0091,NON,1,53000,155000,2,0,46500,1,0,21700,108500,86800
01SCS19E040154,AR.HMR-SB008,20ARSB0366,L,1,90350,139000,2,0,27800,1,0,27800,111200,83400
01SCS19E040154,AR.MPR-SB007,20ARSB0259,M,1,97500,150000,2,0,45000,1,0,26250,105000,78750
01SCS19E040154,ESH.AR-RB0006,00ARRB0045,32,1,90000,265000,2,0,90000,1,0,35000,175000,140000
01SCS19E040155,BSC.AR-QJ0014,00ARQJ0115,XL,1,100000,310000,2,0,150000,1,0,32000,160000,128000
01SCS19E040156,AR.MKV-SC005,20ARSC0082,S,1,253500,390000,2,0,78000,1,0,78000,312000,234000
01SCS19E040157,AR.ASH-SD004,20ARSD0396,XL,1,243750,375000,2,0,112500,1,0,65625,262500,196875
01SCS19E040157,ESH.AR-SD0021,00ARSD0164,S,1,125000,315000,2,0,94500,1,0,44100,220500,176400
01SCS19E040158,AR.CPT-RK009,20ARRK0031,ALL,1,48750,75000,2,0,15000,1,0,15000,60000,45000
01SCS19E040158,AR.TUC-SD024,20ARSD0515,L,1,204750,315000,2,0,63000,1,0,63000,252000,189000
01SCS19E040159,ESH.AR-SD0021,00ARSD0165,M,1,125000,315000,2,0,94500,1,0,44100,220500,176400
01SCS19E040160,BSC.AR-SD0059,00ARSD0331,NON,1,45000,140000,2,0,42000,1,0,19600,98000,78400
01SCS19E040161,ESH.AR-SB0023,00ARSB0135,NON,1,52800,185000,2,0,55500,1,0,25900,129500,103600
01SCS19E040162,AR.TUC-SD023,20ARSD0510,M,1,204750,315000,2,0,63000,1,0,63000,252000,189000
01SCS19E040163,BSC.AR-RD0040,00ARRD0205,L,1,110000,315000,2,0,155000,1,0,32000,160000,128000
01SCS19E040164,AR.FHL-SC003,20ARSC0336,L,1,91000,140000,2,0,28000,1,0,28000,112000,84000
01SCS19E040164,AR.MKV-RJ003,20ARRJ0152,L,1,91000,140000,2,0,28000,1,0,28000,112000,84000
01SCS19E040165,BSC.AR-RI0027,00ARRI0136,NON,1,43000,140000,2,0,42000,1,0,19600,98000,78400
01SCS19E040166,AR.CPT-SD008,20ARSD0442,M,1,204750,315000,2,0,63000,1,0,63000,252000,189000
01SCS19E040166,AR.PUB-RG007,20ARRG0043,M,1,97500,150000,2,0,30000,1,0,30000,120000,90000
01SCS19E040166,AR.PUB-SD026,20ARSD0202,M,1,97500,150000,2,0,30000,1,0,30000,120000,90000
01SCS19E040167,ESH.AR-RL0011,00ARRL0121,S,1,100000,265000,2,0,79500,1,0,37100,185500,148400
01SCS19E040168,ESH.AR-RD0021,00ARRD0192,M,1,42000,135000,2,0,67500,1,0,13500,67500,54000
01SCS19E040168,ESH.AR-RE0004,00ARRE0014,M,1,42000,135000,2,0,67500,1,0,13500,67500,54000
01SCS19E040169,ESH.AR-RA0017,00ARRA0074,ALL,1,40000,140000,2,0,90000,1,0,10000,50000,40000
01SCS19E040170,ESH.AR-SC0008,00ARSC0069,M,1,44500,135000,2,0,40500,1,0,18900,94500,75600
01SCS19E040171,ESH.AR-QK0001,00ARQK0003,L,1,90000,310000,2,0,150000,1,0,32000,160000,128000
01SCS19E040172,AR.SMD-SD013,20ARSD0572,XL,1,87750,135000,2,0,27000,1,0,27000,108000,81000
01SCS19E040172,ESH.AR-RD0018,00ARRD0185,NON,1,55000,150000,2,0,100000,1,0,10000,50000,40000
01SCS19E040173,AR.MKV-SC004,20ARSC0079,M,1,253500,390000,2,0,78000,1,0,78000,312000,234000
01SCS19E040173,ESH.AR-RK0010,00ARRK0041,S,1,44500,135000,2,0,40500,1,0,18900,94500,75600
01SCS19E040174,AR.PUB-SD019,20ARSD0188,ALL,1,97500,150000,2,0,30000,1,0,30000,120000,90000
01SCS19E040175,ESH.AR-RD0018,00ARRD0185,NON,1,55000,150000,2,0,100000,1,0,10000,50000,40000
01SCS19E040176,BSC.AR-RD0040,00ARRD0206,XL,1,110000,315000,2,0,155000,1,0,32000,160000,128000
01SCS19E040177,BSC.AR-RC0026,00ARRC0171,ALL,1,55000,150000,2,0,100000,1,0,10000,50000,40000
01SCS19E040177,ESH.AR-QH0026,00ARQH0137,ALL,1,39700,140000,2,0,90000,1,0,10000,50000,40000
01SCS19E040178,AR.BPH-RB016,20ARRB0484,S,1,291850,449000,2,0,224500,1,0,56125,224500,168375
01SCS19E040178,AR.MKV-SD008,20ARSD0412,M,1,162500,250000,2,0,125000,1,0,31250,125000,93750
01SCS19E040178,ESH.AR-RC0026,00ARRC0187,ALL,1,55000,150000,2,0,100000,1,0,10000,50000,40000
01SCS19E040179,AR.MKV-RL004,20ARRL0249,XL,1,253500,390000,2,0,78000,1,0,78000,312000,234000
01SCS19E040179,ESH.AR-SB0031,00ARSB0206,L,1,44500,135000,2,0,40500,1,0,18900,94500,75600
01SCS19E040179,ESH.AR-SC0010,00ARSC0082,L,1,44500,135000,2,0,40500,1,0,18900,94500,75600
01SCS19E040180,BSC.AR-SD0032,00ARSD0186,XL,1,44500,159000,2,0,47700,1,0,22260,111300,89040
01SCS19E040180,ESH.AR-SB0007,00ARSB0030,XL,1,44000,135000,2,0,40500,1,0,18900,94500,75600
01SCS19E040181,BE.RAK-SB040,00BESB0117,ALL,1,81250,125000,2,0,25000,1,0,25000,100000,75000
01SCS19E040182,BSC.AR-RI0032,00ARRI0150,M,1,120000,315000,2,0,94500,1,0,44100,220500,176400
01SCS19E040182,BSC.AR-RI0035,00ARRI0209,M,1,120000,315000,2,0,94500,1,0,44100,220500,176400
01SCS19E040183,AR.PUB-RI021,20ARRI0280,34,1,224250,345000,2,0,69000,1,0,69000,276000,207000
01SCS19E040183,AR.TUC-SC005,20ARSC0061,30,1,185250,285000,2,0,57000,1,0,57000,228000,171000
01SCS19E040184,AR.TUC-SA013,20ARSA0032,M,1,204750,315000,2,0,63000,1,0,63000,252000,189000
01SCS19E040185,BSC.AR-SC0001,00ARSC0014,M,1,125000,315000,2,0,94500,1,0,44100,220500,176400
01SCS19E040186,ESH.AR-QI0003,00ARQI0036,ALL,1,40000,140000,2,0,90000,1,0,10000,50000,40000
01SCS19E040187,AR.SMD-RL003,20ARRL0267,ALL,1,22750,35000,2,0,7000,1,0,7000,28000,21000
01SCS19E040187,SLT-PI0058,2016I03471,30,1,440000,595000,2,0,59500,1,0,80325,535500,455175
01SCS19E040188,AR.MKV-SA007,20ARSA0201,32,1,243750,375000,2,0,75000,1,0,75000,300000,225000
01SCS19E040188,AR.MKV-SD004,20ARSD0230,28,1,117000,180000,2,0,36000,1,0,36000,144000,108000
01SCS19E040189,ESH.AR-RD0024,00ARRD0227,S,1,145000,435000,2,0,260000,1,0,35000,175000,140000
01SCS19E040190,AR.PUB-RI008,20ARRI0122,M,1,191750,295000,2,0,59000,1,0,59000,236000,177000
01SCS19E040191,AR.PUB-RL016,20ARRL0163,ALL,1,97500,150000,2,0,30000,1,0,30000,120000,90000
01SCS19E040192,AR.HMR-SB032,20ARSB0446,32,1,204750,315000,2,0,63000,1,0,63000,252000,189000
01SCS19E040192,AR.MKV-SB012,20ARSB0546,XL,1,172250,265000,2,0,53000,1,0,53000,212000,159000
01SCS19E040193,AR.MKV-SD005,20ARSD0235,M,1,172250,265000,2,0,53000,1,0,53000,212000,159000
01SCS19E040194,AR.CPT-SC002,20ARSC0245,30,1,227500,350000,2,0,70000,1,0,70000,280000,210000
01SCS19E040195,AR.ESB-RH005,20ARRH0194,ALL,1,91000,140000,2,0,42000,1,0,24500,98000,73500
01SCS19E040195,ESH.AR-SC0017,00ARSC0140,S,1,44000,135000,2,0,40500,1,0,18900,94500,75600
01SCS19E040196,BSC.AR-SB0008,00ARSB0080,L,1,44500,135000,2,0,40500,1,0,18900,94500,75600
01SCS19E040196,ESH.AR-SE0001,00ARSE0003,L,1,44000,135000,2,0,40500,1,0,18900,94500,75600
01SCS19E040197,BSC.AR-QG0018,00ARQG0150,S,1,135000,395000,2,0,220000,1,0,35000,175000,140000
01SCS19E040198,BSC.AR-SC0034,00ARSC0229,M,1,125000,315000,2,0,94500,1,0,44100,220500,176400
01SCS19E040199,BSC.AR-SB0011,00ARSB0097,M,1,44500,135000,2,0,40500,1,0,18900,94500,75600
01SCS19E040199,BSC.AR-SC0018,00ARSC0125,M,1,44500,159000,2,0,47700,1,0,22260,111300,89040
01SCS19E040200,AR.HMR-SD003,20ARSD0534,M,1,243750,375000,2,0,75000,1,0,75000,300000,225000
01SCS19E040201,ESH.AR-SD0011,00ARSD0074,M,1,125000,315000,2,0,94500,1,0,44100,220500,176400
01SCS19E040202,AR.CPT-SD012,20ARSD0458,M,1,94250,145000,2,0,29000,1,0,29000,116000,87000
01SCS19E040202,AR.PUB-SD016,20ARSD0130,M,1,97500,150000,2,0,30000,1,0,30000,120000,90000
01SCS19E040203,ESH.AR-SD0003,00ARSD0044,XL,1,44000,135000,2,0,40500,1,0,18900,94500,75600
01SCS19E040204,AR.TUC-SD031,20ARSD0526,XL,1,87750,135000,2,0,27000,1,0,27000,108000,81000
01SCS19E040204,BSC.AR-SC0026,00ARSC0187,L,1,106400,350000,2,0,105000,1,0,49000,245000,196000
01SCS19E040205,AR.PUB-SE017,20ARSE0067,L,1,159250,245000,2,0,49000,1,0,49000,196000,147000
01SCS19E040205,AR.TUC-SB004,20ARSB0032,ALL,1,61750,95000,2,0,19000,1,0,19000,76000,57000
01SCS19E040206,BSC.AR-SB0003,00ARSB0045,L,1,125000,315000,2,0,94500,1,0,44100,220500,176400
01SCS19E040207,AR.FHL-SC003,20ARSC0334,S,1,91000,140000,2,0,28000,1,0,28000,112000,84000
01SCS19E040208,AR.SMD-RH003,20ARRH0400,L,1,211250,325000,2,0,97500,1,0,56875,227500,170625
01SCS19E040209,AR.MYA-RE005,20ARRE1308,32,1,207350,319000,2,0,159500,1,0,39875,159500,119625
01SCS19E040209,AR.TUC-RL022,20ARRL0346,ALL,1,87750,135000,2,0,27000,1,0,27000,108000,81000
01SCS19E040210,AR.RDC-SB005,20ARSB0171,ALL,1,165750,255000,2,0,51000,1,0,51000,204000,153000
01SCS19E040211,AR.ASH-RK004,20ARRK0516,M,1,195000,300000,2,0,90000,1,0,52500,210000,157500
01SCS19E040212,BSC.AR-QG0008,00ARQG0094,ALL,1,80000,225000,2,0,125000,1,0,20000,100000,80000
01SCS19E040213,BSC.AR-SC0014,00ARSC0096,S,1,44000,159000,2,0,47700,1,0,22260,111300,89040
01SCS19E040214,BSC.AR-QJ0014,00ARQJ0112,S,1,100000,310000,2,0,150000,1,0,32000,160000,128000
01SCS19E040214,ESH.AR-RE0014,00ARRE0093,S,1,105000,330000,2,0,155000,1,0,35000,175000,140000
01SCS19E040214,ESH.AR-SE0001,00ARSE0001,S,1,44000,135000,2,0,40500,1,0,18900,94500,75600
01SCS19E040215,AR.MKV-RJ012,20ARRJ0195,ALL,1,97500,150000,2,0,30000,1,0,30000,120000,90000
01SCS19E040216,AR.VCS-RI007,20ARRI0297,XL,1,243750,375000,2,0,112500,1,0,65625,262500,196875
01SCS19E040217,ESH.AR-RC0026,00ARRC0187,ALL,1,55000,150000,2,0,100000,1,0,10000,50000,40000
01SCS19E040217,ESH.AR-SA0011,00ARSA0092,NON,1,19000,50000,2,0,15000,1,0,7000,35000,28000
01SCS19E040218,BSC.AR-SA0001,00ARSA0002,M,1,120000,315000,2,0,94500,1,0,44100,220500,176400
01SCS19E040219,BSC.AR-SC0033,00ARSC0225,M,1,125000,315000,2,0,94500,1,0,44100,220500,176400
01SCS19E040220,AR.TUC-SD002,20ARSD0146,L,1,204750,315000,2,0,63000,1,0,63000,252000,189000
01SCS19E040221,BSC.AR-RH0025,00ARRH0161,L,1,115000,350000,2,0,105000,1,0,49000,245000,196000
01SCS19E040222,AR.PUB-SE018,20ARSE0070,M,1,159250,245000,2,0,49000,1,0,49000,196000,147000
01SCS19E040222,BSC.AR-RC0025,00ARRC0166,ALL,1,43000,185000,2,0,85000,1,0,20000,100000,80000
01SCS19E040222,BSC.AR-RF0012,00ARRF0111,L,1,67000,185000,2,0,117500,1,0,13500,67500,54000
01SCS19E040222,ESH.AR-RD0020,00ARRD0189,L,1,43000,150000,2,0,82500,1,0,13500,67500,54000
01SCS19E040223,AR.TUC-SB003,20ARSB0031,ALL,1,61750,95000,2,0,19000,1,0,19000,76000,57000
01SCS19E050001,BSC.AR-SC0004,00ARSC0032,L,1,125000,315000,2,0,94500,1,0,44100,220500,176400
01SCS19E050001,BSC.AR-SC0012,00ARSC0073,M,1,44000,159000,2,0,47700,1,0,22260,111300,89040
01SCS19E050002,AR.CPT-RI005,20ARRI0057,M,1,94250,145000,2,0,29000,1,0,29000,116000,87000
01SCS19E050003,AR.ESB-SB003,20ARSB0101,M,1,100750,155000,2,0,31000,1,0,31000,124000,93000
01SCS19E050003,BSC.AR-RH0006,00ARRH0027,L,1,108500,155000,2,0,46500,1,0,21700,108500,86800
01SCS19E050004,BSC.AR-RC0026,00ARRC0171,ALL,1,55000,150000,2,0,100000,1,0,10000,50000,40000
01SCS19E050005,BSC.AR-RC0025,00ARRC0166,ALL,1,43000,185000,2,0,85000,1,0,20000,100000,80000
01SCS19E050005,ESH.AR-SD0029,00ARSD0278,NON,1,58000,175000,2,0,52500,1,0,24500,122500,98000
01SCS19E050006,AR.MDG-SC001,20ARSC0152,M,1,94250,145000,2,0,43500,1,0,25375,101500,76125
01SCS19E050006,AR.MKV-PL017,20ARPL0455,XL,1,91000,140000,2,0,70000,1,0,17500,70000,52500
01SCS19E050006,ESH.AR-QI0003,00ARQI0036,ALL,1,40000,140000,2,0,90000,1,0,10000,50000,40000
01SCS19E050007,AR.SMD-SD010,20ARSD0311,30,1,211250,325000,2,0,65000,1,0,65000,260000,195000
01SCS19E050007,THR.AR-RK0003,00ARRK0167,L,1,332000,415000,2,0,41500,1,0,56025,373500,317475
01SCS19E050008,AR.PUB-RE036,20ARRE0538,ALL,1,97500,150000,2,0,30000,1,0,30000,120000,90000
01SCS19E050009,AR.ESB-SA004,20ARSA0218,XL,1,204750,315000,2,0,63000,1,0,63000,252000,189000
01SCS19E050010,BSC.AR-RL0025,00ARRL0167,M,1,94500,135000,2,0,40500,1,0,18900,94500,75600
01SCS19E050011,BSC.AR-SD0002,00ARSD0005,S,1,44000,159000,2,0,47700,1,0,22260,111300,89040
01SCS19E050012,BSC.AR-SD0054,00ARSD0287,NON,1,50000,150000,2,0,45000,1,0,21000,105000,84000
01SCS19E050013,BSC.AR-RJ0032,00ARRJ0215,NON,1,18000,75000,2,0,22500,1,0,10500,52500,42000
01SCS19E050013,BSC.AR-RL0018,00ARRL0109,S,1,125000,315000,2,0,94500,1,0,44100,220500,176400
01SCS19E050013,BSC.AR-SB0007,00ARSB0074,S,1,44500,135000,2,0,40500,1,0,18900,94500,75600
01SCS19E050013,BSC.AR-SD0004,00ARSD0013,S,1,44000,159000,0,0,0,0,0,31800,159000,127200
01SCS19E050013,BSC.AR-SD0018,00ARSD0123,NON,1,45000,150000,2,0,45000,1,0,21000,105000,84000
01SCS19E050014,AR.STY-SA003,20ARSA0062,ALL,1,61750,95000,2,0,19000,1,0,19000,76000,57000
01SCS19E050014,AR.STY-SB002,20ARSB0489,ALL,1,61750,95000,2,0,19000,1,0,19000,76000,57000
01SCS19E050015,AR.PUB-SC006,20ARSC0277,M,1,97500,150000,2,0,30000,1,0,30000,120000,90000
01SCS19E050015,ESH.AR-SE0001,00ARSE0002,M,1,44000,135000,2,0,40500,1,0,18900,94500,75600
01SCS19E050016,ESH.AR-SA0008,00ARSA0083,S,1,113450,350000,2,0,105000,1,0,49000,245000,196000
01SCS19E050016,ESH.AR-SD0011,00ARSD0074,M,1,125000,315000,2,0,94500,1,0,44100,220500,176400
01SCS19E050017,AR.SMD-SD009,20ARSD0309,XL,1,243750,375000,2,0,112500,1,0,65625,262500,196875
01SCS19E050017,AR.VCS-RL002,20ARRL0298,L,1,97500,150000,2,0,45000,1,0,26250,105000,78750
01SCS19E050018,ESH.AR-SC0013,00ARSC0106,L,1,44500,135000,2,0,40500,1,0,18900,94500,75600
01SCS19E050018,ESH.AR-SD0018,00ARSD0138,L,1,125000,315000,2,0,94500,1,0,44100,220500,176400
01SCS19E050019,AR.TUC-SA027,20ARSA0162,ALL,1,100750,155000,2,0,31000,1,0,31000,124000,93000
01SCS19E050019,ESH.AR-SC0013,00ARSC0106,L,1,44500,135000,2,0,40500,1,0,18900,94500,75600
01SCS19E050020,BSC.AR-SB0003,00ARSB0043,S,1,125000,315000,2,0,94500,1,0,44100,220500,176400
01SCS19E050020,ESH.AR-RF0007,00ARRF0043,M,1,150000,395000,2,0,220000,1,0,35000,175000,140000
01SCS19E050021,AR.STY-RK002,20ARRK0524,ALL,1,61750,95000,2,0,19000,1,0,19000,76000,57000
01SCS19E050021,ESH.AR-RE0007,00ARRE0027,L,1,42000,135000,2,0,67500,1,0,13500,67500,54000
01SCS19E050021,ESH.AR-RE0008,00ARRE0031,L,1,42000,135000,2,0,67500,1,0,13500,67500,54000
01SCS19E050022,AR.BPH-RB008,20ARRB0456,XL,1,103350,159000,2,0,47700,1,0,27825,111300,83475
01SCS19E050022,AR.FHL-SC002,20ARSC0333,XL,1,91000,140000,2,0,28000,1,0,28000,112000,84000
01SCS19E050022,AR.PUB-SE023,20ARSE0090,XL,1,159250,245000,2,0,49000,1,0,49000,196000,147000
01SCS19E050023,BSC.AR-RE0028,00ARRE0303,NON,1,35000,120000,2,0,36000,1,0,16800,84000,67200
01SCS19E050024,AR.YD-RL020,20ARRL0058,ALL,1,94250,145000,2,0,72500,1,0,18125,72500,54375
01SCS19E050025,ESH.AR-SE0001,00ARSE0002,M,1,44000,135000,2,0,40500,1,0,18900,94500,75600
01SCS19E050026,BSC.AR-QJ0014,00ARQJ0112,S,1,100000,310000,2,0,150000,1,0,32000,160000,128000
01SCS19E050027,AR.MKV-PL047,20ARPL0528,ALL,1,78000,120000,2,0,60000,1,0,15000,60000,45000
01SCS19E050027,BSC.AR-SC0029,00ARSC0199,S,1,125000,315000,2,0,94500,1,0,44100,220500,176400
01SCS19E050028,AR.MKV-SC006,20ARSC0087,M,1,107250,165000,2,0,33000,1,0,33000,132000,99000
01SCS19E050029,BSC.AR-SD0038,00ARSD0207,S,1,125000,315000,2,0,94500,1,0,44100,220500,176400
01SCS19E050030,AR.ASH-RJ007,20ARRJ0272,L,1,91000,140000,2,0,42000,1,0,24500,98000,73500
01SCS19E050031,AR.ESB-RH004,20ARRH0193,ALL,1,91000,140000,2,0,42000,1,0,24500,98000,73500
01SCS19E050032,ESH.AR-RL0012,00ARRL0125,NON,1,47000,130000,2,0,39000,1,0,18200,91000,72800
01SCS19E050033,ESH.AR-QI0003,00ARQI0036,ALL,1,40000,140000,2,0,90000,1,0,10000,50000,40000
01SCS19E050034,BSC.AR-QG0010,00ARQG0099,ALL,1,80000,240000,2,0,140000,1,0,20000,100000,80000
01SCS19E050035,AR.TUC-SD001,20ARSD0142,L,1,204750,315000,2,0,63000,1,0,63000,252000,189000
01SCS19E050036,AR.MYA-SC001,20ARSC0038,M,1,220350,339000,2,0,101700,1,0,59325,237300,177975
01SCS19E050037,BSC.AR-RE0028,00ARRE0303,NON,2,35000,120000,2,0,36000,1,0,16800,168000,134400
01SCS19E050037,ESH.AR-RE0015,00ARRE0099,L,1,102500,330000,2,0,155000,1,0,35000,175000,140000
01SCS19E050038,BSC.AR-SA0004,00ARSA0019,M,1,125000,315000,2,0,94500,1,0,44100,220500,176400
01SCS19E050039,AR.REC-SD014,20ARSD0052,ALL,1,107250,165000,2,0,49500,1,0,28875,115500,86625
01SCS19E050040,ESH.AR-SD0009,00ARSD0066,M,1,44500,135000,2,0,40500,1,0,18900,94500,75600
01SCS19E050041,ESH.AR-RF0007,00ARRF0044,L,1,150000,395000,2,0,220000,1,0,35000,175000,140000
01SCS19E050042,AR.ESB-SD009,20ARSD0180,M,1,91000,140000,2,0,28000,1,0,28000,112000,84000
01SCS19E050042,AR.TUC-SD021,20ARSD0502,M,1,94250,145000,2,0,29000,1,0,29000,116000,87000
01SCS19E050043,BSC.AR-SC0033,00ARSC0224,S,1,125000,315000,2,0,94500,1,0,44100,220500,176400
01SCS19E050043,ESH.AR-RJ0013,00ARRJ0175,S,1,94500,135000,2,0,40500,1,0,18900,94500,75600
01SCS19E050044,BSC.AR-RD0040,00ARRD0205,L,1,110000,315000,2,0,155000,1,0,32000,160000,128000
01SCS19E050045,ESH.AR-RC0029,00ARRC0190,ALL,1,45000,150000,2,0,100000,1,0,10000,50000,40000
01SCS19E050046,BSC.AR-RJ0021,00ARRJ0119,S,1,43000,135000,2,0,40500,1,0,18900,94500,75600
01SCS19E050047,ESH.AR-RJ0023,00ARRJ0218,NON,1,18000,75000,2,0,22500,1,0,10500,52500,42000
01SCS19E050048,AR.GTW-SA003,20ARSA0303,S,1,94250,145000,2,0,43500,1,0,25375,101500,76125
01SCS19E050048,AR.STY-SE009,20ARSE0127,ALL,1,55250,85000,2,0,17000,1,0,17000,68000,51000
01SCS19E050048,ESH.AR-SE0001,00ARSE0001,S,1,44000,135000,2,0,40500,1,0,18900,94500,75600
01SCS19E050049,AR.CPT-SC004,20ARSC0253,M,1,304850,469000,2,0,93800,1,0,93800,375200,281400
01SCS19E050050,BSC.AR-RC0026,00ARRC0171,ALL,1,55000,150000,2,0,100000,1,0,10000,50000,40000
01SCS19E050050,ESH.AR-RE0028,00ARRE0306,L,1,135000,350000,2,0,225000,1,0,25000,125000,100000
01SCS19E050051,BSC.AR-RJ0032,00ARRJ0215,NON,1,18000,75000,2,0,22500,1,0,10500,52500,42000
01SCS19E050052,AR.PCT-QE002,20ARQE0011,M,1,78000,120000,2,0,60000,1,0,15000,60000,45000
01SCS19E050052,AR.PCT-RE011,20ARRE1434,M,1,81250,125000,2,0,62500,1,0,15625,62500,46875
01SCS19E050052,ESH.AR-RI0018,00ARRI0146,NON,1,39000,140000,2,0,42000,1,0,19600,98000,78400
01SCS19E050053,ESH.AR-RD0021,00ARRD0192,M,1,42000,135000,2,0,67500,1,0,13500,67500,54000
01SCS19E050053,ESH.AR-RE0019,00ARRE0204,S,1,43000,150000,2,0,82500,1,0,13500,67500,54000
01SCS19E050054,AR.ESB-SB004,20ARSB0105,M,1,91000,140000,2,0,28000,1,0,28000,112000,84000
01SCS19E050055,AR.TUC-RK016,20ARRK0112,ALL,1,87750,135000,2,0,27000,1,0,27000,108000,81000
01SCS19E050055,ESH.AR-SC0001,00ARSC0001,S,1,125000,315000,2,0,94500,1,0,44100,220500,176400
01SCS19E050056,AR.PUB-SB008,20ARSB0012,ALL,1,97500,150000,2,0,30000,1,0,30000,120000,90000
01SCS19E050056,ESH.AR-RE0015,00ARRE0099,L,1,102500,330000,2,0,155000,1,0,35000,175000,140000
01SCS19E050057,AR.SMD-SB001,20ARSB0192,M,1,211250,325000,2,0,65000,1,0,65000,260000,195000
01SCS19E050057,AR.TUC-RK028,20ARRK0132,S,1,94250,145000,2,0,29000,1,0,29000,116000,87000
01SCS19E050057,BSC.AR-SA0002,00ARSA0006,M,1,120000,315000,2,0,94500,1,0,44100,220500,176400
01SCS19E050058,AR.TUC-SD008,20ARSD0168,ALL,1,81250,125000,2,0,25000,1,0,25000,100000,75000
01SCS19E050058,ESH.AR-RF0013,00ARRF0080,XL,1,140000,420000,2,0,245000,1,0,35000,175000,140000
01SCS19E050059,BSC.AR-SC0003,00ARSC0025,NON,1,73000,220000,2,0,66000,1,0,30800,154000,123200
01SCS19E050060,AR.YD-SD001,20ARSD0263,L,1,87750,135000,2,0,67500,1,0,16875,67500,50625
01SCS19E050061,BSC.AR-SD0029,00ARSD0170,S,1,44500,159000,2,0,47700,1,0,22260,111300,89040
01SCS19E050062,AR.ESB-SC001,20ARSC0305,M,1,204750,315000,2,0,63000,1,0,63000,252000,189000
01SCS19E050063,BSC.AR-PI0018,00ARPI0018,ALL,1,58334,175000,2,0,75000,1,0,20000,100000,80000
01SCS19E050064,AR.TUC-SB022,20ARSB0486,ALL,1,87750,135000,2,0,27000,1,0,27000,108000,81000
01SCS19E050065,BSC.AR-SD0026,00ARSD0152,S,1,44500,159000,2,0,47700,1,0,22260,111300,89040
01SCS19E050065,BSC.AR-SD0053,00ARSD0284,M,1,44000,159000,2,0,47700,1,0,22260,111300,89040
01SCS19E050066,ESH.AR-QE0002,00ARQE0021,ALL,1,50000,140000,2,0,90000,1,0,10000,50000,40000
01SCS19E050067,AR.ASH-SD004,20ARSD0396,XL,1,243750,375000,2,0,112500,1,0,65625,262500,196875
01SCS19E050067,AR.TUC-SD014,20ARSD0475,L,1,94250,145000,2,0,29000,1,0,29000,116000,87000
01SCS19E050067,AR.TUC-SD021,20ARSD0503,L,1,94250,145000,2,0,29000,1,0,29000,116000,87000
01SCS19E050068,AR.TUC-SB017,20ARSB0475,L,1,87750,135000,2,0,27000,1,0,27000,108000,81000
01SCS19E050069,AR.PUB-SC006,20ARSC0278,L,1,97500,150000,2,0,30000,1,0,30000,120000,90000
01SCS19E050070,AR.CPT-SC014,20ARSC0489,L,1,94250,145000,2,0,29000,1,0,29000,116000,87000
01SCS19E050071,AR.STY-RK002,20ARRK0524,ALL,1,61750,95000,2,0,19000,1,0,19000,76000,57000
01SCS19E050072,BSC.AR-RK0016,00ARRK0110,M,1,43000,135000,2,0,40500,1,0,18900,94500,75600
01SCS19E050072,ESH.AR-QI0003,00ARQI0036,ALL,1,40000,140000,2,0,90000,1,0,10000,50000,40000
01SCS19E050073,BSC.AR-SB0011,00ARSB0096,S,1,44500,135000,2,0,40500,1,0,18900,94500,75600
01SCS19E050074,AR.PUB-RL031,20ARRL0439,ALL,1,97500,150000,2,0,30000,1,0,30000,120000,90000
01SCS19E050074,BSC.AR-RJ0009,00ARRJ0073,L,1,94500,135000,2,0,40500,1,0,18900,94500,75600
01SCS19E050075,BSC.AR-RL0020,00ARRL0118,M,1,125000,315000,2,0,94500,1,0,44100,220500,176400
01SCS19E050075,BSC.AR-SC0029,00ARSC0199,S,1,125000,315000,2,0,94500,1,0,44100,220500,176400
01SCS19E050076,AR.MPR-SB007,20ARSB0259,M,1,97500,150000,2,0,45000,1,0,26250,105000,78750
01SCS19E050076,AR.PUB-SE021,20ARSE0080,M,1,159250,245000,2,0,49000,1,0,49000,196000,147000
01SCS19E050077,BSC.AR-SD0057,00ARSD0293,NON,1,45000,140000,2,0,42000,1,0,19600,98000,78400
01SCS19E050077,ESH.AR-SA0009,00ARSA0089,L,1,122500,350000,2,0,105000,1,0,49000,245000,196000
01SCS19E050078,AR.PUB-RK007,20ARRK0381,XL,1,97500,150000,2,0,30000,1,0,30000,120000,90000
01SCS19E050079,AR.FHL-SC006,20ARSC0347,M,1,110500,170000,2,0,34000,1,0,34000,136000,102000
01SCS19E050080,ESH.AR-SD0039,00ARSD0349,L,1,122500,350000,2,0,105000,1,0,49000,245000,196000
01SCS19E050081,ESH.AR-RF0004,00ARRF0031,M,1,110000,315000,2,0,155000,1,0,32000,160000,128000
01SCS19E050082,ESH.AR-RD0021,00ARRD0193,L,1,42000,135000,2,0,67500,1,0,13500,67500,54000
01SCS19E050082,ESH.AR-RE0004,00ARRE0014,M,1,42000,135000,2,0,67500,1,0,13500,67500,54000
01SCS19E050083,AR.RDC-RL003,20ARRL0446,ALL,1,81250,125000,2,0,37500,1,0,21875,87500,65625
01SCS19E050084,BSC.AR-RK0008,00ARRK0079,L,1,52000,155000,2,0,46500,1,0,21700,108500,86800
01SCS19E050085,AR.ASH-RJ007,20ARRJ0272,L,1,91000,140000,2,0,42000,1,0,24500,98000,73500
01SCS19E050085,BSC.AR-SC0015,00ARSC0102,L,1,44000,159000,2,0,47700,1,0,22260,111300,89040
01SCS19E050086,AR.CPT-RL003,20ARRL0080,L,1,94250,145000,2,0,29000,1,0,29000,116000,87000
01SCS19E050087,BSC.AR-RJ0017,00ARRJ0103,S,1,43000,135000,2,0,40500,1,0,18900,94500,75600
01SCS19E050088,AR.PUB-RK016,20ARRK0458,ALL,1,97500,150000,2,0,30000,1,0,30000,120000,90000
01SCS19E050089,BSC.AR-RH0017,00ARRH0075,M,1,120000,315000,2,0,94500,1,0,44100,220500,176400
01SCS19E050090,AR.MKV-SC018,20ARSC0223,ALL,1,91000,140000,2,0,70000,1,0,17500,70000,52500
01SCS19E050091,AR.TUC-SD017,20ARSD0486,M,1,94250,145000,2,0,29000,1,0,29000,116000,87000
01SCS19E050091,AR.TUC-SD024,20ARSD0514,M,1,204750,315000,2,0,63000,1,0,63000,252000,189000
01SCS19E050092,AR.ESB-SD009,20ARSD0180,M,1,91000,140000,2,0,28000,1,0,28000,112000,84000
01SCS19E050093,ESH.AR-QE0029,00ARQE0163,L,1,110000,325000,2,0,165000,1,0,32000,160000,128000
01SCS19E050094,AR.GTW-RK002,20ARRK0374,ALL,1,91000,140000,2,0,42000,1,0,24500,98000,73500
01SCS19E050094,AR.TUC-SA042,20ARSA0310,ALL,1,100750,155000,2,0,31000,1,0,31000,124000,93000
01SCS19E050094,BSC.AR-RD0040,00ARRD0205,L,1,110000,315000,2,0,155000,1,0,32000,160000,128000
01SCS19E050095,ESH.AR-SB0016,00ARSB0067,M,1,125000,315000,2,0,94500,1,0,44100,220500,176400
01SCS19E050096,BSC.AR-RK0014,00ARRK0103,L,1,43000,135000,2,0,40500,1,0,18900,94500,75600
01SCS19E050097,ESH.AR-RC0029,00ARRC0190,ALL,1,45000,150000,2,0,100000,1,0,10000,50000,40000
01SCS19E050098,BSC.AR-SC0015,00ARSC0101,M,1,44000,159000,2,0,47700,1,0,22260,111300,89040
01SCS19E050099,ESH.AR-SD0010,00ARSD0070,M,1,44500,135000,2,0,40500,1,0,18900,94500,75600
01SCS19E050100,ESH.AR-SD0011,00ARSD0074,M,1,125000,315000,2,0,94500,1,0,44100,220500,176400
01SCS19E050101,ESH.AR-SA0014,00ARSA0102,M,1,44000,135000,2,0,40500,1,0,18900,94500,75600
01SCS19E050102,AR.SMD-RH008,20ARRH0756,L,1,87750,135000,2,0,40500,1,0,23625,94500,70875
01SCS19E050102,ESH.AR-SC0005,00ARSC0028,L,1,125000,315000,2,0,94500,1,0,44100,220500,176400
01SCS19E050103,AR.MKV-RJ021,20ARSC0068,28,1,117000,180000,2,0,36000,1,0,36000,144000,108000
01SCS19E050104,AR.HLW-SC004,20ARSC0126,S,1,195000,300000,2,0,90000,1,0,52500,210000,157500
01SCS19E050105,BSC.AR-PI0019,00ARPI0019,ALL,1,58334,175000,2,0,75000,1,0,20000,100000,80000
01SCS19E050106,BSC.AR-SC0050,00ARSC0312,S,1,44000,159000,2,0,47700,1,0,22260,111300,89040
01SCS19E050107,AR.ESB-SC001,20ARSC0305,M,1,204750,315000,2,0,63000,1,0,63000,252000,189000
01SCS19E050108,AR.FHL-SC003,20ARSC0335,M,1,91000,140000,2,0,28000,1,0,28000,112000,84000
01SCS19E050108,AR.TRF-RJ003,20ARRJ0063,S,1,97500,150000,2,0,45000,1,0,26250,105000,78750
01SCS19E050109,AR.PUB-SC014,20ARSC0359,XL,1,97500,150000,2,0,30000,1,0,30000,120000,90000
01SCS19E050109,AR.SMD-SA002,20ARSA0226,XL,1,87750,135000,2,0,27000,1,0,27000,108000,81000
01SCS19E050110,ESH.AR-SC0015,00ARSC0120,S,1,44000,135000,2,0,40500,1,0,18900,94500,75600
01SCS19E050111,BSC.AR-SA0001,00ARSA0001,S,1,120000,315000,2,0,94500,1,0,44100,220500,176400
01SCS19E050112,ARN.AR-RK0004,00ARRK0233,XL,1,150000,450000,2,0,90000,1,0,108000,360000,252000
01SCS19E050112,ESH.AR-SB0019,00ARSB0114,NON,1,41000,120000,2,0,36000,1,0,16800,84000,67200
01SCS19E050113,AR.CPT-SC002,20ARSC0245,30,1,227500,350000,2,0,70000,1,0,70000,280000,210000
01SCS19E050113,AR.PUB-SA009,20ARSA0331,L,1,224250,345000,2,0,69000,1,0,69000,276000,207000
01SCS19E050114,ESH.AR-SD0005,00ARSD0050,M,1,44000,135000,2,0,40500,1,0,18900,94500,75600
01SCS19E050115,AR.CPT-SC012,20ARSC0482,XL,1,204750,315000,2,0,63000,1,0,63000,252000,189000
01SCS19E050115,AR.PUB-SB033,20ARSB0464,ALL,1,97500,150000,2,0,30000,1,0,30000,120000,90000
01SCS19E050116,ESH.AR-RL0013,00ARRL0126,NON,1,47000,130000,2,0,39000,1,0,18200,91000,72800
01SCS19E050117,AR.TUC-SD003,20ARSD0149,M,1,204750,315000,2,0,63000,1,0,63000,252000,189000
01SCS19E050117,BSC.AR-RI0037,00ARRI0213,NON,1,273000,390000,2,0,117000,1,0,54600,273000,218400
01SCS19E050117,BSC.AR-SD0003,00ARSD0011,L,1,44000,159000,2,0,47700,1,0,22260,111300,89040
01SCS19E050117,BSC.AR-SD0028,00ARSD0161,M,1,125000,315000,2,0,94500,1,0,44100,220500,176400
01SCS19E050117,ESH.AR-QD0038,00ARQD0297,ALL,1,45000,140000,2,0,90000,1,0,10000,50000,40000
01SCS19E050117,ESH.AR-SD0022,00ARSD0168,NON,1,43000,120000,2,0,36000,1,0,16800,84000,67200
01SCS19E050118,BSC.AR-SC0004,00ARSC0030,S,1,125000,315000,2,0,94500,1,0,44100,220500,176400
01SCS19E050119,ESH.AR-SC0013,00ARSC0106,L,1,44500,135000,2,0,40500,1,0,18900,94500,75600
01SCS19E050119,ESH.AR-SD0001,00ARSD0031,L,1,44500,135000,2,0,40500,1,0,18900,94500,75600
01SCS19E050120,ESH.AR-RE0002,00ARRE0005,S,1,42000,135000,2,0,67500,1,0,13500,67500,54000
01SCS19E050120,ESH.AR-RE0007,00ARRE0026,M,1,42000,135000,2,0,67500,1,0,13500,67500,54000
01SCS19E050121,AR.MPR-SB020,20ARSB0307,ALL,1,97500,150000,2,0,45000,1,0,26250,105000,78750
01SCS19E050121,AR.VCS-RI007,20ARRI0296,L,1,243750,375000,2,0,112500,1,0,65625,262500,196875
01SCS19E050122,AR.ESB-SC002,20ARSC0308,S,1,204750,315000,2,0,63000,1,0,63000,252000,189000
01SCS19E050123,AR.CPT-RH008,20ARRH0869,M,1,204750,315000,2,0,63000,1,0,63000,252000,189000
01SCS19E050124,AR.TUC-SB009,20ARSB0037,ALL,1,97500,150000,2,0,30000,1,0,30000,120000,90000
01SCS19E050124,BSC.AR-SB0019,00ARSB0165,L,1,125000,315000,2,0,94500,1,0,44100,220500,176400
01SCS19E050125,AR.ESB-QE014,20ARQE0413,M,1,97500,150000,2,0,75000,1,0,18750,75000,56250
01SCS19E050125,AR.PCT-RE011,20ARRE1435,L,1,81250,125000,2,0,62500,1,0,15625,62500,46875
01SCS19E050126,ESH.AR-RF0007,00ARRF0044,L,1,150000,395000,2,0,220000,1,0,35000,175000,140000
01SCS19E050127,AR.SLT-SB002,20ARSB0158,32,1,425000,500000,2,0,50000,1,0,67500,450000,382500
01SCS19E050128,BSC.AR-SD0054,00ARSD0287,NON,1,50000,150000,2,0,45000,1,0,21000,105000,84000
01SCS19E050128,ESH.AR-SC0010,00ARSC0080,S,1,44500,135000,2,0,40500,1,0,18900,94500,75600
01SCS19E050129,AR.PUB-SE023,20ARSE0087,S,1,159250,245000,2,0,49000,1,0,49000,196000,147000
01SCS19E050130,AR.ESB-SC003,20ARSC0419,M,1,91000,140000,2,0,28000,1,0,28000,112000,84000
01SCS19E050131,ESH.AR-SD0026,00ARSD0266,S,1,44500,135000,2,0,40500,1,0,18900,94500,75600
01SCS19E050132,AR.ESB-RH008,20ARRH0197,ALL,1,91000,140000,2,0,42000,1,0,24500,98000,73500
01SCS19E050133,AR.CLK-SA006,20ARSA0055,ALL,1,110500,170000,2,0,34000,1,0,34000,136000,102000
01SCS19E050134,ESH.AR-RG0003,00ARRG0008,L,1,90000,255000,2,0,76500,1,0,35700,178500,142800
01SCS19E050135,AR.PCT-RK001,20ARRK0249,ALL,1,178750,275000,2,0,55000,1,0,55000,220000,165000
01SCS19E050136,ESH.AR-QE0029,00ARQE0163,L,1,110000,325000,2,0,165000,1,0,32000,160000,128000
01SCS19E050137,BSC.AR-RD0040,00ARRD0205,L,1,110000,315000,2,0,155000,1,0,32000,160000,128000
01SCS19E050137,ESH.AR-QE0007,00ARQE0026,ALL,1,39800,140000,2,0,90000,1,0,10000,50000,40000
01SCS19E050138,AR.CPT-RK011,20ARRK0033,ALL,1,48750,75000,2,0,15000,1,0,15000,60000,45000
01SCS19E050138,AR.FHL-SC003,20ARSC0335,M,1,91000,140000,2,0,28000,1,0,28000,112000,84000
01SCS19E050139,BSC.AR-RH0017,00ARRH0074,S,1,120000,315000,2,0,94500,1,0,44100,220500,176400
01SCS19E050139,BSC.AR-SC0021,00ARSC0148,NON,1,73000,220000,2,0,66000,1,0,30800,154000,123200
01SCS19E050140,ESH.AR-RK0004,00ARRK0014,M,1,120000,315000,2,0,94500,1,0,44100,220500,176400
01SCS19E050141,AR.FHL-SC008,20ARSC0351,ALL,1,110500,170000,2,0,34000,1,0,34000,136000,102000
01SCS19E050142,AR.CPT-RI004,20ARRI0054,L,1,94250,145000,2,0,29000,1,0,29000,116000,87000
01SCS19E050143,AR.PUB-SD031,20ARSD0217,36,1,211250,325000,2,0,65000,1,0,65000,260000,195000
01SCS19E050144,BSC.AR-RH0018,00ARRH0079,M,1,120000,315000,2,0,94500,1,0,44100,220500,176400
01SCS19E050144,ESH.AR-RK0019,00ARRK0197,L,1,192500,275000,2,0,82500,1,0,38500,192500,154000
01SCS19E050145,AR.VCS-SC005,20ARSC0389,M,1,97500,150000,2,0,45000,1,0,26250,105000,78750
01SCS19E050145,BSC.AR-SB0009,00ARSB0083,M,1,44500,135000,2,0,40500,1,0,18900,94500,75600
01SCS19E050146,AR.CPT-RI004,20ARRI0053,M,1,94250,145000,2,0,29000,1,0,29000,116000,87000
01SCS19E050146,AR.HMR-SB013,20ARSB0375,ALL,1,78000,120000,2,0,24000,1,0,24000,96000,72000
01SCS19E050147,AR.ESB-SC019,20ARSC0468,ALL,1,68250,105000,2,0,31500,1,0,18375,73500,55125
01SCS19E050148,AR.ESB-SD011,20ARSD0320,L,1,91000,140000,2,0,28000,1,0,28000,112000,84000
01SCS19E050148,AR.PUB-RE011,20ARRE0239,L,1,97500,150000,2,0,30000,1,0,30000,120000,90000
01SCS19E050148,BSC.AR-SA0015,00ARSA0045,L,1,44500,135000,2,0,40500,1,0,18900,94500,75600
01SCS19E050149,AR.MPR-SB017,20ARSB0300,L,1,230750,355000,2,0,71000,1,0,71000,284000,213000
01SCS19E050149,AR.REC-SD015,20ARSD0053,ALL,1,107250,165000,2,0,49500,1,0,28875,115500,86625
01SCS19E050149,AR.STY-RK005,20ARRK0527,ALL,1,61750,95000,2,0,19000,1,0,19000,76000,57000
01SCS19E050149,BSC.AR-RE0015,00ARRE0108,NON,1,35000,120000,2,0,36000,1,0,16800,84000,67200
01SCS19E050149,BSC.AR-RH0018,00ARRH0078,S,1,120000,315000,2,0,94500,1,0,44100,220500,176400
01SCS19E050149,BSC.AR-SD0006,00ARSD0023,L,1,44000,159000,0,0,0,0,0,31800,159000,127200
01SCS19E050150,ESH.AR-RL0018,00ARRL0147,32,1,122500,175000,2,0,52500,1,0,24500,122500,98000
01SCS19E050151,AR.MPR-SB008,20ARSB0264,L,1,97500,150000,2,0,45000,1,0,26250,105000,78750
01SCS19E050152,AR.TUC-SB002,20ARSB0029,L,1,204750,315000,2,0,63000,1,0,63000,252000,189000
01SCS19E050153,AR.MPR-SB002,20ARSB0238,S,1,243750,375000,2,0,75000,1,0,75000,300000,225000
01SCS19E050154,AR.CPT-SD002,20ARSD0138,ALL,1,94250,145000,2,0,29000,1,0,29000,116000,87000
01SCS19E050155,AR.TUC-RK009,20ARRK0105,ALL,1,87750,135000,2,0,27000,1,0,27000,108000,81000
01SCS19E050155,BSC.AR-SD0004,00ARSD0013,S,1,44000,159000,0,0,0,0,0,31800,159000,127200
01SCS19E050155,ESH.AR-SC0004,00ARSC0021,S,1,44500,135000,2,0,40500,1,0,18900,94500,75600
01SCS19E050156,AR.HMR-SB030,20ARSB0437,30,1,96850,149000,2,0,29800,1,0,29800,119200,89400
01SCS19E050156,AR.PUB-RK007,20ARRK0380,L,1,97500,150000,2,0,30000,1,0,30000,120000,90000
01SCS19E050157,AR.BPH-RK003,20ARRK0047,M,1,103350,159000,2,0,47700,1,0,27825,111300,83475
01SCS19E050157,AR.CPT-SD011,20ARSD0454,M,1,94250,145000,2,0,29000,1,0,29000,116000,87000
01SCS19E050158,AR.MKV-QB034,20ARQB0424,L,1,165750,255000,2,0,127500,1,0,31875,127500,95625
01SCS19E050159,AR.TUC-SD001,20ARSD0142,L,1,204750,315000,2,0,63000,1,0,63000,252000,189000
01SCS19E050160,AR.HLW-SC003,20ARSC0124,M,1,208000,320000,2,0,96000,1,0,56000,224000,168000
01SCS19E050161,BE.RAK-RX381,00BERX1439,M,1,91000,140000,2,0,28000,1,0,28000,112000,84000
01SCS19E050161,BSC.AR-SD0052,00ARSD0280,M,1,44500,159000,2,0,47700,1,0,22260,111300,89040
01SCS19E050162,AR.PUB-RJ002,20ARRJ0006,M,1,97500,150000,2,0,30000,1,0,30000,120000,90000
01SCS19E050163,ESH.AR-SD0004,00ARSD0046,M,1,44500,135000,2,0,40500,1,0,18900,94500,75600
01SCS19E050164,ESH.AR-QD0038,00ARQD0297,ALL,1,45000,140000,2,0,90000,1,0,10000,50000,40000
01SCS19E050165,AR.PUB-RJ002,20ARRJ0006,M,1,97500,150000,2,0,30000,1,0,30000,120000,90000
01SCS19E050165,ESH.AR-SC0028,00ARSC0265,S,1,44500,135000,2,0,40500,1,0,18900,94500,75600
01SCS19E050166,AR.PUB-SD019,20ARSD0188,ALL,1,97500,150000,2,0,30000,1,0,30000,120000,90000
01SCS19E050167,BSC.AR-RK0007,00ARRK0073,S,1,52000,155000,2,0,46500,1,0,21700,108500,86800
01SCS19E050168,AR.YD-RL014,20ARRL0034,M,1,195000,300000,2,0,150000,1,0,37500,150000,112500
01SCS19E050168,ESH.AR-RD0007,00ARRD0054,NON,1,80500,115000,2,0,34500,1,0,16100,80500,64400
01SCS19E050169,BSC.AR-SB0008,00ARSB0080,L,1,44500,135000,2,0,40500,1,0,18900,94500,75600
01SCS19E050169,BSC.AR-SD0008,00ARSD0035,L,1,44500,159000,2,0,47700,1,0,22260,111300,89040
01SCS19E050170,BE.RAK-SB011,00BESB0053,L,1,201500,310000,2,0,62000,1,0,62000,248000,186000
01SCS19E050171,ESH.AR-RE0002,00ARRE0006,M,1,42000,135000,2,0,67500,1,0,13500,67500,54000
01SCS19E050171,ESH.AR-RE0007,00ARRE0026,M,1,42000,135000,2,0,67500,1,0,13500,67500,54000
01SCS19E050172,AR.PUB-RL009,20ARRL0139,M,1,159250,245000,2,0,49000,1,0,49000,196000,147000
01SCS19E050173,AR.HMR-SB020,20ARSB0390,28,1,204750,315000,2,0,63000,1,0,63000,252000,189000
01SCS19E050174,AR.MKV-SC002,20ARSC0074,30,1,117000,180000,2,0,36000,1,0,36000,144000,108000
01SCS19E050175,AR.SMD-QD013,20ARQD0192,L,1,84500,130000,2,0,39000,1,0,22750,91000,68250
01SCS19E050176,AR.FHL-SC008,20ARSC0351,ALL,1,110500,170000,2,0,34000,1,0,34000,136000,102000
01SCS19E050176,ESH.AR-RI0013,00ARRI0141,NON,1,98000,140000,2,0,42000,1,0,19600,98000,78400
01SCS19E050177,AR.KNR-RL001,20ARRL0412,S,1,152750,235000,2,0,70500,1,0,41125,164500,123375
01SCS19E050178,AR.CPS-SC009,20ARSC0009,ALL,1,130000,200000,2,0,60000,1,0,35000,140000,105000
01SCS19E050178,AR.STY-SC001,20ARSC0200,ALL,1,77350,119000,2,0,23800,1,0,23800,95200,71400
01SCS19E050179,ESH.AR-SD0026,00ARSD0267,M,1,44500,135000,2,0,40500,1,0,18900,94500,75600
01SCS19E050180,BSC.AR-SD0063,00ARSD0338,NON,1,60000,180000,2,0,54000,1,0,25200,126000,100800
01SCS19E050181,ESH.AR-SA0001,00ARSA0013,28,1,122500,175000,2,0,52500,1,0,24500,122500,98000
01SCS19E050182,AR.HLW-SC004,20ARSC0127,M,1,195000,300000,2,0,90000,1,0,52500,210000,157500
01SCS19E050183,AR.HMR-SB032,20ARSB0444,28,1,204750,315000,2,0,63000,1,0,63000,252000,189000
01SCS19E060001,BSC.AR-RI0018,00ARRI0068,L,1,94500,135000,2,0,40500,1,0,18900,94500,75600
01SCS19E060001,ESH.AR-SC0017,00ARSC0142,L,1,44000,135000,2,0,40500,1,0,18900,94500,75600
01SCS19E060002,ESH.AR-PK0043,00ARPK0199,M,1,110000,325000,2,0,165000,1,0,32000,160000,128000
01SCS19E060003,BSC.AR-RJ0011,00ARRJ0080,M,1,44500,135000,2,0,40500,1,0,18900,94500,75600
01SCS19E060003,BSC.AR-SD0027,00ARSD0156,S,1,125000,315000,2,0,94500,1,0,44100,220500,176400
01SCS19E060004,AR.ESB-SB003,20ARSB0102,L,1,100750,155000,2,0,31000,1,0,31000,124000,93000
01SCS19E060004,AR.PCT-SB001,20ARSB0166,ALL,1,201500,310000,2,0,62000,1,0,62000,248000,186000
01SCS19E060005,AR.STY-SE007,20ARSE0125,ALL,1,55250,85000,2,0,17000,1,0,17000,68000,51000
01SCS19E060005,BSC.AR-RI0016,00ARRI0060,L,1,43000,135000,2,0,40500,1,0,18900,94500,75600
01SCS19E060005,BSC.AR-SD0005,00ARSD0018,M,1,44500,159000,0,0,0,0,0,31800,159000,127200
01SCS19E060005,ESH.AR-SC0017,00ARSC0141,M,1,44000,135000,2,0,40500,1,0,18900,94500,75600
01SCS19E060005,ESH.AR-SE0001,00ARSE0002,M,1,44000,135000,2,0,40500,1,0,18900,94500,75600
01SCS19E060006,BE.RAK-RL029,00BERL0103,M,1,259350,399000,2,0,79800,1,0,79800,319200,239400
01SCS19E060006,BSC.AR-SA0022,00ARSA0113,NON,1,47500,140000,2,0,42000,1,0,19600,98000,78400
01SCS19E060007,BSC.AR-SD0004,00ARSD0015,L,1,44000,159000,3,0,47700,1,0,22260,111300,89040
01SCS19E060008,ESH.AR-RF0007,00ARRF0044,L,1,150000,395000,2,0,220000,1,0,35000,175000,140000
01SCS19E060009,AR.CPT-RI009,20ARRI0074,L,1,94251,169000,2,0,33800,1,0,33800,135200,101400
01SCS19E060009,AR.MDS-RL007,20ARRL0379,L,1,130000,200000,2,0,40000,1,0,40000,160000,120000
01SCS19E060009,BSC.AR-SD0072,00ARSD0402,NON,1,12000,59000,2,0,17700,1,0,8260,41300,33040
01SCS19E060010,AR.PUB-SB011,20ARSB0016,30,1,211250,325000,2,0,65000,1,0,65000,260000,195000
01SCS19E060011,AR.CPS-SC004,20ARSC0004,ALL,1,130000,200000,2,0,60000,1,0,35000,140000,105000
01SCS19E060011,BSC.AR-SD0063,00ARSD0338,NON,1,60000,180000,2,0,54000,1,0,25200,126000,100800
01SCS19E060012,BSC.AR-RE0015,00ARRE0108,NON,1,35000,120000,2,0,36000,1,0,16800,84000,67200
01SCS19E060013,AR.TUC-SD007,20ARSD0166,L,1,185250,285000,2,0,57000,1,0,57000,228000,171000
01SCS19E060014,ESH.AR-SB0015,00ARSB0063,M,1,125000,315000,2,0,94500,1,0,44100,220500,176400
01SCS19E060015,BE.RAK-SB035,00BESB0107,XL,1,91000,140000,2,0,28000,1,0,28000,112000,84000
01SCS19E060015,BSC.AR-SD0016,00ARSD0121,XL,1,122000,375000,2,0,112500,1,0,52500,262500,210000
01SCS19E060016,ESH.AR-RD0024,00ARRD0228,M,1,145000,435000,2,0,260000,1,0,35000,175000,140000
01SCS19E060017,AR.ESB-SC002,20ARSC0310,L,1,204750,315000,2,0,63000,1,0,63000,252000,189000
01SCS19E060018,AR.CPT-SD006,20ARSD0434,M,1,200850,309000,2,0,61800,1,0,61800,247200,185400
01SCS19E060018,BSC.AR-SC0004,00ARSC0030,S,1,125000,315000,2,0,94500,1,0,44100,220500,176400
01SCS19E060018,ESH.AR-QH0026,00ARQH0137,ALL,1,39700,140000,2,0,90000,1,0,10000,50000,40000
01SCS19E060019,AR.PUB-SB028,20ARSB0146,L,1,224250,345000,2,0,69000,1,0,69000,276000,207000
01SCS19E060019,ESH.AR-QD0038,00ARQD0297,ALL,1,45000,140000,2,0,90000,1,0,10000,50000,40000
01SCS19E060020,AR.REC-SD020,20ARSD0059,30,1,208000,320000,2,0,96000,1,0,56000,224000,168000
01SCS19E060021,BSC.AR-RH0004,00ARRH0019,L,1,42000,135000,2,0,40500,1,0,18900,94500,75600
01SCS19E060022,BSC.AR-RH0004,00ARRH0019,L,1,42000,135000,2,0,40500,1,0,18900,94500,75600
01SCS19E060022,ESH.AR-QD0038,00ARQD0297,ALL,1,45000,140000,2,0,90000,1,0,10000,50000,40000
01SCS19E060023,BSC.AR-RL0020,00ARRL0118,M,1,125000,315000,2,0,94500,1,0,44100,220500,176400
01SCS19E060024,BSC.AR-SC0038,00ARSC0250,M,1,190000,475000,2,0,142500,1,0,66500,332500,266000
01SCS19E060025,AR.TRF-RJ007,20ARRJ0082,XL,1,97500,150000,2,0,45000,1,0,26250,105000,78750
01SCS19E060026,ESH.AR-SD0023,00ARSD0169,NON,1,43000,120000,2,0,36000,1,0,16800,84000,67200
01SCS19E060027,BSC.AR-RK0022,00ARRK0209,L,1,120000,315000,2,0,94500,1,0,44100,220500,176400
01SCS19E060027,ESH.AR-SC0008,00ARSC0068,S,1,44500,135000,2,0,40500,1,0,18900,94500,75600
01SCS19E060028,AR.CPT-SC004,20ARSC0253,M,1,304850,469000,2,0,93800,1,0,93800,375200,281400
01SCS19E060029,AR.TUC-RK052,20ARRK0215,XL,1,87750,135000,2,0,27000,1,0,27000,108000,81000
01SCS19E060030,AR.VCS-RL005,20ARRL0309,L,1,97500,150000,2,0,45000,1,0,26250,105000,78750
01SCS19E060030,ESH.AR-SA0013,00ARSA0099,L,1,44000,135000,2,0,40500,1,0,18900,94500,75600
01SCS19E060031,AR.TUC-SA006,20ARSA0022,M,1,87750,135000,2,0,27000,1,0,27000,108000,81000
01SCS19E060032,AR.CPT-SC008,20ARSC0268,S,1,94250,145000,2,0,29000,1,0,29000,116000,87000
01SCS19E060033,AR.PUB-SD035,20ARSD0345,M,1,204750,315000,2,0,63000,1,0,63000,252000,189000
01SCS19E060033,BSC.AR-SA0007,00ARSA0031,M,1,44500,135000,2,0,40500,1,0,18900,94500,75600
01SCS19E060034,ESH.AR-SD0018,00ARSD0139,XL,1,125000,315000,2,0,94500,1,0,44100,220500,176400
01SCS19E060035,ESH.AR-SB0032,00ARSB0210,L,1,125000,315000,2,0,94500,1,0,44100,220500,176400
01SCS19E060036,BSC.AR-RK0015,00ARRK0106,M,1,43000,135000,2,0,40500,1,0,18900,94500,75600
01SCS19E060036,BSC.AR-SC0049,00ARSC0308,S,1,44500,159000,0,0,0,0,0,31800,159000,127200
01SCS19E060036,BSC.AR-SC0050,00ARSC0312,S,1,44000,159000,2,0,47700,1,0,22260,111300,89040
01SCS19E060037,BSC.AR-SC0017,00ARSC0117,M,1,44500,135000,2,0,40500,1,0,18900,94500,75600
01SCS19E060037,ESH.AR-SC0032,00ARSC0281,M,1,44500,135000,2,0,40500,1,0,18900,94500,75600
01SCS19E060038,AR.VRS-SC002,20ARSC0167,M,1,96850,149000,2,0,44700,1,0,26075,104300,78225
01SCS19E060039,ARN.AR-SB0001,00ARSB0086,NON,1,107400,179000,2,0,35800,1,0,42960,143200,100240
01SCS19E060040,ESH.AR-RL0013,00ARRL0126,NON,1,47000,130000,2,0,39000,1,0,18200,91000,72800
01SCS19E060041,ESH.AR-SD0018,00ARSD0137,M,1,125000,315000,2,0,94500,1,0,44100,220500,176400
01SCS19E060042,BSC.AR-RK0025,00ARRK0217,NON,1,75000,225000,2,0,67500,1,0,31500,157500,126000
01SCS19E060042,BSC.AR-SE0001,00ARSE0057,S,1,44500,159000,2,0,47700,1,0,22260,111300,89040
01SCS19E060043,AR.HMR-SB002,20ARSB0342,L,1,226850,349000,2,0,69800,1,0,69800,279200,209400
01SCS19E060043,BSC.AR-SC0038,00ARSC0250,M,1,190000,475000,2,0,142500,1,0,66500,332500,266000
01SCS19E060043,ESH.AR-RG0003,00ARRG0007,M,1,90000,255000,2,0,76500,1,0,35700,178500,142800
01SCS19E060044,BSC.AR-RI0017,00ARRI0063,M,1,43000,135000,2,0,40500,1,0,18900,94500,75600
01SCS19E060045,AR.SMD-RH007,20ARRH0751,M,1,87750,135000,2,0,40500,1,0,23625,94500,70875
01SCS19E060046,ESH.AR-SC0005,00ARSC0027,M,1,125000,315000,2,0,94500,1,0,44100,220500,176400
01SCS19E060047,ESH.AR-RH0018,00ARRH0099,S,1,94500,135000,2,0,40500,1,0,18900,94500,75600
01SCS19E060047,ESH.AR-SD0009,00ARSD0065,S,1,44500,135000,2,0,40500,1,0,18900,94500,75600
01SCS19E060048,ESH.AR-RJ0005,00ARRJ0027,S,1,94500,135000,2,0,40500,1,0,18900,94500,75600
01SCS19E060049,BSC.AR-SD0027,00ARSD0157,M,1,125000,315000,2,0,94500,1,0,44100,220500,176400
01SCS19E060050,BSC.AR-SD0028,00ARSD0160,S,1,125000,315000,2,0,94500,1,0,44100,220500,176400
01SCS19E060050,ESH.AR-SD0038,00ARSD0343,S,1,122500,350000,2,0,105000,1,0,49000,245000,196000
01SCS19E060051,BSC.AR-SD0027,00ARSD0157,M,1,125000,315000,2,0,94500,1,0,44100,220500,176400
01SCS19E060052,ESH.AR-SB0032,00ARSB0209,M,1,125000,315000,2,0,94500,1,0,44100,220500,176400
01SCS19E060053,ESH.AR-SC0022,00ARSC0164,XL,1,125000,315000,2,0,94500,1,0,44100,220500,176400
01SCS19E060054,AR.BPH-RB021,20ARSD0357,XL,1,214500,330000,2,0,165000,1,0,41250,165000,123750
01SCS19E060054,AR.BPH-RH029,20ARRH0796,XL,1,220350,339000,2,0,169500,1,0,42375,169500,127125
01SCS19E060054,AR.GTW-SB001,20ARSB0151,XL,1,94250,145000,2,0,43500,1,0,25375,101500,76125
01SCS19E060054,AR.PUB-RJ013,20ARRJ0036,32,1,211250,325000,2,0,65000,1,0,65000,260000,195000
01SCS19E060054,AR.PUB-SE017,20ARSE0068,XL,1,159250,245000,2,0,49000,1,0,49000,196000,147000
01SCS19E060054,AR.PUB-SE020,20ARSE0078,L,1,159250,245000,2,0,49000,1,0,49000,196000,147000
01SCS19E060054,AR.YAS-RH009,20ARRH0863,XL,1,122850,189000,2,0,37800,1,0,37800,151200,113400
01SCS19E060054,ARN.AR-RK0001,00ARRK0221,XL,1,43000,140000,2,0,28000,1,0,33600,112000,78400
01SCS19E060054,ARN.AR-RK0002,00ARRK0225,XL,1,43000,140000,2,0,28000,1,0,33600,112000,78400
01SCS19E060054,ARN.AR-RK0005,00ARRK0237,34,1,110000,350000,2,0,70000,1,0,84000,280000,196000
01SCS19E060054,BSC.AR-RH0026,00ARRH0166,34,1,245000,350000,2,0,105000,1,0,49000,245000,196000
01SCS19E060054,BSC.AR-RI0038,00ARRI0217,XL,1,262500,375000,2,0,112500,1,0,52500,262500,210000
01SCS19E060054,BSC.AR-RJ0011,00ARRJ0081,L,1,44500,135000,2,0,40500,1,0,18900,94500,75600
01SCS19E060054,BSC.AR-SC0026,00ARSC0188,XL,1,106400,350000,2,0,105000,1,0,49000,245000,196000
01SCS19E060054,BSC.AR-SC0027,00ARSC0193,XL,1,106400,350000,2,0,105000,1,0,49000,245000,196000
01SCS19E060054,BSC.AR-SC0032,00ARSC0222,34,1,135000,375000,2,0,112500,1,0,52500,262500,210000
01SCS19E060054,BSC.AR-SC0038,00ARSC0252,XL,1,190000,475000,2,0,142500,1,0,66500,332500,266000
01SCS19E060054,ESH.AR-SB0014,00ARSB0060,NON,1,45000,140000,2,0,42000,1,0,19600,98000,78400
01SCS19E060054,ESH.AR-SD0016,00ARSD0097,XL,1,106400,350000,2,0,105000,1,0,49000,245000,196000
01SCS19E060055,AR.PUB-SD026,20ARSD0202,M,1,97500,150000,2,0,30000,1,0,30000,120000,90000
01SCS19E060055,BSC.AR-SD0006,00ARSD0022,M,1,44000,159000,0,0,0,0,0,31800,159000,127200
01SCS19E060056,ESH.AR-SC0035,00ARSC0300,NON,1,55000,140000,2,0,42000,1,0,19600,98000,78400
01SCS19E060057,ESH.AR-SB0033,00ARSB0212,S,1,44500,135000,2,0,40500,1,0,18900,94500,75600
01SCS19E060058,AR.MKV-QJ007,20ARQJ0032,30,1,227500,350000,2,0,175000,1,0,43750,175000,131250
01SCS19E060058,AR.PUB-RH010,20ARRH0025,M,1,97500,150000,2,0,30000,1,0,30000,120000,90000
01SCS19E060059,AR.MKV-QE005,20ARQE0162,30,1,234000,360000,2,0,180000,1,0,45000,180000,135000
01SCS19E060059,AR.MKV-SD004,20ARSD0231,30,1,117000,180000,2,0,36000,1,0,36000,144000,108000
01SCS19E060059,AR.MKV-SD007,20ARSD0409,28,1,117000,180000,2,0,90000,1,0,22500,90000,67500
01SCS19E060059,AR.SMD-SD005,20ARSD0292,S,1,87750,135000,2,0,27000,1,0,27000,108000,81000
01SCS19E060059,BSC.AR-SB0012,00ARSB0102,S,1,110000,325000,2,0,97500,1,0,45500,227500,182000
01SCS19E060060,BSC.AR-SC0042,00ARSC0278,L,1,135000,375000,2,0,112500,1,0,52500,262500,210000
01SCS19E060060,ESH.AR-SD0015,00ARSD0092,XL,1,106400,350000,2,0,105000,1,0,49000,245000,196000
01SCS19E060061,ESH.AR-RJ0023,00ARRJ0218,NON,1,18000,75000,2,0,22500,1,0,10500,52500,42000
01SCS19E060062,BSC.AR-SA0015,00ARSA0044,M,1,44500,135000,2,0,40500,1,0,18900,94500,75600
01SCS19E060063,AR.ESB-SD009,20ARSD0180,M,1,91000,140000,2,0,28000,1,0,28000,112000,84000
01SCS19E060063,BE.RAK-SA019,00BESA0072,M,1,91000,140000,2,0,28000,1,0,28000,112000,84000
01SCS19E060063,BSC.AR-RL0020,00ARRL0117,S,1,125000,315000,2,0,94500,1,0,44100,220500,176400
01SCS19E060064,AR.ESB-RH010,20ARRH0471,ALL,1,91000,140000,2,0,42000,1,0,24500,98000,73500
01SCS19E060065,ESH.AR-SB0026,00ARSB0158,NON,1,35300,120000,2,0,36000,1,0,16800,84000,67200
01SCS19E060066,AR.PCT-QE004,20ARQE0015,M,1,78000,120000,2,0,60000,1,0,15000,60000,45000
01SCS19E060067,AR.PCT-RL001,20ARRL0185,ALL,1,97500,150000,2,0,30000,1,0,30000,120000,90000
01SCS19E060067,AR.STY-RJ002,20ARRJ0051,ALL,1,55250,85000,2,0,17000,1,0,17000,68000,51000
01SCS19E060067,AR.STY-SA014,20ARSA0073,ALL,1,51350,79000,2,0,15800,1,0,15800,63200,47400
01SCS19E060067,AR.STY-SC004,20ARSC0203,ALL,1,64350,99000,2,0,19800,1,0,19800,79200,59400
01SCS19E060067,BSC.AR-PI0018,00ARPI0018,ALL,1,58334,175000,2,0,75000,1,0,20000,100000,80000
01SCS19E060067,BSC.AR-RL0018,00ARRL0109,S,1,125000,315000,2,0,94500,1,0,44100,220500,176400
01SCS19E060067,ESH.AR-RJ0002,00ARRJ0017,L,1,44500,135000,2,0,40500,1,0,18900,94500,75600
01SCS19E060067,ESH.AR-SA0010,00ARSA0091,NON,1,53000,155000,2,0,46500,1,0,21700,108500,86800
01SCS19E060068,AR.TRF-RJ013,20ARRJ0097,ALL,1,91000,140000,2,0,42000,1,0,24500,98000,73500
01SCS19E060069,AR.MKV-RL003,20ARRL0242,S,1,253500,390000,2,0,195000,1,0,48750,195000,146250
01SCS19E060070,AR.PUB-SD004,20ARSD0090,ALL,1,97500,150000,2,0,30000,1,0,30000,120000,90000
01SCS19E060071,BSC.AR-SD0038,00ARSD0207,S,1,125000,315000,2,0,94500,1,0,44100,220500,176400
01SCS19E060072,BSC.AR-SC0004,00ARSC0030,S,1,125000,315000,2,0,94500,1,0,44100,220500,176400
01SCS19E060073,AR.TUC-RK028,20ARRK0132,S,1,94250,145000,2,0,29000,1,0,29000,116000,87000
01SCS19E060073,BSC.AR-SD0004,00ARSD0013,S,1,44000,159000,0,0,0,0,0,31800,159000,127200
01SCS19E060074,AR.ASH-RJ010,20ARRJ0486,S,1,91000,140000,2,0,42000,1,0,24500,98000,73500
01SCS19E060074,AR.STY-SB011,20ARSB0498,ALL,1,51350,79000,2,0,15800,1,0,15800,63200,47400
01SCS19E060075,BSC.AR-SC0029,00ARSC0200,M,1,125000,315000,2,0,94500,1,0,44100,220500,176400
01SCS19E060075,BSC.AR-SD0004,00ARSD0015,L,1,44000,159000,0,0,0,0,0,31800,159000,127200
01SCS19E060076,AR.RDC-RK010,20ARRK0492,S,1,97500,150000,2,0,30000,1,0,30000,120000,90000
01SCS19E060077,AR.ESB-QJ016,20ARQJ0097,ALL,1,91000,140000,2,0,42000,1,0,24500,98000,73500
01SCS19E060077,AR.MKV-RE035,20ARRE1403,L,1,165750,255000,2,0,51000,1,0,51000,204000,153000
01SCS19E060078,AR.ESB-RH016,20ARRH0825,M,1,198250,305000,2,0,61000,1,0,61000,244000,183000
01SCS19E060079,AR.VCS-SC011,20ARSC0414,L,1,214500,330000,2,0,99000,1,0,57750,231000,173250
01SCS19E060080,AR.ASH-SD005,20ARSD0398,M,1,243750,375000,2,0,112500,1,0,65625,262500,196875
01SCS19E060081,AR.TUC-RL019,20ARRL0343,ALL,1,87750,135000,2,0,27000,1,0,27000,108000,81000
01SCS19E060082,BSC.AR-RJ0011,00ARRJ0081,L,1,44500,135000,2,0,40500,1,0,18900,94500,75600
01SCS19E060082,BSC.AR-SC0017,00ARSC0118,L,1,44500,135000,2,0,40500,1,0,18900,94500,75600
01SCS19E060083,ESH.AR-QI0003,00ARQI0036,ALL,1,40000,140000,2,0,90000,1,0,10000,50000,40000
01SCS19E060083,ESH.AR-SC0010,00ARSC0081,M,1,44500,135000,2,0,40500,1,0,18900,94500,75600
01SCS19E060084,ESH.AR-RK0006,00ARRK0027,L,1,94500,135000,2,0,40500,1,0,18900,94500,75600
01SCS19E060085,ESH.AR-SC0023,00ARSC0166,M,1,125000,315000,2,0,94500,1,0,44100,220500,176400
01SCS19E060086,AR.MDS-RL002,20ARRL0359,M,1,117000,180000,2,0,36000,1,0,36000,144000,108000
01SCS19E060087,AR.HMR-SB019,20ARSB0386,30,1,204750,315000,2,0,63000,1,0,63000,252000,189000
01SCS19E060088,BSC.AR-RC0024,00ARRC0165,ALL,1,43000,185000,2,0,85000,1,0,20000,100000,80000
01SCS19E060089,ESH.AR-RD0024,00ARRD0228,M,1,145000,435000,2,0,260000,1,0,35000,175000,140000
01SCS19E060090,AR.ESB-SB003,20ARSB0102,L,1,100750,155000,2,0,31000,1,0,31000,124000,93000
01SCS19E060090,ESH.AR-SD0009,00ARSD0065,S,1,44500,135000,2,0,40500,1,0,18900,94500,75600
01SCS19E060091,AR.MKV-SC024,20ARSC0242,ALL,1,91000,140000,2,0,28000,1,0,28000,112000,84000
01SCS19E060091,AR.VCS-SC010,20ARSC0410,L,1,214500,330000,2,0,99000,1,0,57750,231000,173250
01SCS19E060092,BSC.AR-SD0052,00ARSD0281,L,1,44500,159000,2,0,47700,1,0,22260,111300,89040
01SCS19E060093,BSC.AR-RD0008,00ARRD0043,36,1,110000,350000,2,0,175000,1,0,35000,175000,140000
01SCS19E060094,ESH.AR-SD0040,00ARSD0366,S,1,122500,350000,2,0,105000,1,0,49000,245000,196000
01SCS19E060095,BSC.AR-PI0018,00ARPI0018,ALL,1,58334,175000,2,0,75000,1,0,20000,100000,80000
01SCS19E060096,AR.VCS-SC011,20ARSC0414,L,1,214500,330000,2,0,99000,1,0,57750,231000,173250
01SCS19E060097,BSC.AR-RL0018,00ARRL0112,XL,1,125000,315000,2,0,94500,1,0,44100,220500,176400
01SCS19E060098,BSC.AR-RE0002,00ARRE0042,M,1,42000,135000,2,0,67500,1,0,13500,67500,54000
01SCS19E060098,ESH.AR-PL0015,00ARPL0127,L,1,110000,325000,2,0,165000,1,0,32000,160000,128000
01SCS19E060098,ESH.AR-RD0031,00ARRD0256,M,1,43000,135000,2,0,67500,1,0,13500,67500,54000
01SCS19E060099,AR.TUC-RL017,20ARRL0341,ALL,1,87750,135000,2,0,27000,1,0,27000,108000,81000
01SCS19E060100,BSC.AR-SC0015,00ARSC0101,M,1,44000,159000,2,0,47700,1,0,22260,111300,89040
01SCS19E060100,BSC.AR-SD0004,00ARSD0015,L,1,44000,159000,0,0,0,0,0,31800,159000,127200
01SCS19E060101,ESH.AR-SE0001,00ARSE0003,L,1,44000,135000,2,0,40500,1,0,18900,94500,75600
01SCS19E060102,AR.PUB-RL004,20ARRL0119,S,1,97500,150000,2,0,30000,1,0,30000,120000,90000
01SCS19E060103,ESH.AR-SB0032,00ARSB0210,L,1,125000,315000,2,0,94500,1,0,44100,220500,176400
01SCS19E060104,AR.VCS-SC004,20ARSC0385,M,1,97500,150000,2,0,45000,1,0,26250,105000,78750
01SCS19E060104,BSC.AR-RE0002,00ARRE0042,M,1,42000,135000,2,0,67500,1,0,13500,67500,54000
01SCS19E060104,ESH.AR-RD0031,00ARRD0256,M,1,43000,135000,2,0,67500,1,0,13500,67500,54000
01SCS19E060105,AR.PUB-RK010,20ARRK0393,XL,1,191750,295000,2,0,59000,1,0,59000,236000,177000
01SCS19E060106,BSC.AR-SD0028,00ARSD0161,M,1,125000,315000,2,0,94500,1,0,44100,220500,176400
01SCS19E070001,AR.STY-SA018,20ARSA0077,ALL,1,51350,79000,2,0,15800,1,0,15800,63200,47400
01SCS19E070001,BSC.AR-SC0012,00ARSC0074,L,1,44000,159000,2,0,47700,1,0,22260,111300,89040
01SCS19E070002,ESH.AR-SD0023,00ARSD0169,NON,1,43000,120000,2,0,36000,1,0,16800,84000,67200
01SCS19E070003,ESH.AR-RJ0016,00ARRJ0188,30,1,262500,375000,2,0,112500,1,0,52500,262500,210000
01SCS19E070004,ARN.AR-SB0001,00ARSB0086,NON,1,107400,179000,2,0,35800,1,0,42960,143200,100240
01SCS19E070005,BSC.AR-RE0002,00ARRE0043,L,1,42000,135000,2,0,67500,1,0,13500,67500,54000
01SCS19E070005,ESH.AR-RD0003,00ARRD0051,36,1,110000,350000,2,0,175000,1,0,35000,175000,140000
01SCS19E070005,ESH.AR-RE0007,00ARRE0027,L,1,42000,135000,2,0,67500,1,0,13500,67500,54000
01SCS19E070006,BSC.AR-SD0027,00ARSD0156,S,1,125000,315000,2,0,94500,1,0,44100,220500,176400
01SCS19E070007,BSC.AR-RH0030,00ARRH0184,XL,1,37000,155000,2,0,46500,1,0,21700,108500,86800
01SCS19E070008,ESH.AR-QK0012,00ARQK0072,M,1,100000,310000,2,0,150000,1,0,32000,160000,128000
01SCS19E070008,ESH.AR-RF0012,00ARRF0066,M,1,43000,135000,2,0,67500,1,0,13500,67500,54000
01SCS19E070008,ESH.AR-RF0020,00ARRF0139,M,1,42000,135000,2,0,67500,1,0,13500,67500,54000
01SCS19E070009,BSC.AR-RE0002,00ARRE0042,M,1,42000,135000,2,0,67500,1,0,13500,67500,54000
01SCS19E070009,ESH.AR-RE0007,00ARRE0026,M,1,42000,135000,2,0,67500,1,0,13500,67500,54000
01SCS19E070010,ESH.AR-SD0026,00ARSD0266,S,1,44500,135000,2,0,40500,1,0,18900,94500,75600
01SCS19E070011,AR.MDG-RJ003,20ARRJ0555,M,1,94250,145000,2,0,43500,1,0,25375,101500,76125
01SCS19E070011,AR.MDG-SC001,20ARSC0153,L,1,94250,145000,2,0,43500,1,0,25375,101500,76125
01SCS19E070011,ESH.AR-QE0002,00ARQE0021,ALL,1,50000,140000,2,0,90000,1,0,10000,50000,40000
01SCS19E070011,ESH.AR-RD0018,00ARRD0185,NON,1,55000,150000,2,0,100000,1,0,10000,50000,40000
01SCS19E070012,ESH.AR-SB0016,00ARSB0067,M,1,125000,315000,2,0,94500,1,0,44100,220500,176400
01SCS19E070013,BSC.AR-RI0010,00ARRI0036,L,1,94500,135000,2,0,40500,1,0,18900,94500,75600
01SCS19E070014,ESH.AR-RB0030,00ARRB0164,34,1,130000,350000,2,0,175000,1,0,35000,175000,140000
01SCS19E070015,BSC.AR-RJ0029,00ARRJ0167,S,1,120000,315000,2,0,94500,1,0,44100,220500,176400
01SCS19E070016,ESH.AR-SE0001,00ARSE0003,L,1,44000,135000,2,0,40500,1,0,18900,94500,75600
01SCS19E070017,AR.PUB-SC015,20ARSC0361,M,1,97500,150000,2,0,30000,1,0,30000,120000,90000
01SCS19E070018,BSC.AR-RE0002,00ARRE0043,L,1,42000,135000,2,0,67500,1,0,13500,67500,54000
01SCS19E070018,ESH.AR-RF0012,00ARRF0067,L,1,43000,135000,2,0,67500,1,0,13500,67500,54000
01SCS19E070019,BSC.AR-RH0025,00ARRH0161,L,1,115000,350000,2,0,105000,1,0,49000,245000,196000
01SCS19E070019,ESH.AR-QI0003,00ARQI0036,ALL,1,40000,140000,2,0,90000,1,0,10000,50000,40000
01SCS19E070020,BSC.AR-SB0003,00ARSB0043,S,1,125000,315000,2,0,94500,1,0,44100,220500,176400
01SCS19E070021,AR.PUB-SA009,20ARSA0331,L,1,224250,345000,2,0,69000,1,0,69000,276000,207000
01SCS19E070022,BSC.AR-RE0002,00ARRE0042,M,1,42000,135000,2,0,67500,1,0,13500,67500,54000
01SCS19E070022,BSC.AR-SA0018,00ARSA0060,M,1,44000,135000,2,0,40500,1,0,18900,94500,75600
01SCS19E070022,BSC.AR-SD0007,00ARSD0026,M,1,44500,159000,2,0,47700,1,0,22260,111300,89040
01SCS19E070022,ESH.AR-RE0009,00ARRE0034,M,1,42000,135000,2,0,67500,1,0,13500,67500,54000
01SCS19E070023,BSC.AR-SA0004,00ARSA0018,S,1,125000,315000,2,0,94500,1,0,44100,220500,176400
01SCS19E070024,AR.SMD-SD006,20ARSD0296,S,1,87750,135000,2,0,27000,1,0,27000,108000,81000
01SCS19E070025,AR.BPH-RB008,20ARRB0454,M,1,103350,159000,2,0,47700,1,0,27825,111300,83475
01SCS19E070025,AR.MKV-SA006,20ARSA0196,30,1,243750,375000,2,0,75000,1,0,75000,300000,225000
01SCS19E070026,AR.PUB-SE019,20ARSE0073,S,1,159250,245000,2,0,49000,1,0,49000,196000,147000
01SCS19E070027,AR.MDS-RE011,20ARRE0670,M,1,234000,360000,2,0,72000,1,0,72000,288000,216000
01SCS19E070027,ESH.AR-RD0001,00ARRD0020,32,1,110000,350000,2,0,175000,1,0,35000,175000,140000
01SCS19E070028,BSC.AR-QH0001,00ARQH0005,ALL,1,37800,140000,2,0,90000,1,0,10000,50000,40000
01SCS19E070029,AR.ESB-RK002,20ARRK0229,L,1,198250,305000,2,0,61000,1,0,61000,244000,183000
01SCS19E070029,AR.MKV-QB034,20ARQB0425,XL,1,165750,255000,2,0,127500,1,0,31875,127500,95625
01SCS19E070030,ESH.AR-QE0004,00ARQE0023,ALL,1,39800,140000,2,0,90000,1,0,10000,50000,40000
01SCS19E070031,ESH.AR-QL0004,00ARQL0018,S,1,42000,135000,2,0,67500,1,0,13500,67500,54000
01SCS19E070031,ESH.AR-RE0020,00ARRE0208,S,1,42000,135000,2,0,67500,1,0,13500,67500,54000
01SCS19E070032,AR.CLK-RE010,20ARRE0919,ALL,1,84500,130000,2,0,26000,1,0,26000,104000,78000
01SCS19E070033,ESH.AR-PL0032,00ARPL0231,ALL,1,39800,140000,2,0,90000,1,0,10000,50000,40000
01SCS19E070034,AR.MKV-SC003,20ARSC0077,ALL,1,87750,135000,2,0,27000,1,0,27000,108000,81000
01SCS19E070035,BSC.AR-RH0018,00ARRH0079,M,1,120000,315000,2,0,94500,1,0,44100,220500,176400
01SCS19E070035,BSC.AR-RK0016,00ARRK0110,M,1,43000,135000,2,0,40500,1,0,18900,94500,75600
01SCS19E070036,BSC.AR-QG0008,00ARQG0094,ALL,1,80000,225000,2,0,125000,1,0,20000,100000,80000
01SCS19E070036,BSC.AR-RH0020,00ARRH0115,S,1,52000,155000,2,0,46500,1,0,21700,108500,86800
01SCS19E070036,BSC.AR-SD0053,00ARSD0283,S,1,44000,159000,2,0,47700,1,0,22260,111300,89040
01SCS19E070036,BSC.AR-SD0062,00ARSD0337,NON,1,45000,150000,2,0,45000,1,0,21000,105000,84000
01SCS19E070036,ESH.AR-QG0007,00ARQG0098,ALL,1,70000,205000,2,0,105000,1,0,20000,100000,80000
01SCS19E070037,ESH.AR-RD0001,00ARRD0020,32,1,110000,350000,2,0,175000,1,0,35000,175000,140000
01SCS19E070037,ESH.AR-RD0001,00ARRD0021,34,1,110000,350000,2,0,175000,1,0,35000,175000,140000
01SCS19E070037,ESH.AR-SA0001,00ARSA0015,32,1,122500,175000,2,0,52500,1,0,24500,122500,98000
01SCS19E070038,BSC.AR-PI0075,00ARPI0202,M,1,98334,295000,2,0,135000,1,0,32000,160000,128000
01SCS19E070039,AR.MYA-SC001,20ARSC0037,S,1,220350,339000,2,0,101700,1,0,59325,237300,177975
01SCS19E070040,AR.MKV-RC024,20ARRC0596,ALL,1,78000,120000,2,0,24000,1,0,24000,96000,72000
01SCS19E070041,AR.CPT-SC011,20ARSC0476,M,1,204750,315000,2,0,63000,1,0,63000,252000,189000
01SCS19E070041,BSC.AR-RK0015,00ARRK0106,M,1,43000,135000,2,0,40500,1,0,18900,94500,75600
01SCS19E070041,BSC.AR-SC0044,00ARSC0296,NON,1,45000,150000,2,0,45000,1,0,21000,105000,84000
01SCS19E070041,ESH.AR-RD0018,00ARRD0185,NON,1,55000,150000,2,0,100000,1,0,10000,50000,40000
01SCS19E070042,AR.CPT-SD008,20ARSD0443,L,1,204750,315000,2,0,63000,1,0,63000,252000,189000
01SCS19E070043,ESH.AR-RC0047,00ARRC0276,M,1,42000,135000,2,0,67500,1,0,13500,67500,54000
01SCS19E070043,ESH.AR-RD0031,00ARRD0256,M,1,43000,135000,2,0,67500,1,0,13500,67500,54000
01SCS19E070044,AR.YAS-RL005,20ARRL0222,S,1,252850,389000,2,0,77800,1,0,77800,311200,233400
01SCS19E070044,BSC.AR-SC0015,00ARSC0100,S,1,44000,159000,2,0,47700,1,0,22260,111300,89040
01SCS19E070045,BSC.AR-SA0009,00ARSA0035,NON,1,47500,140000,2,0,42000,1,0,19600,98000,78400
01SCS19E070046,ESH.AR-SD0022,00ARSD0168,NON,1,43000,120000,2,0,36000,1,0,16800,84000,67200
01SCS19E070047,BSC.AR-RE0018,00ARRE0118,NON,1,36837,115000,2,0,15000,1,0,20000,100000,80000
01SCS19E070047,ESH.AR-RK0009,00ARRK0037,S,1,44500,135000,2,0,40500,1,0,18900,94500,75600
01SCS19E070048,AR.CPT-RI007,20ARRI0067,XL,1,94250,145000,2,0,29000,1,0,29000,116000,87000
01SCS19E070048,ESH.AR-RG0004,00ARRG0013,XL,1,90000,255000,2,0,76500,1,0,35700,178500,142800
01SCS19E070049,ESH.AR-SB0028,00ARSB0172,M,1,44000,135000,2,0,40500,1,0,18900,94500,75600
01SCS19E070049,ESH.AR-SD0038,00ARSD0344,M,1,122500,350000,2,0,105000,1,0,49000,245000,196000
01SCS19E070050,AR.STY-RK005,20ARRK0527,ALL,1,61750,95000,2,0,19000,1,0,19000,76000,57000
01SCS19E070051,AR.SMD-RL002,20ARRL0266,ALL,1,22750,35000,2,0,7000,1,0,7000,28000,21000
01SCS19E070051,BSC.AR-RE0002,00ARRE0042,M,1,42000,135000,2,0,67500,1,0,13500,67500,54000
01SCS19E070051,ESH.AR-QL0004,00ARQL0019,M,1,42000,135000,2,0,67500,1,0,13500,67500,54000
01SCS19E070052,ARN.AR-RK0003,00ARRK0227,M,1,120000,315000,2,0,63000,1,0,75600,252000,176400
01SCS19E070052,BSC.AR-RH0026,00ARRH0165,32,1,245000,350000,2,0,105000,1,0,49000,245000,196000
01SCS19E070053,AR.MKV-RC019,20ARRC0461,S,1,312000,480000,2,0,240000,1,0,60000,240000,180000
01SCS19E070054,AR.REC-SD028,20ARSD0075,ALL,1,32500,50000,2,0,15000,1,0,8750,35000,26250
01SCS19E070055,BSC.AR-RI0018,00ARRI0067,M,1,94500,135000,2,0,40500,1,0,18900,94500,75600
01SCS19E070055,BSC.AR-RK0002,00ARRK0055,L,1,94500,135000,2,0,40500,1,0,18900,94500,75600
01SCS19E070056,AR.PUB-RG026,20ARRG0130,S,1,97500,150000,2,0,30000,1,0,30000,120000,90000
01SCS19E070057,BSC.AR-RL0018,00ARRL0110,M,1,125000,315000,2,0,94500,1,0,44100,220500,176400
01SCS19E070057,ESH.AR-RC0011,00ARRC0110,S,1,180000,499000,2,0,324000,1,0,35000,175000,140000
01SCS19E070058,BSC.AR-SD0058,00ARSD0294,NON,1,50000,150000,2,0,45000,1,0,21000,105000,84000
01SCS19E070059,BSC.AR-RL0001,00ARRL0004,XL,1,220500,315000,2,0,94500,1,0,44100,220500,176400
01SCS19E070059,BSC.AR-SD0012,00ARSD0105,NON,1,18000,75000,2,0,22500,1,0,10500,52500,42000
01SCS19E070060,ESH.AR-SD0006,00ARSD0055,L,1,44500,135000,2,0,40500,1,0,18900,94500,75600
01SCS19E070060,ESH.AR-SD0010,00ARSD0071,L,1,44500,135000,2,0,40500,1,0,18900,94500,75600
01SCS19E070061,ESH.AR-RB0017,00ARRB0115,S,1,450000,135000,2,0,67500,1,0,13500,67500,54000
01SCS19E070061,ESH.AR-RD0031,00ARRD0257,L,1,43000,135000,2,0,67500,1,0,13500,67500,54000
01SCS19E070062,AR.CPT-RE010,20ARRE0708,XL,1,204750,315000,2,0,63000,1,0,63000,252000,189000
01SCS19E070062,AR.REC-SD018,20ARSD0056,ALL,1,107250,165000,2,0,49500,1,0,28875,115500,86625
01SCS19E070062,AR.TUC-SD024,20ARSD0514,M,1,204750,315000,2,0,63000,1,0,63000,252000,189000
01SCS19E070062,BSC.AR-RC0039,00ARRC0287,S,1,155000,450000,2,0,275000,1,0,35000,175000,140000
01SCS19E070063,BSC.AR-RL0018,00ARRL0110,M,1,125000,315000,2,0,94500,1,0,44100,220500,176400
01SCS19E070064,AR.TUC-SB018,20ARSB0479,L,1,87750,135000,2,0,27000,1,0,27000,108000,81000
01SCS19E070065,AR.TRF-RJ007,20ARRJ0082,XL,1,97500,150000,2,0,45000,1,0,26250,105000,78750
01SCS19E070065,ESH.AR-QK0011,00ARQK0070,36,1,130000,375000,2,0,200000,1,0,35000,175000,140000
01SCS19E070065,ESH.AR-RI0018,00ARRI0146,NON,1,39000,140000,2,0,42000,1,0,19600,98000,78400
01SCS19E070066,AR.TUC-SD012,20ARSD0466,M,1,94250,145000,2,0,29000,1,0,29000,116000,87000
01SCS19E070067,AR.CPT-SB003,20ARSB0505,M,1,94250,145000,2,0,29000,1,0,29000,116000,87000
01SCS19E070068,BSC.AR-RH0004,00ARRH0019,L,1,42000,135000,2,0,40500,1,0,18900,94500,75600
01SCS19E070068,BSC.AR-SC0013,00ARSC0094,L,1,44000,135000,2,0,40500,1,0,18900,94500,75600
01SCS19E070069,AR.BPH-RH008,20ARRH0357,M,1,214500,330000,2,0,165000,1,0,41250,165000,123750
01SCS19E070070,ESH.AR-RD0001,00ARRD0018,28,1,110000,350000,2,0,175000,1,0,35000,175000,140000
01SCS19E070070,ESH.AR-RD0003,00ARRD0050,30,1,110000,350000,2,0,175000,1,0,35000,175000,140000
01SCS19E070071,AR.PUB-RL004,20ARRL0119,S,1,97500,150000,2,0,30000,1,0,30000,120000,90000
01SCS19E070072,BSC.AR-PI0075,00ARPI0203,L,1,98334,295000,2,0,135000,1,0,32000,160000,128000
01SCS19E070073,BSC.AR-PI0018,00ARPI0018,ALL,1,58334,175000,2,0,75000,1,0,20000,100000,80000
01SCS19E070074,BSC.AR-SA0002,00ARSA0005,S,1,120000,315000,2,0,94500,1,0,44100,220500,176400
01SCS19E070074,ESH.AR-SA0008,00ARSA0085,L,1,113450,350000,2,0,105000,1,0,49000,245000,196000
01SCS19E070075,AR.PCT-RK002,20ARRK0250,ALL,1,97500,150000,2,0,30000,1,0,30000,120000,90000
01SCS19E070075,BSC.AR-RH0026,00ARRH0165,32,1,245000,350000,2,0,105000,1,0,49000,245000,196000
01SCS19E070076,AR.TUC-SB020,20ARSB0484,ALL,1,87750,135000,2,0,27000,1,0,27000,108000,81000
01SCS19E070076,ESH.AR-SD0040,00ARSD0367,M,1,122500,350000,2,0,105000,1,0,49000,245000,196000
01SCS19E070077,ESH.AR-QE0002,00ARQE0021,ALL,1,50000,140000,2,0,90000,1,0,10000,50000,40000
01SCS19E070077,ESH.AR-RC0002,00ARRC0005,S,1,85000,240000,2,0,115000,1,0,25000,125000,100000
01SCS19E070078,ESH.AR-SE0001,00ARSE0002,M,1,44000,135000,2,0,40500,1,0,18900,94500,75600
01SCS19E070079,AR.CPT-RL004,20ARRL0083,M,1,94250,145000,2,0,29000,1,0,29000,116000,87000
01SCS19E070080,ESH.AR-RH0008,00ARRH0060,NON,1,45000,150000,2,0,45000,1,0,21000,105000,84000
01SCS19E070081,AR.TUC-SB022,20ARSB0486,ALL,1,87750,135000,2,0,27000,1,0,27000,108000,81000
01SCS19E070081,BE.RAK-SA019,00BESA0073,L,1,91000,140000,2,0,28000,1,0,28000,112000,84000
01SCS19E070082,BSC.AR-RL0020,00ARRL0117,S,1,125000,315000,2,0,94500,1,0,44100,220500,176400
01SCS19E070082,ESH.AR-RC0024,00ARRC0181,L,1,42000,135000,2,0,67500,1,0,13500,67500,54000
01SCS19E070082,ESH.AR-RE0009,00ARRE0033,S,1,42000,135000,2,0,67500,1,0,13500,67500,54000
01SCS19E070083,AR.GTW-SA002,20ARSA0300,M,1,107250,165000,2,0,49500,1,0,28875,115500,86625
01SCS19E070083,AR.TUC-SB002,20ARSB0029,L,1,204750,315000,2,0,63000,1,0,63000,252000,189000
01SCS19E070084,AR.MPR-SB001,20ARSD0278,XXL,1,230750,355000,2,0,71000,1,0,71000,284000,213000
01SCS19E070084,ESH.AR-RG0003,00ARRG0008,L,1,90000,255000,2,0,76500,1,0,35700,178500,142800
01SCS19E070085,ESH.AR-RF0012,00ARRF0066,M,1,43000,135000,2,0,67500,1,0,13500,67500,54000
01SCS19E070085,ESH.AR-RF0019,00ARRF0135,M,1,42000,135000,2,0,67500,1,0,13500,67500,54000
01SCS19E070086,BSC.AR-RE0002,00ARRE0043,L,1,42000,135000,2,0,67500,1,0,13500,67500,54000
01SCS19E070086,ESH.AR-RB0017,00ARRB0116,M,1,450000,135000,2,0,67500,1,0,13500,67500,54000
01SCS19E070087,AR.PUB-SD004,20ARSD0090,ALL,1,97500,150000,2,0,30000,1,0,30000,120000,90000
01SCS19E070087,BSC.AR-PI0075,00ARPI0203,L,1,98334,295000,2,0,135000,1,0,32000,160000,128000
01SCS19E070088,BSC.AR-SA0004,00ARSA0018,S,1,125000,315000,2,0,94500,1,0,44100,220500,176400
01SCS19E070089,AR.PUB-SB032,20ARSB0462,L,1,204750,315000,2,0,63000,1,0,63000,252000,189000
01SCS19E070089,AR.PUB-SD017,20ARSD0134,M,1,204750,315000,2,0,63000,1,0,63000,252000,189000
01SCS19E070089,BSC.AR-RE0002,00ARRE0043,L,1,42000,135000,2,0,67500,1,0,13500,67500,54000
01SCS19E070089,ESH.AR-RF0012,00ARRF0067,L,1,43000,135000,2,0,67500,1,0,13500,67500,54000
01SCS19E070090,BSC.AR-RJ0021,00ARRJ0119,S,1,43000,135000,2,0,40500,1,0,18900,94500,75600
01SCS19E070090,BSC.AR-RL0026,00ARRL0171,M,1,94500,135000,2,0,40500,1,0,18900,94500,75600
01SCS19E070091,AR.MKV-QE005,20ARQE0162,30,1,234000,360000,2,0,180000,1,0,45000,180000,135000
01SCS19E070092,BSC.AR-SC0029,00ARSC0199,S,1,125000,315000,2,0,94500,1,0,44100,220500,176400
01SCS19E070093,AR.PUB-SD012,20ARSD0122,ALL,1,97500,150000,2,0,30000,1,0,30000,120000,90000
01SCS19E070094,ESH.AR-SB0033,00ARSB0213,M,1,44500,135000,2,0,40500,1,0,18900,94500,75600
01SCS19E070095,AR.MYA-RK002,20ARRK0006,32,1,220350,339000,2,0,101700,1,0,59325,237300,177975
01SCS19E070095,BSC.AR-RE0014,00ARRE0107,NON,1,35000,120000,2,0,36000,1,0,16800,84000,67200
01SCS19E070096,ESH.AR-RC0011,00ARRC0111,M,2,180000,499000,2,0,324000,1,0,35000,350000,280000
01SCS19E070097,ESH.AR-RC0047,00ARRC0276,M,1,42000,135000,2,0,67500,1,0,13500,67500,54000
01SCS19E070097,ESH.AR-RE0005,00ARRE0018,M,1,42000,135000,2,0,67500,1,0,13500,67500,54000
01SCS19E070098,BSC.AR-RE0018,00ARRE0118,NON,1,36837,115000,2,0,15000,1,0,20000,100000,80000
01SCS19E070098,ESH.AR-QH0026,00ARQH0137,ALL,1,39700,140000,2,0,90000,1,0,10000,50000,40000
01SCS19E070099,ESH.AR-RC0035,00ARRC0206,S,1,42000,135000,2,0,67500,1,0,13500,67500,54000
01SCS19E070099,ESH.AR-RF0012,00ARRF0065,S,1,43000,135000,2,0,67500,1,0,13500,67500,54000
01SCS19E070100,ESH.AR-QK0001,00ARQK0002,M,1,90000,310000,2,0,150000,1,0,32000,160000,128000
01SCS19E070101,AR.STY-RK003,20ARRK0525,ALL,1,61750,95000,2,0,19000,1,0,19000,76000,57000
01SCS19E070101,ESH.AR-RL0018,00ARRL0146,30,1,122500,175000,2,0,52500,1,0,24500,122500,98000
01SCS19E070101,ESH.AR-SB0032,00ARSB0209,M,1,125000,315000,2,0,94500,1,0,44100,220500,176400
01SCS19E070102,BSC.AR-RI0017,00ARRI0064,L,1,43000,135000,2,0,40500,1,0,18900,94500,75600
01SCS19E070102,BSC.AR-SA0002,00ARSA0007,L,1,120000,315000,2,0,94500,1,0,44100,220500,176400
01SCS19E070103,BSC.AR-SA0005,00ARSA0024,L,1,94500,135000,2,0,40500,1,0,18900,94500,75600
01SCS19E070103,ESH.AR-SC0005,00ARSC0028,L,1,125000,315000,2,0,94500,1,0,44100,220500,176400
01SCS19E070103,ESH.AR-SC0028,00ARSC0267,L,1,44500,135000,2,0,40500,1,0,18900,94500,75600
01SCS19E070104,BSC.AR-RE0001,00ARRE0037,S,1,42000,135000,2,0,67500,1,0,13500,67500,54000
01SCS19E070104,ESH.AR-RF0012,00ARRF0065,S,1,43000,135000,2,0,67500,1,0,13500,67500,54000
01SCS19E070105,AR.SMD-SD003,20ARSD0285,M,1,97500,150000,2,0,45000,1,0,26250,105000,78750
01SCS19E070105,ESH.AR-RD0035,00ARRD0271,M,1,43000,135000,2,0,67500,1,0,13500,67500,54000
01SCS19E070105,ESH.AR-RE0005,00ARRE0018,M,1,42000,135000,2,0,67500,1,0,13500,67500,54000
01SCS19E070106,BSC.AR-SD0012,00ARSD0105,NON,1,18000,75000,2,0,22500,1,0,10500,52500,42000
01SCS19E070106,ESH.AR-RB0007,00ARRB0050,32,1,90000,265000,2,0,90000,1,0,35000,175000,140000
01SCS19E070107,BSC.AR-RL0020,00ARRL0118,M,1,125000,315000,2,0,94500,1,0,44100,220500,176400
01SCS19E070108,AR.YD-SD001,20ARSD0263,L,1,87750,135000,2,0,67500,1,0,16875,67500,50625
01SCS19E070109,AR.PUB-RK001,20ARRK0067,L,1,97500,150000,2,0,30000,1,0,30000,120000,90000
01SCS19E070110,BSC.AR-SC0040,00ARSC0258,M,1,52000,155000,2,0,46500,1,0,21700,108500,86800
01SCS19E070111,AR.SMD-SD005,20ARSD0292,S,1,87750,135000,2,0,27000,1,0,27000,108000,81000
01SCS19E070112,ESH.AR-QE0008,00ARQE0027,ALL,1,39800,140000,2,0,90000,1,0,10000,50000,40000
01SCS19E070113,AR.MKV-RJ028,20ARRJ0228,34,1,214500,330000,2,0,66000,1,0,66000,264000,198000
01SCS19E070114,ESH.AR-RB0006,00ARRB0045,32,1,90000,265000,2,0,90000,1,0,35000,175000,140000
01SCS19E070114,ESH.AR-RC0011,00ARRC0111,M,1,180000,499000,2,0,324000,1,0,35000,175000,140000
01SCS19E070115,ESH.AR-SC0001,00ARSC0001,S,1,125000,315000,2,0,94500,1,0,44100,220500,176400
01SCS19E070116,AR.ESB-RK002,20ARRK0229,L,1,198250,305000,2,0,61000,1,0,61000,244000,183000
01SCS19E070117,ESH.AR-PK0040,00ARPK0186,S,1,110000,325000,2,0,165000,1,0,32000,160000,128000
01SCS19E070118,AR.SLS-SE007,20ARSE0134,XL,1,425000,500000,0,0,0,0,0,75000,500000,425000
01SCS19E070119,BSC.AR-RC0024,00ARRC0165,ALL,1,43000,185000,2,0,85000,1,0,20000,100000,80000
01SCS19E070120,ESH.AR-SD0023,00ARSD0169,NON,1,43000,120000,2,0,36000,1,0,16800,84000,67200
01SCS19E070121,ESH.AR-SB0034,00ARSB0218,L,1,125000,315000,2,0,94500,1,0,44100,220500,176400
01SCS19E070122,AR.ESB-RK010,20ARRK0365,S,1,87750,135000,2,0,27000,1,0,27000,108000,81000
01SCS19E070123,BSC.AR-RI0024,00ARRI0133,NON,1,43000,140000,2,0,42000,1,0,19600,98000,78400
01SCS19E070123,ESH.AR-SB0032,00ARSB0209,M,1,125000,315000,2,0,94500,1,0,44100,220500,176400
01SCS19E070124,ESH.AR-RB0021,00ARRB0131,S,1,95000,310000,2,0,150000,1,0,32000,160000,128000
01SCS19E070124,ESH.AR-RC0005,00ARRC0066,M,1,95000,310000,2,0,150000,1,0,32000,160000,128000
01SCS19E070125,ESH.AR-SD0004,00ARSD0045,S,1,44500,135000,2,0,40500,1,0,18900,94500,75600
01SCS19E070126,AR.PUB-SD030,20ARSD0210,32,1,211250,325000,2,0,65000,1,0,65000,260000,195000
01SCS19E070126,ARN.AR-SB0001,00ARSB0086,NON,1,107400,179000,2,0,35800,1,0,42960,143200,100240
01SCS19E070127,ESH.AR-QG0007,00ARQG0098,ALL,1,70000,205000,2,0,105000,1,0,20000,100000,80000
01SCS19E070128,BSC.AR-SC0001,00ARSC0013,S,1,125000,315000,2,0,94500,1,0,44100,220500,176400
01SCS19E070129,AR.HMR-SB024,20ARSB0409,28,1,211250,325000,2,0,65000,1,0,65000,260000,195000
01SCS19E070130,AR.HMR-SB024,20ARSB0410,30,1,211250,325000,2,0,65000,1,0,65000,260000,195000
01SCS19E070130,ESH.AR-SC0027,00ARSC0262,M,1,125000,315000,2,0,94500,1,0,44100,220500,176400
01SCS19E070131,ESH.AR-SC0027,00ARSC0263,L,1,125000,315000,2,0,94500,1,0,44100,220500,176400
01SCS19E070132,AR.YD-RL017,20ARRL0047,M,1,91000,140000,2,0,70000,1,0,17500,70000,52500
01SCS19E070132,AR.YD-SD001,20ARSD0262,M,1,87750,135000,2,0,67500,1,0,16875,67500,50625
01SCS19E070133,ESH.AR-RE0025,00ARRE0260,30,1,120000,350000,2,0,175000,1,0,35000,175000,140000
01SCS19E070134,AR.MPR-SB005,20ARSB0252,L,1,230750,355000,2,0,71000,1,0,71000,284000,213000
01SCS19E070134,BSC.AR-SD0016,00ARSD0118,S,1,122000,375000,2,0,112500,1,0,52500,262500,210000
01SCS19E070135,AR.PUB-SB033,20ARSB0464,ALL,1,97500,150000,2,0,30000,1,0,30000,120000,90000
01SCS19E070136,BSC.AR-SE0001,00ARSE0057,S,1,44500,159000,2,0,47700,1,0,22260,111300,89040
01SCS19E070136,ESH.AR-SD0022,00ARSD0168,NON,1,43000,120000,2,0,36000,1,0,16800,84000,67200
01SCS19E070137,AR.HMR-SB024,20ARSB0409,28,1,211250,325000,2,0,65000,1,0,65000,260000,195000
01SCS19E070138,ESH.AR-RE0009,00ARRE0035,L,1,42000,135000,2,0,67500,1,0,13500,67500,54000
01SCS19E070138,ESH.AR-RE0020,00ARRE0210,L,1,42000,135000,2,0,67500,1,0,13500,67500,54000
01SCS19E070139,AR.CPT-RI004,20ARRI0053,M,1,94250,145000,2,0,29000,1,0,29000,116000,87000
01SCS19E070139,AR.PUB-SB025,20ARSB0133,M,1,97500,150000,2,0,30000,1,0,30000,120000,90000
01SCS19E070139,AR.PUB-SD007,20ARSD0093,ALL,1,97500,150000,2,0,30000,1,0,30000,120000,90000
01SCS19E070139,AR.SMD-RH007,20ARRH0751,M,1,87750,135000,2,0,40500,1,0,23625,94500,70875
01SCS19E070139,AR.SMD-SD018,20ARSD0580,ALL,1,97500,150000,2,0,30000,1,0,30000,120000,90000
01SCS19E070139,BE.RAK-SC044,00BESC0192,ALL,1,120250,185000,2,0,37000,1,0,37000,148000,111000
01SCS19E070139,BSC.AR-RC0025,00ARRC0166,ALL,1,43000,185000,2,0,85000,1,0,20000,100000,80000
01SCS19E070140,AR.STY-SE004,20ARSE0122,ALL,1,55250,85000,2,0,17000,1,0,17000,68000,51000
01SCS19E070140,AR.STY-SE008,20ARSE0126,ALL,1,55250,85000,2,0,17000,1,0,17000,68000,51000
01SCS19E070141,AR.STY-RK007,20ARRK0529,ALL,1,61750,95000,2,0,19000,1,0,19000,76000,57000
01SCS19E070141,ESH.AR-SB0019,00ARSB0114,NON,1,41000,120000,2,0,36000,1,0,16800,84000,67200
01SCS19E070142,AR.MKV-RC001,20ARRC0204,L,1,214500,330000,2,0,66000,1,0,66000,264000,198000
01SCS19E070143,BSC.AR-QG0008,00ARQG0094,ALL,1,80000,225000,2,0,125000,1,0,20000,100000,80000
01SCS19E070143,ESH.AR-RD0001,00ARRD0018,28,1,110000,350000,2,0,175000,1,0,35000,175000,140000
01SCS19E070144,AR.TUC-SD024,20ARSD0515,L,1,204750,315000,2,0,63000,1,0,63000,252000,189000
01SCS19E070145,BSC.AR-RD0001,00ARRD0002,M,1,155,450000,2,0,275000,1,0,35000,175000,140000
01SCS19E070146,BSC.AR-SD0055,00ARSD0288,NON,1,50000,150000,2,0,45000,1,0,21000,105000,84000
01SCS19E070147,BSC.AR-QH0002,00ARQH0006,ALL,1,37800,140000,2,0,90000,1,0,10000,50000,40000
01SCS19E080001,ESH.AR-SD0019,00ARSD0140,S,1,125000,315000,2,0,94500,1,0,44100,220500,176400
01SCS19E080002,BSC.AR-RE0001,00ARRE0037,S,1,42000,135000,2,0,67500,1,0,13500,67500,54000
01SCS19E080002,ESH.AR-RE0005,00ARRE0018,M,1,42000,135000,2,0,67500,1,0,13500,67500,54000
01SCS19E080002,ESH.AR-SC0027,00ARSC0261,S,1,125000,315000,2,0,94500,1,0,44100,220500,176400
01SCS19E080003,ESH.AR-SC0003,00ARSC0009,S,1,125000,350000,2,0,105000,1,0,49000,245000,196000
01SCS19E080004,AR.ESB-SD006,20ARSD0117,M,1,204750,315000,2,0,63000,1,0,63000,252000,189000
01SCS19E080005,AR.ESB-SD006,20ARSD0117,M,1,204750,315000,2,0,63000,1,0,63000,252000,189000
01SCS19E080006,BSC.AR-RE0001,00ARRE0037,S,1,42000,135000,2,0,67500,1,0,13500,67500,54000
01SCS19E080006,ESH.AR-RC0047,00ARRC0275,S,1,42000,135000,2,0,67500,1,0,13500,67500,54000
01SCS19E080006,ESH.AR-SD0023,00ARSD0169,NON,1,43000,120000,2,0,36000,1,0,16800,84000,67200
01SCS19E080007,ESH.AR-RD0028,00ARRD0244,M,1,43000,135000,2,0,67500,1,0,13500,67500,54000
01SCS19E080007,ESH.AR-RD0035,00ARRD0270,S,1,43000,135000,2,0,67500,1,0,13500,67500,54000
01SCS19E080008,AR.STY-RK003,20ARRK0525,ALL,1,61750,95000,2,0,19000,1,0,19000,76000,57000
01SCS19E080008,ESH.AR-SD0023,00ARSD0169,NON,1,43000,120000,2,0,36000,1,0,16800,84000,67200
01SCS19E080009,AR.ESB-SA004,20ARSA0216,M,1,204750,315000,2,0,63000,1,0,63000,252000,189000
01SCS19E080010,AR.REC-SD022,20ARSD0065,S,1,224250,345000,2,0,103500,1,0,60375,241500,181125
01SCS19E080010,BSC.AR-SC0017,00ARSC0116,S,1,44500,135000,2,0,40500,1,0,18900,94500,75600
01SCS19E080011,AR.SMD-QD006,20ARQD0106,XL,1,84500,130000,2,0,39000,1,0,22750,91000,68250
01SCS19E080011,AR.TUC-RI008,20ARRI0356,L,1,87750,135000,2,0,27000,1,0,27000,108000,81000
01SCS19E080011,AR.TUC-SA035,20ARSA0267,ALL,1,87750,135000,2,0,27000,1,0,27000,108000,81000
01SCS19E080012,AR.SMD-SD018,20ARSD0580,ALL,1,97500,150000,2,0,30000,1,0,30000,120000,90000
01SCS19E080012,BSC.AR-RD0001,00ARRD0001,S,1,155,450000,2,0,275000,1,0,35000,175000,140000
01SCS19E080013,BSC.AR-SD0029,00ARSD0171,M,1,44500,159000,2,0,47700,1,0,22260,111300,89040
01SCS19E080014,AR.ESB-SD015,20ARSD0335,L,1,91000,140000,2,0,28000,1,0,28000,112000,84000
01SCS19E080015,AR.TUC-RE032,20ARRE1165,L,1,87750,135000,2,0,67500,1,0,16875,67500,50625
01SCS19E080015,AR.VCS-SC001,20ARSC0374,M,1,97500,150000,2,0,45000,1,0,26250,105000,78750
01SCS19E080016,AR.TUC-RI009,20ARRI0360,L,1,87750,135000,2,0,27000,1,0,27000,108000,81000
01SCS19E080017,BSC.AR-SB0003,00ARSB0043,S,1,125000,315000,2,0,94500,1,0,44100,220500,176400
01SCS19E080018,AR.TUC-SB003,20ARSB0031,ALL,1,61750,95000,2,0,19000,1,0,19000,76000,57000
01SCS19E080018,ESH.AR-RE0005,00ARRE0018,M,1,42000,135000,2,0,67500,1,0,13500,67500,54000
01SCS19E080018,ESH.AR-RE0009,00ARRE0034,M,1,42000,135000,2,0,67500,1,0,13500,67500,54000
01SCS19E080019,ESH.AR-SC0002,00ARSC0005,S,1,44500,135000,2,0,40500,1,0,18900,94500,75600
01SCS19E080020,AR.SMD-RE007,20ARRE0785,L,1,87750,135000,2,0,40500,1,0,23625,94500,70875
01SCS19E080020,AR.STY-RK003,20ARRK0525,ALL,1,61750,95000,2,0,19000,1,0,19000,76000,57000
01SCS19E080020,AR.STY-SA003,20ARSA0062,ALL,1,61750,95000,2,0,19000,1,0,19000,76000,57000
01SCS19E080020,BSC.AR-SC0013,00ARSC0093,M,1,44000,135000,2,0,40500,1,0,18900,94500,75600
01SCS19E080021,AR.ESB-RE036,20ARRE0795,M,1,65000,100000,2,0,50000,1,0,12500,50000,37500
01SCS19E080022,ESH.AR-SC0028,00ARSC0266,M,1,44500,135000,2,0,40500,1,0,18900,94500,75600
01SCS19E080023,AR.ESB-SA003,20ARSA0212,M,1,204750,315000,2,0,63000,1,0,63000,252000,189000
01SCS19E080023,ESH.AR-QK0011,00ARQK0069,34,1,130000,375000,2,0,200000,1,0,35000,175000,140000
01SCS19E080024,ESH.AR-RJ0022,00ARRJ0217,NON,1,18000,75000,2,0,22500,1,0,10500,52500,42000
01SCS19E080025,BSC.AR-SC0010,00ARSC0058,L,1,125000,315000,2,0,94500,1,0,44100,220500,176400
01SCS19E080026,AR.SMD-RL003,20ARRL0267,ALL,1,22750,35000,2,0,7000,1,0,7000,28000,21000
01SCS19E080027,AR.REC-SD022,20ARSD0067,L,1,224250,345000,2,0,103500,1,0,60375,241500,181125
01SCS19E080027,ESH.AR-RC0035,00ARRC0208,L,1,42000,135000,2,0,67500,1,0,13500,67500,54000
01SCS19E080027,ESH.AR-RF0012,00ARRF0066,M,1,43000,135000,2,0,67500,1,0,13500,67500,54000
01SCS19E080027,ESH.AR-SD0009,00ARSD0068,XL,1,44500,135000,2,0,40500,1,0,18900,94500,75600
01SCS19E080028,ESH.AR-RE0025,00ARRE0261,32,1,120000,350000,2,0,175000,1,0,35000,175000,140000
01SCS19E080029,ESH.AR-SD0021,00ARSD0164,S,1,125000,315000,2,0,94500,1,0,44100,220500,176400
01SCS19E080030,AR.ESB-RL002,20ARRL0008,XL,1,97500,150000,2,0,30000,1,0,30000,120000,90000
01SCS19E080031,DKS.AR-SE0011,00ARSE0172,32,1,417272,696000,2,0,69600,1,0,93960,626400,532440
01SCS19E080032,ESH.AR-QL0004,00ARQL0019,M,1,42000,135000,2,0,67500,1,0,13500,67500,54000
01SCS19E080032,ESH.AR-RD0035,00ARRD0271,M,1,43000,135000,2,0,67500,1,0,13500,67500,54000
01SCS19E080033,BSC.AR-RE0001,00ARRE0038,M,1,42000,135000,2,0,67500,1,0,13500,67500,54000
01SCS19E080033,ESH.AR-RD0031,00ARRD0257,L,1,43000,135000,2,0,67500,1,0,13500,67500,54000
01SCS19E080034,ESH.AR-SC0001,00ARSC0003,L,1,125000,315000,2,0,94500,1,0,44100,220500,176400
01SCS19E080035,BSC.AR-SC0009,00ARSC0053,M,1,125000,315000,2,0,94500,1,0,44100,220500,176400
01SCS19E080035,ESH.AR-RJ0001,00ARRJ0012,M,1,44500,135000,2,0,40500,1,0,18900,94500,75600
01SCS19E080035,ESH.AR-SB0027,00ARSB0160,M,1,44000,135000,2,0,40500,1,0,18900,94500,75600
01SCS19E080036,AR.FHL-SC008,20ARSC0351,ALL,1,110500,170000,2,0,34000,1,0,34000,136000,102000
01SCS19E080036,AR.MKV-SB009,20ARSB0533,L,1,97500,150000,2,0,30000,1,0,30000,120000,90000
01SCS19E080037,AR.MPR-SB016,20ARSB0295,M,1,230750,355000,2,0,71000,1,0,71000,284000,213000
01SCS19E080038,AR.ESB-SB003,20ARSB0102,L,1,100750,155000,2,0,31000,1,0,31000,124000,93000
01SCS19E080038,AR.YAS-RH009,20ARRH0861,M,1,122850,189000,2,0,37800,1,0,37800,151200,113400
01SCS19E080039,BSC.AR-RJ0014,00ARRJ0091,S,1,43000,135000,2,0,40500,1,0,18900,94500,75600
01SCS19E080039,BSC.AR-SD0042,00ARSD0227,S,1,44500,159000,2,0,47700,1,0,22260,111300,89040
01SCS19E080040,AR.MPR-SB001,20ARSB0236,L,1,230750,355000,2,0,71000,1,0,71000,284000,213000
01SCS19E080041,BSC.AR-RC0024,00ARRC0165,ALL,1,43000,185000,2,0,85000,1,0,20000,100000,80000
01SCS19E080041,BSC.AR-SC0021,00ARSC0148,NON,1,73000,220000,2,0,66000,1,0,30800,154000,123200
01SCS19E080042,ESH.AR-SB0031,00ARSB0204,S,1,44500,135000,2,0,40500,1,0,18900,94500,75600
01SCS19E080043,AR.MPR-SB014,20ARSB0289,XL,1,97500,150000,2,0,45000,1,0,26250,105000,78750
01SCS19E080043,ESH.AR-RD0009,00ARRD0056,NON,1,37500,115000,2,0,34500,1,0,16100,80500,64400
01SCS19E080043,ESH.AR-RH0016,00ARRH0093,L,1,94500,135000,2,0,40500,1,0,18900,94500,75600
01SCS19E080043,ESH.AR-SD0036,00ARSD0334,NON,1,50000,150000,2,0,45000,1,0,21000,105000,84000
01SCS19E080044,ESH.AR-PK0040,00ARPK0188,L,1,110000,325000,2,0,165000,1,0,32000,160000,128000
01SCS19E080045,BSC.AR-SC0050,00ARSC0313,M,1,44000,159000,2,0,47700,1,0,22260,111300,89040
01SCS19E080046,BSC.AR-SC0047,00ARSC0299,NON,1,45000,150000,2,0,45000,1,0,21000,105000,84000
01SCS19E080047,AR.CPT-RL010,20ARRL0103,NON,1,77350,119000,2,0,23800,1,0,23800,95200,71400
01SCS19E080047,BE.RAK-RX530,00BERX2191,L,1,91000,140000,2,0,28000,1,0,28000,112000,84000
01SCS19E080047,BSC.AR-RI0003,00ARRI0008,L,1,43000,135000,2,0,40500,1,0,18900,94500,75600
01SCS19E080048,BE.RAK-SC004,00BESC0006,M,1,256750,395000,2,0,79000,1,0,79000,316000,237000
01SCS19E080049,BE.RAK-RX381,00BERX1441,XL,1,91000,140000,2,0,28000,1,0,28000,112000,84000
01SCS19E080050,BSC.AR-SD0009,00ARSD0100,M,1,44000,159000,3,0,47700,1,0,22260,111300,89040
01SCS19E080051,AR.STY-RJ004,20ARRJ0053,ALL,1,55250,85000,2,0,17000,1,0,17000,68000,51000
01SCS19E080051,ESH.AR-SC0010,00ARSC0080,S,1,44500,135000,2,0,40500,1,0,18900,94500,75600
01SCS19E080052,AR.CPT-SC008,20ARSC0269,M,1,94250,145000,2,0,29000,1,0,29000,116000,87000
01SCS19E080052,AR.ESB-SC015,20ARSC0443,M,1,87750,135000,2,0,27000,1,0,27000,108000,81000
01SCS19E080053,AR.REC-SD022,20ARSD0066,M,1,224250,345000,2,0,103500,1,0,60375,241500,181125
01SCS19E080054,AR.TUC-SD023,20ARSD0511,L,1,204750,315000,2,0,63000,1,0,63000,252000,189000
01SCS19E080055,ESH.AR-RC0040,00ARRC0226,S,1,42000,135000,2,0,67500,1,0,13500,67500,54000
01SCS19E080055,ESH.AR-RE0009,00ARRE0033,S,1,42000,135000,2,0,67500,1,0,13500,67500,54000
01SCS19E080056,ARN.AR-SD0001,00ARSD0219,S,1,44500,150000,0,0,0,0,0,45000,150000,105000
01SCS19E080057,ARN.AR-SB0001,00ARSB0086,NON,1,107400,179000,2,0,35800,1,0,42960,143200,100240
01SCS19E080058,AR.CPT-RI005,20ARRI0057,M,1,94250,145000,2,0,29000,1,0,29000,116000,87000
01SCS19E080058,AR.VCS-SC005,20ARSC0389,M,1,97500,150000,2,0,45000,1,0,26250,105000,78750
01SCS19E080059,BSC.AR-PI0079,00ARPI0220,XL,1,88334,265000,2,0,105000,1,0,32000,160000,128000
01SCS19E080060,ESH.AR-RD0028,00ARRD0244,M,1,43000,135000,2,0,67500,1,0,13500,67500,54000
01SCS19E080060,ESH.AR-RF0019,00ARRF0135,M,1,42000,135000,2,0,67500,1,0,13500,67500,54000
01SCS19E080061,AR.PUB-SE030,20ARSE0116,M,1,224250,345000,2,0,69000,1,0,69000,276000,207000
01SCS19E080062,BSC.AR-SD0027,00ARSD0156,S,1,125000,315000,2,0,94500,1,0,44100,220500,176400
01SCS19E080062,ESH.AR-RC0047,00ARRC0276,M,1,42000,135000,2,0,67500,1,0,13500,67500,54000
01SCS19E080062,ESH.AR-RD0031,00ARRD0258,XL,1,43000,135000,2,0,67500,1,0,13500,67500,54000
01SCS19E080063,AR.PUB-SE026,20ARSE0100,M,1,204750,315000,2,0,63000,1,0,63000,252000,189000
01SCS19E080063,ESH.AR-RF0004,00ARRF0032,L,1,110000,315000,2,0,155000,1,0,32000,160000,128000
01SCS19E080064,BSC.AR-SA0017,00ARSA0051,S,1,125000,315000,2,0,94500,1,0,44100,220500,176400
01SCS19E080065,ESH.AR-RC0024,00ARRC0179,S,1,42000,135000,2,0,67500,1,0,13500,67500,54000
01SCS19E080065,ESH.AR-RD0028,00ARRD0244,M,1,43000,135000,2,0,67500,1,0,13500,67500,54000
01SCS19E080066,AR.TUC-SD026,20ARSD0521,ALL,1,35750,55000,2,0,11000,1,0,11000,44000,33000
01SCS19E080067,THR.AR-QG0009,00ARQG0039,XL,1,1030000,1030000,2,0,103000,1,0,139050,927000,787950
01SCS19E080068,ESH.AR-SA0008,00ARSA0085,L,1,113450,350000,2,0,105000,1,0,49000,245000,196000
01SCS19E080069,ESH.AR-RF0007,00ARRF0043,M,1,150000,395000,2,0,220000,1,0,35000,175000,140000
01SCS19E080070,AR.BPH-RH027,20ARRH0785,S,1,187850,289000,2,0,144500,1,0,36125,144500,108375
01SCS19E080070,BE.RAK-RX192,00BERX0473,42,1,130000,200000,2,0,40000,1,0,40000,160000,120000
01SCS19E080070,BSC.AR-RE0001,00ARRE0038,M,1,42000,135000,2,0,67500,1,0,13500,67500,54000
01SCS19E080070,ESH.AR-QG0007,00ARQG0098,ALL,1,70000,205000,2,0,105000,1,0,20000,100000,80000
01SCS19E080070,ESH.AR-RF0019,00ARRF0135,M,1,42000,135000,2,0,67500,1,0,13500,67500,54000
01SCS19E080071,BSC.AR-QI0010,00ARQI0037,ALL,1,46000,140000,2,0,40000,1,0,20000,100000,80000
01SCS19E080071,BSC.AR-RE0001,00ARRE0040,XL,1,42000,135000,2,0,67500,1,0,13500,67500,54000
01SCS19E080071,ESH.AR-RE0005,00ARRE0019,L,1,42000,135000,2,0,67500,1,0,13500,67500,54000
01SCS19E080072,AR.TUC-SD018,20ARSD0491,L,1,94250,145000,2,0,29000,1,0,29000,116000,87000
01SCS19E080072,ESH.AR-RD0035,00ARRD0272,L,1,43000,135000,2,0,67500,1,0,13500,67500,54000
01SCS19E080072,ESH.AR-RE0004,00ARRE0014,M,1,42000,135000,2,0,67500,1,0,13500,67500,54000
01SCS19E080073,BSC.AR-RE0015,00ARRE0108,NON,1,35000,120000,2,0,36000,1,0,16800,84000,67200
01SCS19E080073,ESH.AR-RJ0023,00ARRJ0218,NON,1,18000,75000,2,0,22500,1,0,10500,52500,42000
01SCS19E080074,AR.PUB-SE021,20ARSE0080,M,1,159250,245000,2,0,49000,1,0,49000,196000,147000
01SCS19E080075,BSC.AR-RE0001,00ARRE0038,M,1,42000,135000,2,0,67500,1,0,13500,67500,54000
01SCS19E080075,ESH.AR-RC0040,00ARRC0226,S,1,42000,135000,2,0,67500,1,0,13500,67500,54000
01SCS19E080075,ESH.AR-RE0009,00ARRE0034,M,1,42000,135000,2,0,67500,1,0,13500,67500,54000
01SCS19E080075,ESH.AR-RE0010,00ARRE0078,M,1,42000,135000,2,0,67500,1,0,13500,67500,54000
01SCS19E080075,ESH.AR-RE0013,00ARRE0089,S,1,42000,135000,2,0,67500,1,0,13500,67500,54000
01SCS19E080075,ESH.AR-RE0020,00ARRE0208,S,1,42000,135000,2,0,67500,1,0,13500,67500,54000
01SCS19E080076,AR.TUC-SB003,20ARSB0031,ALL,1,61750,95000,2,0,19000,1,0,19000,76000,57000
01SCS19E080077,AR.CPT-SD006,20ARSD0434,M,1,200850,309000,2,0,61800,1,0,61800,247200,185400
01SCS19E080077,ESH.AR-SD0023,00ARSD0169,NON,1,43000,120000,2,0,36000,1,0,16800,84000,67200
01SCS19E080078,ESH.AR-QD0016,00ARQD0150,M,1,110000,325000,2,0,165000,1,0,32000,160000,128000
01SCS19E080079,AR.MKV-RJ003,20ARRJ0152,L,1,91000,140000,2,0,28000,1,0,28000,112000,84000
01SCS19E080079,AR.MPR-SE016,20ARSE0198,M,1,243750,375000,2,0,75000,1,0,75000,300000,225000
01SCS19E080079,AR.TUC-SA006,20ARSA0024,XL,1,87750,135000,2,0,27000,1,0,27000,108000,81000
01SCS19E080080,AR.SMD-QF005,20ARQF0704,L,1,104000,160000,2,0,48000,1,0,28000,112000,84000
01SCS19E080081,BSC.AR-SC0013,00ARSC0094,L,1,44000,135000,2,0,40500,1,0,18900,94500,75600
01SCS19E080082,BSC.AR-RI0032,00ARRI0150,M,1,120000,315000,2,0,94500,1,0,44100,220500,176400
01SCS19E080083,ESH.AR-QE0008,00ARQE0027,ALL,1,39800,140000,2,0,90000,1,0,10000,50000,40000
01SCS19E080084,BSC.AR-SA0009,00ARSA0035,NON,1,47500,140000,2,0,42000,1,0,19600,98000,78400
01SCS19E080085,BSC.AR-SC0042,00ARSC0277,M,1,135000,375000,2,0,112500,1,0,52500,262500,210000
01SCS19E080086,BSC.AR-SD0043,00ARSD0233,L,1,44500,159000,2,0,47700,1,0,22260,111300,89040
01SCS19E080087,ESH.AR-RB0021,00ARRB0131,S,1,95000,310000,2,0,150000,1,0,32000,160000,128000
01SCS19E080088,BSC.AR-SC0004,00ARSC0031,M,1,125000,315000,2,0,94500,1,0,44100,220500,176400
01SCS19E080089,AR.MDS-RL006,20ARRL0375,M,1,117000,180000,2,0,36000,1,0,36000,144000,108000
01SCS19E080089,AR.TUC-RI011,20ARRI0367,M,1,87750,135000,2,0,27000,1,0,27000,108000,81000
01SCS19E080089,BSC.AR-RE0001,00ARRE0038,M,1,42000,135000,2,0,67500,1,0,13500,67500,54000
01SCS19E080089,ESH.AR-RC0047,00ARRC0275,S,1,42000,135000,2,0,67500,1,0,13500,67500,54000
01SCS19E080089,ESH.AR-RF0007,00ARRF0042,S,1,150000,395000,2,0,220000,1,0,35000,175000,140000
01SCS19E080090,ESH.AR-SD0040,00ARSD0369,XL,1,122500,350000,2,0,105000,1,0,49000,245000,196000
01SCS19E080091,AR.PUB-SE011,20ARSE0044,XL,1,97500,150000,2,0,30000,1,0,30000,120000,90000
01SCS19E080091,BSC.AR-SC0049,00ARSC0311,XL,1,44500,159000,0,0,0,0,0,31800,159000,127200
01SCS19E080092,AR.MPR-SB017,20ARSB0299,M,1,230750,355000,2,0,71000,1,0,71000,284000,213000
01SCS19E080093,ESH.AR-QE0002,00ARQE0021,ALL,1,50000,140000,2,0,90000,1,0,10000,50000,40000
01SCS19E080094,AR.CPT-RL008,20ARRL0100,L,1,94250,145000,2,0,29000,1,0,29000,116000,87000
01SCS19E080095,ESH.AR-SB0034,00ARSB0216,S,1,125000,315000,2,0,94500,1,0,44100,220500,176400
01SCS19E080096,ESH.AR-RF0004,00ARRF0032,L,1,110000,315000,2,0,155000,1,0,32000,160000,128000
01SCS19E080096,ESH.AR-SC0015,00ARSC0120,S,1,44000,135000,2,0,40500,1,0,18900,94500,75600
01SCS19E080097,BSC.AR-RE0001,00ARRE0039,L,1,42000,135000,2,0,67500,1,0,13500,67500,54000
01SCS19E080097,ESH.AR-RF0019,00ARRF0135,M,1,42000,135000,2,0,67500,1,0,13500,67500,54000
01SCS19E080098,AR.MYA-SD004,20ARSD0257,32,1,207350,319000,2,0,159500,1,0,39875,159500,119625
01SCS19E080098,ESH.AR-QJ0007,00ARQJ0030,M,1,100000,310000,2,0,150000,1,0,32000,160000,128000
01SCS19E080099,DKS.AR-SE0003,00ARSE0138,34,1,417272,696000,2,0,69600,1,0,93960,626400,532440
01SCS19E080100,BE.RAK-SC039,00BESC0168,M,1,91000,140000,2,0,28000,1,0,28000,112000,84000
01SCS19E080101,AR.MKV-QF025,20ARSD0414,36,1,224250,345000,2,0,172500,1,0,43125,172500,129375
01SCS19E080102,AR.PUB-RL018,20ARRL0168,S,1,191750,295000,2,0,59000,1,0,59000,236000,177000
01SCS19E080102,AR.TUC-SD028,20ARSD0523,ALL,1,35750,55000,2,0,11000,1,0,11000,44000,33000
01SCS19E080102,ARN.AR-RK0003,00ARRK0228,L,1,120000,315000,2,0,63000,1,0,75600,252000,176400
01SCS19E080102,BSC.AR-RE0001,00ARRE0039,L,1,42000,135000,2,0,67500,1,0,13500,67500,54000
01SCS19E080102,BSC.AR-RH0020,00ARRH0115,S,1,52000,155000,2,0,46500,1,0,21700,108500,86800
01SCS19E080102,BSC.AR-RJ0033,00ARRJ0216,NON,1,52500,75000,2,0,22500,1,0,10500,52500,42000
01SCS19E080102,BSC.AR-SD0011,00ARSD0104,NON,1,18000,75000,2,0,22500,1,0,10500,52500,42000
01SCS19E080102,ESH.AR-RC0024,00ARRC0179,S,1,42000,135000,2,0,67500,1,0,13500,67500,54000
01SCS19E080102,ESH.AR-RE0004,00ARRE0013,S,1,42000,135000,2,0,67500,1,0,13500,67500,54000
01SCS19E080102,ESH.AR-RE0009,00ARRE0035,L,1,42000,135000,2,0,67500,1,0,13500,67500,54000
01SCS19E080102,ESH.AR-RE0010,00ARRE0078,M,1,42000,135000,2,0,67500,1,0,13500,67500,54000
01SCS19E080102,ESH.AR-RF0019,00ARRF0135,M,1,42000,135000,2,0,67500,1,0,13500,67500,54000
01SCS19E080103,AR.FHL-SC005,20ARSC0344,L,1,110500,170000,2,0,34000,1,0,34000,136000,102000
01SCS19E080103,ESH.AR-RE0009,00ARRE0035,L,1,42000,135000,2,0,67500,1,0,13500,67500,54000
01SCS19E080103,ESH.AR-RF0012,00ARRF0066,M,1,43000,135000,2,0,67500,1,0,13500,67500,54000
01SCS19E080104,ESH.AR-RG0005,00ARRG0101,M,1,94500,135000,2,0,40500,1,0,18900,94500,75600
01SCS19E080105,ESH.AR-SD0021,00ARSD0165,M,1,125000,315000,2,0,94500,1,0,44100,220500,176400
01SCS19E080106,AR.YD-RL014,20ARRL0035,L,1,195000,300000,2,0,150000,1,0,37500,150000,112500
01SCS19E080107,ESH.AR-RD0024,00ARRD0228,M,1,145000,435000,2,0,260000,1,0,35000,175000,140000
01SCS19E080108,ESH.AR-RC0011,00ARRC0112,L,1,180000,499000,2,0,324000,1,0,35000,175000,140000
01SCS19E080109,ESH.AR-RC0011,00ARRC0112,L,1,180000,499000,2,0,324000,1,0,35000,175000,140000
01SCS19E080110,BSC.AR-RK0018,00ARRK0118,M,1,43000,135000,2,0,40500,1,0,18900,94500,75600
01SCS19E090001,AR.STY-SC006,20ARSC0205,ALL,1,77350,119000,2,0,23800,1,0,23800,95200,71400
01SCS19E090001,ESH.AR-QK0001,00ARQK0003,L,1,90000,310000,2,0,150000,1,0,32000,160000,128000
01SCS19E090002,ESH.AR-RK0002,00ARRK0006,M,1,120000,315000,2,0,94500,1,0,44100,220500,176400
01SCS19E090003,AR.MKV-QH013,20ARQH0218,ALL,1,78000,120000,2,0,60000,1,0,15000,60000,45000
01SCS19E090003,BSC.AR-RI0006,00ARRI0021,XL,1,94500,135000,2,0,40500,1,0,18900,94500,75600
01SCS19E090003,BSC.AR-RJ0021,00ARRJ0119,S,1,43000,135000,2,0,40500,1,0,18900,94500,75600
01SCS19E090003,ESH.AR-SC0018,00ARSC0147,XL,1,44000,135000,2,0,40500,1,0,18900,94500,75600
01SCS19E090004,AR.TUC-SD006,20ARSD0162,L,1,94250,145000,2,0,29000,1,0,29000,116000,87000
01SCS19E090005,ESH.AR-RC0040,00ARRC0226,S,1,42000,135000,2,0,67500,1,0,13500,67500,54000
01SCS19E090005,ESH.AR-RE0005,00ARRE0019,L,1,42000,135000,2,0,67500,1,0,13500,67500,54000
01SCS19E090006,AR.MKV-RG004,20ARRG0090,ALL,1,78000,120000,2,0,24000,1,0,24000,96000,72000
01SCS19E090007,DKS.AR-SE0007,00ARSE0152,30,1,417272,696000,2,0,69600,1,0,93960,626400,532440
01SCS19E090008,AR.PUB-RJ002,20ARRJ0007,L,1,97500,150000,2,0,30000,1,0,30000,120000,90000
01SCS19E090008,AR.SMD-RE011,20ARRE1283,L,1,87750,135000,2,0,40500,1,0,23625,94500,70875
01SCS19E090009,BSC.AR-RE0001,00ARRE0039,L,1,42000,135000,2,0,67500,1,0,13500,67500,54000
01SCS19E090009,ESH.AR-RD0028,00ARRD0244,M,1,43000,135000,2,0,67500,1,0,13500,67500,54000
01SCS19E090010,AR.MKV-RE022,20ARRE0903,L,1,204750,315000,2,0,63000,1,0,63000,252000,189000
01SCS19E090010,AR.PUB-SB023,20ARSB0126,L,1,97500,150000,2,0,30000,1,0,30000,120000,90000
01SCS19E090010,AR.PUB-SD018,20ARSD0187,ALL,1,97500,150000,2,0,30000,1,0,30000,120000,90000
01SCS19E090010,BSC.AR-RC0025,00ARRC0166,ALL,1,43000,185000,2,0,85000,1,0,20000,100000,80000
01SCS19E090011,BSC.AR-RC0024,00ARRC0165,ALL,1,43000,185000,2,0,85000,1,0,20000,100000,80000
01SCS19E090011,BSC.AR-RD0001,00ARRD0001,S,1,155,450000,2,0,275000,1,0,35000,175000,140000
01SCS19E090011,BSC.AR-SD0006,00ARSD0021,S,1,44000,159000,0,0,0,0,0,31800,159000,127200
01SCS19E090011,ESH.AR-QE0008,00ARQE0027,ALL,1,39800,140000,2,0,90000,1,0,10000,50000,40000
01SCS19E090012,ESH.AR-PK0010,00ARPK0081,ALL,1,39800,140000,2,0,90000,1,0,10000,50000,40000
01SCS19E090012,ESH.AR-QA0024,00ARQA0129,ALL,1,37800,140000,2,0,90000,1,0,10000,50000,40000
01SCS19E090013,AR.PUB-SE011,20ARSE0041,S,1,97500,150000,2,0,30000,1,0,30000,120000,90000
01SCS19E090013,AR.SMD-SD018,20ARSD0580,ALL,1,97500,150000,2,0,30000,1,0,30000,120000,90000
01SCS19E090014,AR.STY-SB007,20ARSB0494,ALL,1,55250,85000,2,0,17000,1,0,17000,68000,51000
01SCS19E090014,ESH.AR-RH0020,00ARRH0108,M,1,94500,135000,2,0,40500,1,0,18900,94500,75600
01SCS19E090015,ESH.AR-RI0018,00ARRI0146,NON,1,39000,140000,2,0,42000,1,0,19600,98000,78400
01SCS19E090016,ESH.AR-SD0044,00ARSD0399,M,1,125000,315000,2,0,94500,1,0,44100,220500,176400
01SCS19E090017,AR.STY-SC006,20ARSC0205,ALL,1,77350,119000,2,0,23800,1,0,23800,95200,71400
01SCS19E090017,AR.STY-SC008,20ARSC0207,ALL,1,77350,119000,2,0,23800,1,0,23800,95200,71400
01SCS19E090018,AR.STY-SC008,20ARSC0207,ALL,1,77350,119000,2,0,23800,1,0,23800,95200,71400
01SCS19E090019,AR.TUC-RI011,20ARRI0367,M,1,87750,135000,2,0,27000,1,0,27000,108000,81000
01SCS19E090020,AR.MPR-SE008,20ARSE0165,S,1,97500,150000,2,0,45000,1,0,26250,105000,78750
01SCS19E090020,ESH.AR-QD0016,00ARQD0150,M,1,110000,325000,2,0,165000,1,0,32000,160000,128000
01SCS19E090020,ESH.AR-SD0022,00ARSD0168,NON,1,43000,120000,2,0,36000,1,0,16800,84000,67200
01SCS19E090021,BSC.AR-RJ0030,00ARRJ0199,L,1,220500,315000,2,0,94500,1,0,44100,220500,176400
01SCS19E090021,BSC.AR-SD0056,00ARSD0289,S,1,125000,315000,2,0,94500,1,0,44100,220500,176400
01SCS19E090022,ESH.AR-SD0013,00ARSD0081,30,1,145000,375000,2,0,112500,1,0,52500,262500,210000
01SCS19E090023,AR.MKV-RL001,20ARRL0236,M,1,204750,315000,2,0,63000,1,0,63000,252000,189000
01SCS19E090023,ESH.AR-SB0025,00ARSB0157,NON,1,35300,120000,2,0,36000,1,0,16800,84000,67200
01SCS19E090024,AR.CPT-RL013,20ARRL0111,L,1,204750,315000,2,0,63000,1,0,63000,252000,189000
01SCS19E090025,AR.ESB-SC003,20ARSC0420,L,1,91000,140000,2,0,28000,1,0,28000,112000,84000
01SCS19E090025,AR.PUB-SD018,20ARSD0187,ALL,1,97500,150000,2,0,30000,1,0,30000,120000,90000
01SCS19E090025,AR.PUB-SE002,20ARSE0007,L,1,97500,150000,2,0,30000,1,0,30000,120000,90000
01SCS19E090025,AR.SMD-RL002,20ARRL0266,ALL,1,22750,35000,2,0,7000,1,0,7000,28000,21000
01SCS19E090026,AR.TUC-SA027,20ARSA0162,ALL,1,100750,155000,2,0,31000,1,0,31000,124000,93000
01SCS19E090027,ESH.AR-SD0040,00ARSD0366,S,1,122500,350000,2,0,105000,1,0,49000,245000,196000
01SCS19E090028,AR.STY-SB001,20ARSB0488,ALL,1,61750,95000,2,0,19000,1,0,19000,76000,57000
01SCS19E090028,ESH.AR-SD0044,00ARSD0398,S,1,125000,315000,2,0,94500,1,0,44100,220500,176400
01SCS19E090029,ESH.AR-RC0047,00ARRC0275,S,1,42000,135000,2,0,67500,1,0,13500,67500,54000
01SCS19E090029,ESH.AR-RF0012,00ARRF0066,M,1,43000,135000,2,0,67500,1,0,13500,67500,54000
01SCS19E090030,ESH.AR-SB0016,00ARSB0067,M,1,125000,315000,2,0,94500,1,0,44100,220500,176400
01SCS19E090031,ESH.AR-QK0011,00ARQK0069,34,1,130000,375000,2,0,200000,1,0,35000,175000,140000
01SCS19E090032,ESH.AR-SD0026,00ARSD0266,S,1,44500,135000,2,0,40500,1,0,18900,94500,75600
01SCS19E090033,AR.CPT-SD008,20ARSD0442,M,1,204750,315000,2,0,63000,1,0,63000,252000,189000
01SCS19E090034,BSC.AR-RC0034,00ARRC0235,M,1,120000,360000,2,0,185000,1,0,35000,175000,140000
01SCS19E090035,BSC.AR-RJ0032,00ARRJ0215,NON,1,18000,75000,2,0,22500,1,0,10500,52500,42000
01SCS19E090036,BSC.AR-QG0018,00ARQG0151,M,1,135000,395000,2,0,220000,1,0,35000,175000,140000
01SCS19E090036,BSC.AR-SD0056,00ARSD0289,S,1,125000,315000,2,0,94500,1,0,44100,220500,176400
01SCS19E090036,ESH.AR-RD0020,00ARRD0187,S,1,43000,150000,2,0,82500,1,0,13500,67500,54000
01SCS19E090036,ESH.AR-RE0013,00ARRE0090,M,1,42000,135000,2,0,67500,1,0,13500,67500,54000
01SCS19E090037,ESH.AR-RL0017,00ARRL0137,S,1,94500,135000,2,0,40500,1,0,18900,94500,75600
01SCS19E090038,AR.HMR-SB020,20ARSB0392,32,1,204750,315000,2,0,63000,1,0,63000,252000,189000
01SCS19E090038,AR.MPR-SB007,20ARSB0260,L,1,97500,150000,2,0,45000,1,0,26250,105000,78750
01SCS19E090038,AR.REC-SD006,20ARSD0022,M,1,107250,165000,2,0,49500,1,0,28875,115500,86625
01SCS19E090039,BSC.AR-SD0047,00ARSD0247,NON,1,68000,220000,2,0,66000,1,0,30800,154000,123200
01SCS19E090040,AR.VLD-RK019,20ARRK0353,S,1,91000,140000,2,0,42000,1,0,24500,98000,73500
01SCS19E090041,BSC.AR-RH0017,00ARRH0074,S,1,120000,315000,2,0,94500,1,0,44100,220500,176400
01SCS19E090042,ESH.AR-SA0009,00ARSA0088,M,1,122500,350000,2,0,105000,1,0,49000,245000,196000
01SCS19E090043,AR.MPR-SE021,20ARSE0205,ALL,1,97500,150000,2,0,45000,1,0,26250,105000,78750
01SCS19E090043,ESH.AR-RE0014,00ARRE0094,M,1,105000,330000,2,0,155000,1,0,35000,175000,140000
01SCS19E090044,ESH.AR-SC0019,00ARSC0149,S,1,125000,315000,2,0,94500,1,0,44100,220500,176400
01SCS19E090045,AR.SMD-RL002,20ARRL0266,ALL,1,22750,35000,2,0,7000,1,0,7000,28000,21000
01SCS19E090046,AR.PUB-SD032,20ARSD0240,L,1,204750,315000,2,0,63000,1,0,63000,252000,189000
01SCS19E090047,AR.HLW-SC010,20ARSC0143,M,1,100750,155000,2,0,46500,1,0,27125,108500,81375
01SCS19E090048,ESH.AR-SD0004,00ARSD0046,M,1,44500,135000,2,0,40500,1,0,18900,94500,75600
01SCS19E090049,AR.ASH-RJ007,20ARRJ0271,M,1,91000,140000,2,0,42000,1,0,24500,98000,73500
01SCS19E090049,AR.TUC-SD002,20ARSD0146,L,1,204750,315000,2,0,63000,1,0,63000,252000,189000
01SCS19E090049,ESH.AR-RD0001,00ARRD0019,30,1,110000,350000,2,0,175000,1,0,35000,175000,140000
01SCS19E090050,ESH.AR-PK0043,00ARPK0198,S,1,110000,325000,2,0,165000,1,0,32000,160000,128000
01SCS19E090050,ESH.AR-QE0008,00ARQE0027,ALL,1,39800,140000,2,0,90000,1,0,10000,50000,40000
01SCS19E090051,ESH.AR-QE0009,00ARQE0028,ALL,1,45000,140000,2,0,90000,1,0,10000,50000,40000
01SCS19E090052,ESH.AR-RC0040,00ARRC0228,L,1,42000,135000,2,0,67500,1,0,13500,67500,54000
01SCS19E090052,ESH.AR-RD0001,00ARRD0019,30,1,110000,350000,2,0,175000,1,0,35000,175000,140000
01SCS19E090052,ESH.AR-RD0003,00ARRD0050,30,1,110000,350000,2,0,175000,1,0,35000,175000,140000
01SCS19E090052,ESH.AR-RE0005,00ARRE0019,L,1,42000,135000,2,0,67500,1,0,13500,67500,54000
01SCS19E090053,ESH.AR-QD0038,00ARQD0297,ALL,1,45000,140000,2,0,90000,1,0,10000,50000,40000
01SCS19E090054,ESH.AR-SD0010,00ARSD0069,S,1,44500,135000,2,0,40500,1,0,18900,94500,75600
01SCS19E090054,ESH.AR-SD0043,00ARSD0394,S,1,125000,315000,2,0,94500,1,0,44100,220500,176400
01SCS19E090055,ESH.AR-RL0013,00ARRL0126,NON,1,47000,130000,2,0,39000,1,0,18200,91000,72800
01SCS19E090056,ESH.AR-SB0027,00ARSB0159,S,1,44000,135000,2,0,40500,1,0,18900,94500,75600
01SCS19E090057,AR.TUC-RK040,20ARRK0174,L,1,204750,315000,2,0,63000,1,0,63000,252000,189000
01SCS19E090058,AR.HLW-SA020,20ARSA0126,30,1,243750,375000,2,0,112500,1,0,65625,262500,196875
01SCS19E090058,AR.PUB-RC010,20ARRC0623,ALL,1,97500,150000,2,0,30000,1,0,30000,120000,90000
01SCS19E090058,BSC.AR-RJ0029,00ARRJ0168,M,1,120000,315000,2,0,94500,1,0,44100,220500,176400
01SCS19E090059,AR.PUB-SE028,20ARSE0108,M,1,204750,315000,2,0,63000,1,0,63000,252000,189000
01SCS19E090060,ESH.AR-RE0025,00ARRE0261,32,1,120000,350000,2,0,175000,1,0,35000,175000,140000
01SCS19E090061,BSC.AR-RD0001,00ARRD0002,M,1,155,450000,2,0,275000,1,0,35000,175000,140000
01SCS19E090062,AR.PUB-SB023,20ARSB0125,M,1,97500,150000,2,0,30000,1,0,30000,120000,90000
01SCS19E090063,ESH.AR-RJ0011,00ARRJ0054,XL,1,94500,135000,2,0,40500,1,0,18900,94500,75600
01SCS19E090064,AR.CPT-SD009,20ARSD0446,M,1,94250,145000,2,0,29000,1,0,29000,116000,87000
01SCS19E090065,ESH.AR-QK0001,00ARQK0002,M,1,90000,310000,2,0,150000,1,0,32000,160000,128000
01SCS19E090066,AR.MPR-SE016,20ARSE0200,XL,1,243750,375000,2,0,75000,1,0,75000,300000,225000
01SCS19E090066,AR.PUB-SE020,20ARSE0078,L,1,159250,245000,2,0,49000,1,0,49000,196000,147000
01SCS19E090067,AR.CPT-RE013,20ARRE0718,M,1,94250,145000,2,0,29000,1,0,29000,116000,87000
01SCS19E090068,AR.CPT-SD009,20ARSD0446,M,1,94250,145000,2,0,29000,1,0,29000,116000,87000
01SCS19E090069,BSC.AR-RK0014,00ARRK0103,L,1,43000,135000,2,0,40500,1,0,18900,94500,75600
01SCS19E090070,BSC.AR-RL0018,00ARRL0110,M,1,125000,315000,2,0,94500,1,0,44100,220500,176400
01SCS19E090071,AR.MKV-RG005,20ARRG0091,ALL,1,78000,120000,2,0,24000,1,0,24000,96000,72000
01SCS19E090072,AR.PUB-SB014,20ARSB0054,L,1,159250,245000,2,0,49000,1,0,49000,196000,147000
01SCS19E090073,ESH.AR-SC0005,00ARSC0026,S,1,125000,315000,2,0,94500,1,0,44100,220500,176400
01SCS19E090074,AR.TUC-SD002,20ARSD0146,L,1,204750,315000,2,0,63000,1,0,63000,252000,189000
01SCS19E090075,AR.MDS-RL006,20ARRL0375,M,1,117000,180000,2,0,36000,1,0,36000,144000,108000
01SCS19E090076,AR.REC-SD014,20ARSD0052,ALL,1,107250,165000,2,0,49500,1,0,28875,115500,86625
01SCS19E090077,AR.CPT-SD006,20ARSD0433,S,1,200850,309000,2,0,61800,1,0,61800,247200,185400
01SCS19E090078,AR.PCT-QE002,20ARQE0012,L,1,78000,120000,2,0,60000,1,0,15000,60000,45000
01SCS19E090079,BSC.AR-RJ0029,00ARRJ0167,S,1,120000,315000,2,0,94500,1,0,44100,220500,176400
01SCS19E090080,ESH.AR-QJ0007,00ARQJ0031,L,1,100000,310000,2,0,150000,1,0,32000,160000,128000
01SCS19E090080,ESH.AR-SD0026,00ARSD0268,L,1,44500,135000,2,0,40500,1,0,18900,94500,75600
01SCS19E090081,BSC.AR-SD0041,00ARSD0223,S,1,44500,159000,2,0,47700,1,0,22260,111300,89040
01SCS19E090082,BSC.AR-SD0016,00ARSD0118,S,1,122000,375000,2,0,112500,1,0,52500,262500,210000
01SCS19E090083,ESH.AR-RC0040,00ARRC0228,L,1,42000,135000,2,0,67500,1,0,13500,67500,54000
01SCS19E090083,ESH.AR-RD0001,00ARRD0019,30,1,110000,350000,2,0,175000,1,0,35000,175000,140000
01SCS19E090083,ESH.AR-RE0013,00ARRE0090,M,1,42000,135000,2,0,67500,1,0,13500,67500,54000
01SCS19E090084,BSC.AR-RL0020,00ARRL0118,M,1,125000,315000,2,0,94500,1,0,44100,220500,176400
01SCS19E090084,ESH.AR-SE0001,00ARSE0003,L,1,44000,135000,2,0,40500,1,0,18900,94500,75600
01SCS19E090085,AR.MKV-RB023,20ARRB0110,ALL,1,91000,140000,2,0,70000,1,0,17500,70000,52500
01SCS19E090085,AR.YD-RL004,20ARRL0020,ALL,1,91000,140000,2,0,70000,1,0,17500,70000,52500
01SCS19E090085,AR.YD-RL014,20ARRL0035,L,1,195000,300000,2,0,150000,1,0,37500,150000,112500
01SCS19E090085,BSC.AR-QG0010,00ARQG0099,ALL,1,80000,240000,2,0,140000,1,0,20000,100000,80000
01SCS19E090085,BSC.AR-RC0039,00ARRC0288,M,1,155000,450000,2,0,275000,1,0,35000,175000,140000
01SCS19E090085,BSC.AR-RE0001,00ARRE0039,L,1,42000,135000,2,0,67500,1,0,13500,67500,54000
01SCS19E090085,BSC.AR-RE0022,00ARRE0252,M,1,168000,240000,2,0,115000,1,0,25000,125000,100000
01SCS19E090085,BSC.AR-RI0032,00ARRI0151,L,1,120000,315000,2,0,94500,1,0,44100,220500,176400
01SCS19E090085,BSC.AR-RI0033,00ARRI0155,L,1,120000,315000,2,0,94500,1,0,44100,220500,176400
01SCS19E090085,BSC.AR-RI0035,00ARRI0209,M,1,120000,315000,2,0,94500,1,0,44100,220500,176400
01SCS19E090085,BSC.AR-RL0019,00ARRL0113,S,1,125000,315000,2,0,94500,1,0,44100,220500,176400
01SCS19E090085,BSC.AR-SA0002,00ARSA0005,S,1,120000,315000,2,0,94500,1,0,44100,220500,176400
01SCS19E090085,BSC.AR-SC0009,00ARSC0053,M,1,125000,315000,2,0,94500,1,0,44100,220500,176400
01SCS19E090085,BSC.AR-SC0010,00ARSC0058,L,1,125000,315000,2,0,94500,1,0,44100,220500,176400
01SCS19E090085,BSC.AR-SC0025,00ARSC0182,M,1,125000,315000,2,0,94500,1,0,44100,220500,176400
01SCS19E090085,BSC.AR-SC0029,00ARSC0200,M,1,125000,315000,2,0,94500,1,0,44100,220500,176400
01SCS19E090085,BSC.AR-SC0035,00ARSC0232,S,1,125000,315000,2,0,94500,1,0,44100,220500,176400
01SCS19E090085,BSC.AR-SD0038,00ARSD0208,M,1,125000,315000,2,0,94500,1,0,44100,220500,176400
01SCS19E090085,BSC.AR-SD0039,00ARSD0211,S,1,125000,315000,2,0,94500,1,0,44100,220500,176400
01SCS19E090085,ESH.AR-QE0004,00ARQE0023,ALL,1,39800,140000,2,0,90000,1,0,10000,50000,40000
01SCS19E090085,ESH.AR-QE0008,00ARQE0027,ALL,1,39800,140000,2,0,90000,1,0,10000,50000,40000
01SCS19E090085,ESH.AR-QG0007,00ARQG0098,ALL,1,70000,205000,2,0,105000,1,0,20000,100000,80000
01SCS19E090085,ESH.AR-QJ0007,00ARQJ0029,S,1,100000,310000,2,0,150000,1,0,32000,160000,128000
01SCS19E090085,ESH.AR-RC0002,00ARRC0005,S,1,85000,240000,2,0,115000,1,0,25000,125000,100000
01SCS19E090085,ESH.AR-RD0028,00ARRD0244,M,1,43000,135000,2,0,67500,1,0,13500,67500,54000
01SCS19E090085,ESH.AR-RE0007,00ARRE0025,S,1,42000,135000,2,0,67500,1,0,13500,67500,54000
01SCS19E090085,ESH.AR-RE0009,00ARRE0035,L,1,42000,135000,2,0,67500,1,0,13500,67500,54000
01SCS19E090085,ESH.AR-RE0025,00ARRE0261,32,1,120000,350000,2,0,175000,1,0,35000,175000,140000
01SCS19E090085,ESH.AR-RF0012,00ARRF0066,M,1,43000,135000,2,0,67500,1,0,13500,67500,54000
01SCS19E090085,ESH.AR-RF0020,00ARRF0139,M,1,42000,135000,2,0,67500,1,0,13500,67500,54000
01SCS19E090086,ESH.AR-SC0034,00ARSC0292,S,1,125000,315000,2,0,94500,1,0,44100,220500,176400
01SCS19E090087,AR.STY-SC008,20ARSC0207,ALL,1,77350,119000,2,0,23800,1,0,23800,95200,71400
01SCS19E090088,ESH.AR-QL0004,00ARQL0018,S,1,42000,135000,2,0,67500,1,0,13500,67500,54000
01SCS19E090088,ESH.AR-RE0013,00ARRE0090,M,1,42000,135000,2,0,67500,1,0,13500,67500,54000
01SCS19E090089,BSC.AR-SC0015,00ARSC0102,L,1,44000,159000,2,0,47700,1,0,22260,111300,89040
01SCS19E090090,AR.SMD-RH007,20ARRH0752,L,1,87750,135000,2,0,40500,1,0,23625,94500,70875
01SCS19E090091,ESH.AR-RB0006,00ARRB0045,32,1,90000,265000,2,0,90000,1,0,35000,175000,140000
01SCS19E090092,AR.PUB-RL002,20ARRL0114,ALL,1,97500,150000,2,0,30000,1,0,30000,120000,90000
01SCS19E090092,AR.PUB-SD018,20ARSD0187,ALL,1,97500,150000,2,0,30000,1,0,30000,120000,90000
01SCS19E090092,AR.PUB-SD032,20ARSD0240,L,1,204750,315000,2,0,63000,1,0,63000,252000,189000
01SCS19E090092,AR.PUB-SE028,20ARSE0109,L,1,204750,315000,2,0,63000,1,0,63000,252000,189000
01SCS19E090092,AR.YD-RL003,20ARRL0019,ALL,1,91000,140000,2,0,70000,1,0,17500,70000,52500
01SCS19E090092,ESH.AR-SD0037,00ARSD0335,NON,1,50000,150000,2,0,45000,1,0,21000,105000,84000
01SCS19E090093,AR.MPR-SE019,20ARSE0203,ALL,1,97500,150000,2,0,45000,1,0,26250,105000,78750
01SCS19E090093,AR.PUB-SD033,20ARSD0245,XL,1,204750,315000,2,0,63000,1,0,63000,252000,189000
01SCS19E090093,AR.TUC-SD020,20ARSD0500,XL,1,94250,145000,2,0,29000,1,0,29000,116000,87000
01SCS19E090094,AR.CPT-RH008,20ARRH0869,M,1,204750,315000,2,0,63000,1,0,63000,252000,189000
01SCS19E090095,ESH.AR-RD0020,00ARRD0188,M,1,43000,150000,2,0,82500,1,0,13500,67500,54000
01SCS19E090095,ESH.AR-RD0021,00ARRD0192,M,1,42000,135000,2,0,67500,1,0,13500,67500,54000
01SCS19E090096,ESH.AR-SC0019,00ARSC0150,M,1,125000,315000,2,0,94500,1,0,44100,220500,176400
01SCS19E090097,AR.MYA-RE005,20ARRE1309,34,1,207350,319000,2,0,159500,1,0,39875,159500,119625
01SCS19E090098,BSC.AR-SA0004,00ARSA0018,S,1,125000,315000,2,0,94500,1,0,44100,220500,176400
01SCS19E090099,AR.ESB-SC001,20ARSC0306,L,1,204750,315000,2,0,63000,1,0,63000,252000,189000
01SCS19E090100,AR.SLS-SC012,20ARSC0316,M,1,148750,175000,2,0,17500,1,0,23625,157500,133875
01SCS19E090100,ESH.AR-RG0004,00ARRG0011,M,1,90000,255000,2,0,76500,1,0,35700,178500,142800
01SCS19E090101,AR.CPT-SC013,20ARSC0484,M,1,94250,145000,2,0,29000,1,0,29000,116000,87000
01SCS19E090102,BSC.AR-RH0024,00ARRH0157,L,1,245000,350000,2,0,105000,1,0,49000,245000,196000
01SCS19E090103,AR.CPT-RE010,20ARRE0705,S,1,204750,315000,2,0,63000,1,0,63000,252000,189000
01SCS19E090104,ESH.AR-RD0001,00ARRD0020,32,1,110000,350000,2,0,175000,1,0,35000,175000,140000
01SCS19E090105,AR.TUC-SD011,20ARSD0462,M,1,94250,145000,2,0,29000,1,0,29000,116000,87000
01SCS19E090105,AR.TUC-SD012,20ARSD0467,L,1,94250,145000,2,0,29000,1,0,29000,116000,87000
01SCS19E090106,BSC.AR-SD0009,00ARSD0100,M,1,44000,159000,3,0,47700,1,0,22260,111300,89040
01SCS19E090107,AR.HLW-SA013,20ARSA0105,M,1,120250,185000,2,0,55500,1,0,32375,129500,97125
01SCS19E090108,AR.TUC-SD022,20ARSD0507,L,1,94250,145000,2,0,29000,1,0,29000,116000,87000
01SCS19E090109,AR.PUB-SE023,20ARSE0088,M,1,159250,245000,2,0,49000,1,0,49000,196000,147000
01SCS19E090110,AR.MKV-SA002,20ARSA0188,ALL,1,87750,135000,2,0,27000,1,0,27000,108000,81000
01SCS19E100001,AR.ESB-RB016,20ARRB0374,ALL,1,91000,140000,2,0,42000,1,0,24500,98000,73500
01SCS19E100002,BSC.AR-QG0010,00ARQG0099,ALL,1,80000,240000,2,0,140000,1,0,20000,100000,80000
01SCS19E100003,AR.SMD-SD005,20ARSD0293,M,1,87750,135000,2,0,27000,1,0,27000,108000,81000
01SCS19E100004,AR.PUB-RJ010,20ARRJ0030,ALL,1,97500,150000,2,0,30000,1,0,30000,120000,90000
01SCS19E100004,ESH.AR-SB0026,00ARSB0158,NON,1,35300,120000,2,0,36000,1,0,16800,84000,67200
01SCS19E100005,DKS.AR-SE0011,00ARSE0171,30,1,417272,696000,2,0,69600,1,0,93960,626400,532440
01SCS19E100006,ESH.AR-RF0007,00ARRF0044,L,1,150000,395000,2,0,220000,1,0,35000,175000,140000
01SCS19E100007,BSC.AR-SD0054,00ARSD0287,NON,1,50000,150000,2,0,45000,1,0,21000,105000,84000
01SCS19E100008,AR.PUB-SE026,20ARSE0100,M,1,204750,315000,2,0,63000,1,0,63000,252000,189000
01SCS19E100009,BSC.AR-SD0061,00ARSD0336,NON,1,45000,150000,2,0,45000,1,0,21000,105000,84000
01SCS19E100010,BSC.AR-QH0002,00ARQH0006,ALL,1,37800,140000,2,0,90000,1,0,10000,50000,40000
01SCS19E100010,ESH.AR-PK0040,00ARPK0188,L,1,110000,325000,2,0,165000,1,0,32000,160000,128000
01SCS19E100010,ESH.AR-PL0015,00ARPL0127,L,1,110000,325000,2,0,165000,1,0,32000,160000,128000
01SCS19E100010,ESH.AR-QD0038,00ARQD0297,ALL,1,45000,140000,2,0,90000,1,0,10000,50000,40000
01SCS19E100010,ESH.AR-QE0008,00ARQE0027,ALL,1,39800,140000,2,0,90000,1,0,10000,50000,40000
01SCS19E100010,ESH.AR-QE0009,00ARQE0028,ALL,1,45000,140000,2,0,90000,1,0,10000,50000,40000
01SCS19E100010,ESH.AR-QH0026,00ARQH0137,ALL,1,39700,140000,2,0,90000,1,0,10000,50000,40000
01SCS19E100010,ESH.AR-QI0003,00ARQI0036,ALL,1,40000,140000,2,0,90000,1,0,10000,50000,40000
01SCS19E100010,ESH.AR-QL0004,00ARQL0019,M,1,42000,135000,2,0,67500,1,0,13500,67500,54000
01SCS19E100010,ESH.AR-RA0014,00ARRA0071,ALL,1,55000,140000,2,0,90000,1,0,10000,50000,40000
01SCS19E100010,ESH.AR-RA0017,00ARRA0074,ALL,1,40000,140000,2,0,90000,1,0,10000,50000,40000
01SCS19E100010,ESH.AR-RB0015,00ARRB0084,32,1,105000,285000,2,0,110000,1,0,35000,175000,140000
01SCS19E100010,ESH.AR-RC0029,00ARRC0190,ALL,1,45000,150000,2,0,100000,1,0,10000,50000,40000
01SCS19E100010,ESH.AR-RC0040,00ARRC0228,L,1,42000,135000,2,0,67500,1,0,13500,67500,54000
01SCS19E100010,ESH.AR-RE0010,00ARRE0078,M,1,42000,135000,2,0,67500,1,0,13500,67500,54000
01SCS19E100010,ESH.AR-RF0020,00ARRF0139,M,1,42000,135000,2,0,67500,1,0,13500,67500,54000
01SCS19E100011,AR.CPT-SC009,20ARSC0274,L,1,94250,145000,2,0,29000,1,0,29000,116000,87000
01SCS19E100011,BSC.AR-RJ0019,00ARRJ0113,L,1,94500,135000,2,0,40500,1,0,18900,94500,75600
01SCS19E100011,BSC.AR-SD0017,00ARSD0122,NON,1,45000,150000,2,0,45000,1,0,21000,105000,84000
01SCS19E100011,BSC.AR-SD0026,00ARSD0154,L,1,44500,159000,2,0,47700,1,0,22260,111300,89040
01SCS19E100012,AR.BPH-RH033,20ARRH0811,L,1,220350,339000,2,0,169500,1,0,42375,169500,127125
01SCS19E100013,BSC.AR-RH0017,00ARRH0075,M,1,120000,315000,2,0,94500,1,0,44100,220500,176400
01SCS19E100014,ESH.AR-SD0015,00ARSD0090,M,1,106400,350000,2,0,105000,1,0,49000,245000,196000
01SCS19E100015,BSC.AR-SC0009,00ARSC0054,L,1,125000,315000,2,0,94500,1,0,44100,220500,176400
01SCS19E100016,AR.PUB-SE030,20ARSE0115,S,1,224250,345000,2,0,69000,1,0,69000,276000,207000
01SCS19E100017,AR.PCT-RE001,20ARRE0608,L,1,81250,125000,2,0,62500,1,0,15625,62500,46875
01SCS19E100017,AR.PCT-RE010,20ARRE1431,M,1,81250,125000,2,0,62500,1,0,15625,62500,46875
01SCS19E100017,ESH.AR-SB0027,00ARSB0161,L,1,44000,135000,2,0,40500,1,0,18900,94500,75600
01SCS19E100018,ESH.AR-QJ0007,00ARQJ0029,S,1,100000,310000,2,0,150000,1,0,32000,160000,128000
01SCS19E100018,ESH.AR-RB0030,00ARRB0163,32,1,130000,350000,2,0,175000,1,0,35000,175000,140000
01SCS19E100019,AR.CLK-RH001,20ARRH0736,ALL,1,91000,140000,2,0,28000,1,0,28000,112000,84000
01SCS19E100019,AR.TUC-SD022,20ARSD0507,L,1,94250,145000,2,0,29000,1,0,29000,116000,87000
01SCS19E100020,ESH.AR-SA0013,00ARSA0097,S,1,44000,135000,2,0,40500,1,0,18900,94500,75600
01SCS19E100021,ESH.AR-SD0009,00ARSD0067,L,1,44500,135000,2,0,40500,1,0,18900,94500,75600
01SCS19E100022,AR.FHL-SC002,20ARSC0332,L,1,91000,140000,2,0,28000,1,0,28000,112000,84000
01SCS19E100022,AR.MKV-PL009,20ARPL0425,L,1,91000,140000,2,0,70000,1,0,17500,70000,52500
01SCS19E100023,BSC.AR-RJ0029,00ARRJ0169,L,1,120000,315000,2,0,94500,1,0,44100,220500,176400
01SCS19E100024,AR.REC-SD029,20ARSD0076,ALL,1,32500,50000,2,0,15000,1,0,8750,35000,26250
01SCS19E100024,ESH.AR-RJ0023,00ARRJ0218,NON,1,18000,75000,2,0,22500,1,0,10500,52500,42000
01SCS19E100025,ESH.AR-PL0035,00ARPL0234,ALL,1,39800,140000,2,0,90000,1,0,10000,50000,40000
01SCS19E100025,ESH.AR-RJ0005,00ARRJ0029,L,1,94500,135000,2,0,40500,1,0,18900,94500,75600
01SCS19E100025,ESH.AR-SC0010,00ARSC0082,L,1,44500,135000,2,0,40500,1,0,18900,94500,75600
01SCS19E100026,AR.TUC-SD002,20ARSD0147,XL,1,204750,315000,2,0,63000,1,0,63000,252000,189000
01SCS19E100027,AR.GTW-SA003,20ARSA0303,S,1,94250,145000,2,0,43500,1,0,25375,101500,76125
01SCS19E100027,AR.PUB-SE003,20ARSE0009,S,1,97500,150000,2,0,30000,1,0,30000,120000,90000
01SCS19E100028,AR.PCT-RE003,20ARRE0614,L,1,81250,125000,2,0,62500,1,0,15625,62500,46875
01SCS19E100028,AR.PCT-RE013,20ARRE1440,M,1,81250,125000,2,0,62500,1,0,15625,62500,46875
01SCS19E100029,AR.BPH-RB005,20ARRB0441,S,1,182000,280000,2,0,140000,1,0,35000,140000,105000
01SCS19E100029,ESH.AR-RF0007,00ARRF0043,M,1,150000,395000,2,0,220000,1,0,35000,175000,140000
01SCS19E100030,BSC.AR-SD0027,00ARSD0157,M,1,125000,315000,2,0,94500,1,0,44100,220500,176400
01SCS19E100031,AR.STY-SE008,20ARSE0126,ALL,1,55250,85000,2,0,17000,1,0,17000,68000,51000
01SCS19E100032,AR.SMD-SD005,20ARSD0293,M,1,87750,135000,2,0,27000,1,0,27000,108000,81000
01SCS19E100032,ESH.AR-RD0035,00ARRD0270,S,1,43000,135000,2,0,67500,1,0,13500,67500,54000
01SCS19E100032,ESH.AR-RE0008,00ARRE0029,S,1,42000,135000,2,0,67500,1,0,13500,67500,54000
01SCS19E100033,AR.MPR-SE008,20ARSE0165,S,1,97500,150000,2,0,45000,1,0,26250,105000,78750
01SCS19E100034,BSC.AR-RC0034,00ARRC0235,M,1,120000,360000,2,0,185000,1,0,35000,175000,140000
01SCS19E100034,BSC.AR-SD0048,00ARSD0248,NON,1,45000,135000,2,0,40500,1,0,18900,94500,75600
01SCS19E100034,ESH.AR-SA0012,00ARSA0096,XL,1,44000,135000,2,0,40500,1,0,18900,94500,75600
01SCS19E100035,AR.MKV-SC004,20ARSC0080,L,1,253500,390000,2,0,78000,1,0,78000,312000,234000
01SCS19E100036,AR.MKV-SB009,20ARSB0533,L,1,97500,150000,2,0,30000,1,0,30000,120000,90000
01SCS19E100037,AR.ESB-SC004,20ARSC0422,S,1,94250,145000,2,0,29000,1,0,29000,116000,87000
01SCS19E100038,BSC.AR-RK0005,00ARRK0065,S,1,52000,155000,2,0,46500,1,0,21700,108500,86800
01SCS19E100039,AR.STY-SE003,20ARSE0121,ALL,1,55250,85000,2,0,17000,1,0,17000,68000,51000
01SCS19E100040,AR.PUB-SE018,20ARSE0072,XL,1,159250,245000,2,0,49000,1,0,49000,196000,147000
01SCS19E100041,AR.PUB-SC006,20ARSC0278,L,1,97500,150000,2,0,30000,1,0,30000,120000,90000
01SCS19E100042,THR.AR-RK0003,00ARRK0168,XL,1,332000,415000,2,0,41500,1,0,56025,373500,317475
01SCS19E100043,BSC.AR-SC0004,00ARSC0031,M,1,125000,315000,2,0,94500,1,0,44100,220500,176400
01SCS19E100044,AR.PUB-RH018,20ARRH0276,30,1,211250,325000,2,0,65000,1,0,65000,260000,195000
01SCS19E100044,BSC.AR-SA0018,00ARSA0060,M,1,44000,135000,2,0,40500,1,0,18900,94500,75600
01SCS19E100045,AR.PUB-RJ041,20ARRJ0513,S,1,97500,150000,2,0,30000,1,0,30000,120000,90000
01SCS19E100046,BSC.AR-SD0018,00ARSD0123,NON,1,45000,150000,2,0,45000,1,0,21000,105000,84000
01SCS19E100047,BSC.AR-SC0035,00ARSC0232,S,1,125000,315000,2,0,94500,1,0,44100,220500,176400
01SCS19E100048,BSC.AR-RH0008,00ARRH0051,L,1,110000,350000,2,0,105000,1,0,49000,245000,196000
01SCS19E100049,BSC.AR-SD0041,00ARSD0223,S,1,44500,159000,2,0,47700,1,0,22260,111300,89040
01SCS19E100050,ESH.AR-SD0006,00ARSD0054,M,1,44500,135000,2,0,40500,1,0,18900,94500,75600
01SCS19E100051,BE.RAK-SA025,00BESA0102,M,1,104000,160000,2,0,32000,1,0,32000,128000,96000
01SCS19E100052,AR.MDS-RL004,20ARRL0367,M,1,117000,180000,2,0,36000,1,0,36000,144000,108000
01SCS19E100052,AR.PUB-RG024,20ARRG0128,ALL,1,97500,150000,2,0,30000,1,0,30000,120000,90000
01SCS19E100052,AR.PUB-SD034,20ARSD0341,M,1,97500,150000,2,0,30000,1,0,30000,120000,90000
01SCS19E100052,AR.TUC-SD017,20ARSD0486,M,1,94250,145000,2,0,29000,1,0,29000,116000,87000
01SCS19E100053,BE.RAK-SB036,00BESB0110,M,1,91000,140000,2,0,28000,1,0,28000,112000,84000
01SCS19E100054,ESH.AR-SA0008,00ARSA0085,L,1,113450,350000,2,0,105000,1,0,49000,245000,196000
01SCS19E100055,AR.VLD-RK013,20ARRK0332,ALL,1,84500,130000,2,0,39000,1,0,22750,91000,68250
01SCS19E100056,AR.PUB-SC002,20ARSC0112,ALL,1,48750,75000,2,0,15000,1,0,15000,60000,45000
01SCS19E100056,AR.TUC-SC006,20ARSC0066,32,1,204750,315000,2,0,63000,1,0,63000,252000,189000
01SCS19E100057,AR.MKV-RJ016,20ARRJ0199,ALL,1,117000,180000,2,0,36000,1,0,36000,144000,108000
01SCS19E100057,ARN.AR-SB0001,00ARSB0086,NON,1,107400,179000,2,0,35800,1,0,42960,143200,100240
01SCS19E100058,AR.ESB-SB004,20ARSB0106,L,1,91000,140000,2,0,28000,1,0,28000,112000,84000
01SCS19E100058,BSC.AR-RI0018,00ARRI0068,L,1,94500,135000,2,0,40500,1,0,18900,94500,75600
01SCS19E100059,AR.CPT-RK004,20ARRK0020,ALL,1,77350,119000,2,0,23800,1,0,23800,95200,71400
01SCS19E100059,ESH.AR-RB0028,00ARRB0152,30,1,130000,350000,2,0,175000,1,0,35000,175000,140000
01SCS19E100060,AR.MKV-QH013,20ARQH0218,ALL,1,78000,120000,2,0,60000,1,0,15000,60000,45000
01SCS19E100060,AR.SMD-RL002,20ARRL0266,ALL,1,22750,35000,2,0,7000,1,0,7000,28000,21000
01SCS19E100060,AR.SMD-RL003,20ARRL0267,ALL,1,22750,35000,2,0,7000,1,0,7000,28000,21000
01SCS19E100061,AR.MKV-RE005,20ARRE0842,ALL,1,91000,140000,2,0,70000,1,0,17500,70000,52500
01SCS19E100062,ESH.AR-RJ0001,00ARRJ0013,L,1,94500,135000,2,0,40500,1,0,18900,94500,75600
01SCS19E100063,AR.YD-RL008,20ARRL0024,ALL,1,87750,135000,2,0,67500,1,0,16875,67500,50625
01SCS19E100064,AR.VLD-SA008,20ARSA0186,ALL,1,94250,145000,2,0,43500,1,0,25375,101500,76125
01SCS19E100065,AR.HLW-SC003,20ARSC0125,L,1,208000,320000,2,0,96000,1,0,56000,224000,168000
01SCS19E100066,ESH.AR-RB0021,00ARRB0132,M,1,95000,310000,2,0,150000,1,0,32000,160000,128000
01SCS19E100066,ESH.AR-RD0021,00ARRD0191,S,1,42000,135000,2,0,67500,1,0,13500,67500,54000
01SCS19E100066,ESH.AR-RE0010,00ARRE0078,M,1,42000,135000,2,0,67500,1,0,13500,67500,54000
01SCS19E100066,ESH.AR-SC0019,00ARSC0149,S,1,125000,315000,2,0,94500,1,0,44100,220500,176400
01SCS19E100067,ESH.AR-SD0015,00ARSD0091,L,1,106400,350000,2,0,105000,1,0,49000,245000,196000
01SCS19E100068,AR.PUB-SD030,20ARSD0210,32,1,211250,325000,2,0,65000,1,0,65000,260000,195000
01SCS19E100069,AR.YD-RL001,20ARRL0017,ALL,1,91000,140000,2,0,70000,1,0,17500,70000,52500
01SCS19E100070,AR.ESB-SD015,20ARSD0334,M,1,91000,140000,2,0,28000,1,0,28000,112000,84000
01SCS19E100070,AR.STY-RK002,20ARRK0524,ALL,1,61750,95000,2,0,19000,1,0,19000,76000,57000
01SCS19E100071,ESH.AR-RB0021,00ARRB0131,S,1,95000,310000,2,0,150000,1,0,32000,160000,128000
01SCS19E100071,ESH.AR-RD0028,00ARRD0245,L,1,43000,135000,2,0,67500,1,0,13500,67500,54000
01SCS19E100071,ESH.AR-RE0007,00ARRE0025,S,1,42000,135000,2,0,67500,1,0,13500,67500,54000
01SCS19E100072,BSC.AR-RE0001,00ARRE0039,L,1,42000,135000,2,0,67500,1,0,13500,67500,54000
01SCS19E100072,ESH.AR-RF0020,00ARRF0139,M,1,42000,135000,2,0,67500,1,0,13500,67500,54000
01SCS19E100073,AR.MKV-SB003,20ARSB0315,32,1,165750,255000,2,0,51000,1,0,51000,204000,153000
01SCS19E100074,AR.MKV-SC002,20ARSC0074,30,1,117000,180000,2,0,36000,1,0,36000,144000,108000
01SCS19E100075,ESH.AR-RH0020,00ARRH0110,XL,1,94500,135000,2,0,40500,1,0,18900,94500,75600
01SCS19E100076,AR.YD-SB003,20ARSB0177,ALL,1,78000,120000,2,0,36000,1,0,21000,84000,63000
01SCS19E100077,ESH.AR-PL0015,00ARPL0125,S,1,110000,325000,2,0,165000,1,0,32000,160000,128000
01SCS19E100078,AR.FHL-SC002,20ARSC0332,L,1,91000,140000,2,0,28000,1,0,28000,112000,84000
01SCS19E100078,AR.SMD-SD010,20ARSD0312,32,1,211250,325000,2,0,65000,1,0,65000,260000,195000
01SCS19E100079,AR.CPT-SD011,20ARSD0455,L,1,94250,145000,2,0,29000,1,0,29000,116000,87000
01SCS19E100080,AR.ESB-SD009,20ARSD0180,M,1,91000,140000,2,0,28000,1,0,28000,112000,84000
01SCS19E100080,AR.PUB-SB008,20ARSC0116,L,1,97500,150000,2,0,30000,1,0,30000,120000,90000
01SCS19E100081,AR.MPR-SE002,20ARSE0141,S,1,97500,150000,2,0,45000,1,0,26250,105000,78750
01SCS19E100082,BSC.AR-SC0029,00ARSC0200,M,1,125000,315000,2,0,94500,1,0,44100,220500,176400
01SCS19E100083,ARN.AR-SB0002,00ARSB0087,NON,1,149400,249000,2,0,49800,1,0,59760,199200,139440
01SCS19E100084,AR.CPT-SD001,20ARSD0137,ALL,1,94250,145000,2,0,29000,1,0,29000,116000,87000
01SCS19E100084,AR.MDS-RL005,20ARRL0371,M,1,117000,180000,2,0,36000,1,0,36000,144000,108000
01SCS19E100085,AR.PUB-RL007,20ARRL0134,XL,1,97500,150000,2,0,30000,1,0,30000,120000,90000
01SCS19E100086,ESH.AR-SD0005,00ARSD0052,XL,1,44000,135000,2,0,40500,1,0,18900,94500,75600
01SCS19E100087,AR.MPR-SE011,20ARSE0178,M,1,97500,150000,2,0,45000,1,0,26250,105000,78750
01SCS19E100087,BSC.AR-SA0001,00ARSA0001,S,1,120000,315000,2,0,94500,1,0,44100,220500,176400
01SCS19E100088,AR.ESB-RL011,20ARRL0462,ALL,1,91000,140000,2,0,42000,1,0,24500,98000,73500
01SCS19E100089,AR.SMD-SD013,20ARSD0571,L,1,87750,135000,2,0,27000,1,0,27000,108000,81000
01SCS19E100090,AR.MPR-SE020,20ARSE0204,ALL,1,97500,150000,2,0,45000,1,0,26250,105000,78750
01SCS19E100091,AR.ESB-RE036,20ARRE0795,M,1,65000,100000,2,0,50000,1,0,12500,50000,37500
01SCS19E100091,AR.PCT-RE003,20ARRE0614,L,1,81250,125000,2,0,62500,1,0,15625,62500,46875
01SCS19E100091,AR.TUC-RK037,20ARRK0162,M,1,94250,145000,2,0,29000,1,0,29000,116000,87000
01SCS19E100091,AR.TUC-SD021,20ARSD0503,L,1,94250,145000,2,0,29000,1,0,29000,116000,87000
01SCS19E100092,AR.ASH-RK004,20ARRK0517,L,1,195000,300000,2,0,90000,1,0,52500,210000,157500
01SCS19E100092,BE.RAK-RX096,00BERX0096,ALL,1,97500,150000,2,0,30000,1,0,30000,120000,90000
01SCS19E100092,BE.RAK-SA005,00BESA0020,XL,1,204750,315000,2,0,63000,1,0,63000,252000,189000
01SCS19E100093,AR.ESB-RH008,20ARRH0197,ALL,1,91000,140000,2,0,42000,1,0,24500,98000,73500
01SCS19E100093,BE.RAK-SA023,00BESA0092,M,1,91000,140000,2,0,28000,1,0,28000,112000,84000
01SCS19E100094,AR.PUB-SE028,20ARSE0107,S,1,204750,315000,2,0,63000,1,0,63000,252000,189000
01SCS19E100095,AR.HLW-SA017,20ARSD0247,XXL,1,100750,155000,2,0,46500,1,0,27125,108500,81375
01SCS19E100096,ESH.AR-QE0004,00ARQE0023,ALL,1,39800,140000,2,0,90000,1,0,10000,50000,40000
01SCS19E100097,AR.SMD-RI006,20ARRI0327,M,1,87750,135000,2,0,40500,1,0,23625,94500,70875
01SCS19E100098,AR.MDS-RF010,20ARRF0110,S,1,344500,530000,2,0,106000,1,0,106000,424000,318000
01SCS19E100098,AR.MPR-SB016,20ARSB0294,S,1,230750,355000,2,0,71000,1,0,71000,284000,213000
01SCS19E100098,AR.MPR-SE019,20ARSE0203,ALL,1,97500,150000,2,0,45000,1,0,26250,105000,78750
01SCS19E100098,AR.MPR-SE021,20ARSE0205,ALL,1,97500,150000,2,0,45000,1,0,26250,105000,78750
01SCS19E100098,BSC.AR-SD0030,00ARSD0174,S,1,44500,159000,2,0,47700,1,0,22260,111300,89040
01SCS19E100099,AR.PUB-SE028,20ARSE0108,M,1,204750,315000,2,0,63000,1,0,63000,252000,189000
01SCS19E100100,ESH.AR-SD0021,00ARSD0164,S,1,125000,315000,2,0,94500,1,0,44100,220500,176400
01SCS19E100101,BSC.AR-RK0026,00ARRK0241,34,1,262500,375000,2,0,112500,1,0,52500,262500,210000
01SCS19E100102,AR.MPR-SB016,20ARSB0296,L,1,230750,355000,2,0,71000,1,0,71000,284000,213000
01SCS19E100103,BSC.AR-SD0042,00ARSD0227,S,1,44500,159000,2,0,47700,1,0,22260,111300,89040
01SCS19E100104,AR.ASH-RK004,20ARRK0515,S,1,195000,300000,2,0,90000,1,0,52500,210000,157500
01SCS19E100105,BSC.AR-QH0002,00ARQH0006,ALL,1,37800,140000,2,0,90000,1,0,10000,50000,40000
01SCS19E100106,AR.PUB-SC009,20ARSC0291,XL,1,97500,150000,2,0,30000,1,0,30000,120000,90000
01SCS19E100106,BSC.AR-RE0001,00ARRE0039,L,1,42000,135000,2,0,67500,1,0,13500,67500,54000
01SCS19E100106,BSC.AR-SD0056,00ARSD0290,M,1,125000,315000,2,0,94500,1,0,44100,220500,176400
01SCS19E100106,ESH.AR-RE0005,00ARRE0019,L,1,42000,135000,2,0,67500,1,0,13500,67500,54000
01SCS19E100107,AR.PUB-SE029,20ARSE0111,S,1,224250,345000,2,0,69000,1,0,69000,276000,207000
01SCS19E100108,ESH.AR-RD0001,00ARRD0020,32,1,110000,350000,2,0,175000,1,0,35000,175000,140000
01SCS19E100109,AR.SMD-RH009,20ARRH0759,M,1,87750,135000,2,0,40500,1,0,23625,94500,70875
01SCS19E100109,BSC.AR-SB0018,00ARSB0141,M,1,44500,135000,2,0,40500,1,0,18900,94500,75600
01SCS19E100110,ESH.AR-RD0020,00ARRD0187,S,1,43000,150000,2,0,82500,1,0,13500,67500,54000
01SCS19E100110,ESH.AR-RF0020,00ARRF0139,M,1,42000,135000,2,0,67500,1,0,13500,67500,54000
01SCS19E100111,ESH.AR-QH0026,00ARQH0137,ALL,1,39700,140000,2,0,90000,1,0,10000,50000,40000
01SCS19E100112,ESH.AR-SB0024,00ARSB0156,NON,1,35300,120000,2,0,36000,1,0,16800,84000,67200
01SCS19E100113,AR.ESB-SA002,20ARSA0207,S,1,204750,315000,2,0,63000,1,0,63000,252000,189000
01SCS19E100114,AR.CPT-SD006,20ARSD0435,L,1,200850,309000,2,0,61800,1,0,61800,247200,185400
01SCS19E100114,AR.MKV-SC024,20ARSC0242,ALL,1,91000,140000,2,0,28000,1,0,28000,112000,84000
01SCS19E100115,AR.RDC-RK010,20ARRK0494,L,1,97500,150000,2,0,30000,1,0,30000,120000,90000
01SCS19E100115,AR.RDC-SB002,20ARSB0168,ALL,1,94250,145000,2,0,29000,1,0,29000,116000,87000
01SCS19E100115,AR.STY-SB001,20ARSB0488,ALL,1,61750,95000,2,0,19000,1,0,19000,76000,57000
01SCS19E100115,ESH.AR-RJ0014,00ARRJ0181,L,1,44500,135000,2,0,40500,1,0,18900,94500,75600
01SCS19E100116,THR.AR-RB0003,00ARRB0185,L,1,1030000,1030000,2,0,103000,1,0,139050,927000,787950
01SCS19E100117,ARN.AR-SD0001,00ARSD0220,M,1,44500,150000,0,0,0,0,0,45000,150000,105000
01SCS19E100118,ARN.AR-RK0005,00ARRK0235,30,1,110000,350000,2,0,70000,1,0,84000,280000,196000
01SCS19E100119,ESH.AR-SD0029,00ARSD0278,NON,1,58000,175000,2,0,52500,1,0,24500,122500,98000
01SCS19E100120,ESH.AR-SD0009,00ARSD0065,S,1,44500,135000,2,0,40500,1,0,18900,94500,75600
01SCS19E100121,ESH.AR-SC0006,00ARSC0049,XL,1,125000,350000,2,0,105000,1,0,49000,245000,196000
01SCS19E110001,BSC.AR-RH0018,00ARRH0078,S,1,120000,315000,2,0,94500,1,0,44100,220500,176400
01SCS19E110002,BSC.AR-SA0021,00ARSA0106,M,1,44000,135000,2,0,40500,1,0,18900,94500,75600
01SCS19E110002,ESH.AR-RE0002,00ARRE0006,M,1,42000,135000,2,0,67500,1,0,13500,67500,54000
01SCS19E110002,ESH.AR-RE0013,00ARRE0090,M,1,42000,135000,2,0,67500,1,0,13500,67500,54000
01SCS19E110002,ESH.AR-RK0006,00ARRK0026,M,1,43000,135000,2,0,40500,1,0,18900,94500,75600
01SCS19E110003,AR.MPR-SB001,20ARSB0236,L,1,230750,355000,2,0,71000,1,0,71000,284000,213000
01SCS19E110004,AR.PUB-RJ041,20ARRJ0515,L,1,97500,150000,2,0,30000,1,0,30000,120000,90000
01SCS19E110004,AR.TUC-SB020,20ARSB0484,ALL,1,87750,135000,2,0,27000,1,0,27000,108000,81000
01SCS19E110005,AR.STY-SB001,20ARSB0488,ALL,1,61750,95000,2,0,19000,1,0,19000,76000,57000
01SCS19E110005,AR.STY-SC002,20ARSC0201,ALL,1,77350,119000,2,0,23800,1,0,23800,95200,71400
01SCS19E110006,BSC.AR-RL0019,00ARRL0115,L,1,125000,315000,2,0,94500,1,0,44100,220500,176400
01SCS19E110006,BSC.AR-SC0015,00ARSC0101,M,1,44000,159000,2,0,47700,1,0,22260,111300,89040
01SCS19E110007,AR.MPR-SE003,20ARSE0145,S,1,97500,150000,2,0,45000,1,0,26250,105000,78750
01SCS19E110007,BSC.AR-RI0018,00ARRI0067,M,1,94500,135000,2,0,40500,1,0,18900,94500,75600
01SCS19E110008,AR.STY-SE002,20ARSE0120,ALL,1,55250,85000,2,0,17000,1,0,17000,68000,51000
01SCS19E110009,BSC.AR-RJ0031,00ARRJ0203,L,1,220500,315000,2,0,94500,1,0,44100,220500,176400
01SCS19E110010,DKS.AR-SE0009,00ARSE0162,32,1,417272,696000,2,0,69600,1,0,93960,626400,532440
01SCS19E110011,AR.STY-SB010,20ARSB0497,ALL,1,51350,79000,2,0,15800,1,0,15800,63200,47400
01SCS19E110012,ESH.AR-RC0005,00ARRC0067,L,1,95000,310000,2,0,150000,1,0,32000,160000,128000
01SCS19E110013,AR.BPH-RB015,20ARRB0481,M,1,226850,349000,2,0,174500,1,0,43625,174500,130875
01SCS19E110013,AR.STY-SB012,20ARSB0499,ALL,1,51350,79000,2,0,15800,1,0,15800,63200,47400
01SCS19E110014,AR.MKV-SB003,20ARSB0315,32,1,165750,255000,2,0,51000,1,0,51000,204000,153000
01SCS19E110015,DKS.AR-SE0009,00ARSE0162,32,1,417272,696000,2,0,69600,1,0,93960,626400,532440
01SCS19E110016,AR.MKV-RJ016,20ARRJ0199,ALL,1,117000,180000,2,0,36000,1,0,36000,144000,108000
01SCS19E110017,AR.MKV-RC001,20ARRC0202,S,1,214500,330000,2,0,66000,1,0,66000,264000,198000
01SCS19E110017,ESH.AR-RF0007,00ARRF0043,M,1,150000,395000,2,0,220000,1,0,35000,175000,140000
01SCS19E110018,ESH.AR-SD0014,00ARSD0086,32,1,145000,375000,2,0,112500,1,0,52500,262500,210000
01SCS19E110019,AR.STY-SA006,20ARSA0065,ALL,1,61750,95000,2,0,19000,1,0,19000,76000,57000
01SCS19E110020,ESH.AR-SC0021,00ARSC0157,S,1,44000,135000,2,0,40500,1,0,18900,94500,75600
01SCS19E110021,ESH.AR-SB0021,00ARSB0122,XL,1,44500,135000,2,0,40500,1,0,18900,94500,75600
01SCS19E110022,BSC.AR-SC0036,00ARSC0240,28,1,135000,375000,2,0,112500,1,0,52500,262500,210000
01SCS19E110022,BSC.AR-SD0043,00ARSD0231,S,1,44500,159000,2,0,47700,1,0,22260,111300,89040
01SCS19E110023,BSC.AR-RK0002,00ARRK0055,L,1,94500,135000,2,0,40500,1,0,18900,94500,75600
01SCS19E110024,BSC.AR-SD0026,00ARSD0152,S,1,44500,159000,2,0,47700,1,0,22260,111300,89040
01SCS19E110025,DKS.AR-SE0008,00ARSE0156,28,1,41727,696000,2,0,69600,1,0,93960,626400,532440
01SCS19E110026,ESH.AR-RD0028,00ARRD0245,L,1,43000,135000,2,0,67500,1,0,13500,67500,54000
01SCS19E110026,ESH.AR-RE0013,00ARRE0090,M,1,42000,135000,2,0,67500,1,0,13500,67500,54000
01SCS19E110027,ESH.AR-QK0012,00ARQK0073,L,1,100000,310000,2,0,150000,1,0,32000,160000,128000
01SCS19E110028,BSC.AR-SC0017,00ARSC0116,S,1,44500,135000,2,0,40500,1,0,18900,94500,75600
01SCS19E110029,AR.PUB-SB011,20ARSB0016,30,1,211250,325000,2,0,65000,1,0,65000,260000,195000
01SCS19E110029,AR.SMD-SD010,20ARSD0312,32,1,211250,325000,2,0,65000,1,0,65000,260000,195000
01SCS19E110030,ESH.AR-SA0004,00ARSA0055,S,1,44500,135000,2,0,40500,1,0,18900,94500,75600
01SCS19E110031,BSC.AR-SC0005,00ARSC0037,XL,1,44500,159000,2,0,47700,1,0,22260,111300,89040
01SCS19E110031,ESH.AR-SC0010,00ARSC0083,XL,1,44500,135000,2,0,40500,1,0,18900,94500,75600
01SCS19E110032,AR.ESB-SC018,20ARSC0464,S,1,91000,140000,2,0,28000,1,0,28000,112000,84000
01SCS19E110032,AR.PUB-SD018,20ARSD0187,ALL,1,97500,150000,2,0,30000,1,0,30000,120000,90000
01SCS19E110033,AR.YD-RL014,20ARRL0035,L,1,195000,300000,2,0,150000,1,0,37500,150000,112500
01SCS19E110034,AR.STY-SE004,20ARSE0122,ALL,1,55250,85000,2,0,17000,1,0,17000,68000,51000
01SCS19E110034,BSC.AR-RJ0011,00ARRJ0081,L,1,44500,135000,2,0,40500,1,0,18900,94500,75600
01SCS19E110034,ESH.AR-SD0045,00ARSD0406,L,1,125000,315000,2,0,94500,1,0,44100,220500,176400
01SCS19E110035,AR.ESB-RE016,20ARRE0383,L,1,94250,145000,2,0,72500,1,0,18125,72500,54375
01SCS19E110035,AR.MKV-SB010,20ARSB0536,M,1,97500,150000,2,0,30000,1,0,30000,120000,90000
01SCS19E110036,BSC.AR-RF0005,00ARRF0070,M,1,85000,240000,2,0,115000,1,0,25000,125000,100000
01SCS19E110036,ESH.AR-QJ0007,00ARQJ0030,M,1,100000,310000,2,0,150000,1,0,32000,160000,128000
01SCS19E110037,AR.MKV-QB012,20ARSD0415,36,1,214500,330000,2,0,165000,1,0,41250,165000,123750
01SCS19E110037,ESH.AR-SB0027,00ARSB0162,XL,1,44000,135000,2,0,40500,1,0,18900,94500,75600
01SCS19E110038,AR.MPR-SE002,20ARSE0141,S,1,97500,150000,2,0,45000,1,0,26250,105000,78750
01SCS19E110038,AR.TUC-SD017,20ARSD0486,M,1,94250,145000,2,0,29000,1,0,29000,116000,87000
01SCS19E110038,BSC.AR-RJ0016,00ARRJ0101,L,1,94500,135000,2,0,40500,1,0,18900,94500,75600
01SCS19E110038,BSC.AR-SC0014,00ARSC0096,S,1,44000,159000,2,0,47700,1,0,22260,111300,89040
01SCS19E110038,ESH.AR-RI0007,00ARRI0096,L,1,94500,135000,2,0,40500,1,0,18900,94500,75600
01SCS19E110039,BSC.AR-SD0047,00ARSD0247,NON,1,68000,220000,2,0,66000,1,0,30800,154000,123200
01SCS19E110040,AR.MDG-SC005,20ARSC0453,ALL,1,97500,150000,2,0,45000,1,0,26250,105000,78750
01SCS19E110041,ESH.AR-SB0022,00ARSB0123,S,1,44000,135000,2,0,40500,1,0,18900,94500,75600
01SCS19E110042,BSC.AR-RL0026,00ARRL0171,M,1,94500,135000,2,0,40500,1,0,18900,94500,75600
01SCS19E110043,BSC.AR-SD0016,00ARSD0118,S,1,122000,375000,2,0,112500,1,0,52500,262500,210000
01SCS19E110044,BSC.AR-SD0044,00ARSD0235,S,1,44500,159000,2,0,47700,1,0,22260,111300,89040
01SCS19E110045,BSC.AR-SC0012,00ARSC0072,S,1,44000,159000,2,0,47700,1,0,22260,111300,89040
01SCS19E110045,BSC.AR-SC0033,00ARSC0225,M,1,125000,315000,2,0,94500,1,0,44100,220500,176400
01SCS19E110046,AR.ESB-QE010,20ARQE0402,L,1,87750,135000,2,0,67500,1,0,16875,67500,50625
01SCS19E110046,AR.PCT-RE001,20ARRE0608,L,1,81250,125000,2,0,62500,1,0,15625,62500,46875
01SCS19E110047,ESH.AR-RF0007,00ARRF0044,L,1,150000,395000,2,0,220000,1,0,35000,175000,140000
01SCS19E110048,AR.MPR-SB003,20ARSB0244,L,1,230750,355000,2,0,71000,1,0,71000,284000,213000
01SCS19E110048,AR.PUB-SB001,20ARSB0005,ALL,1,97500,150000,2,0,30000,1,0,30000,120000,90000
01SCS19E110049,AR.CPT-RK010,20ARRK0032,ALL,1,48750,75000,2,0,15000,1,0,15000,60000,45000
01SCS19E110050,BE.RAK-SC004,00BESC0007,L,1,256750,395000,2,0,79000,1,0,79000,316000,237000
01SCS19E110051,AR.SMD-QD004,20ARQD0097,L,1,84500,130000,2,0,39000,1,0,22750,91000,68250
01SCS19E110052,AR.CPT-SD006,20ARSD0435,L,1,200850,309000,2,0,61800,1,0,61800,247200,185400
01SCS19E110053,BSC.AR-SD0011,00ARSD0104,NON,1,18000,75000,2,0,22500,1,0,10500,52500,42000
01SCS19E110053,BSC.AR-SD0014,00ARSD0111,M,1,122000,375000,2,0,112500,1,0,52500,262500,210000
01SCS19E110054,AR.MKV-SB010,20ARSB0537,L,1,97500,150000,2,0,30000,1,0,30000,120000,90000
01SCS19E110054,AR.SMD-RL002,20ARRL0266,ALL,1,22750,35000,2,0,7000,1,0,7000,28000,21000
01SCS19E110054,ESH.AR-SD0022,00ARSD0168,NON,1,43000,120000,2,0,36000,1,0,16800,84000,67200
01SCS19E110055,AR.PUB-SC004,20ARSC0114,ALL,1,48750,75000,2,0,15000,1,0,15000,60000,45000
01SCS19E110055,ESH.AR-SA0006,00ARSA0073,L,1,44500,135000,2,0,40500,1,0,18900,94500,75600
01SCS19E110056,ESH.AR-RC0040,00ARRC0228,L,1,42000,135000,2,0,67500,1,0,13500,67500,54000
01SCS19E110056,ESH.AR-RE0010,00ARRE0079,L,1,42000,135000,2,0,67500,1,0,13500,67500,54000
01SCS19E110057,BSC.AR-RI0017,00ARRI0063,M,1,43000,135000,2,0,40500,1,0,18900,94500,75600
01SCS19E110058,BSC.AR-SC0015,00ARSC0100,S,1,44000,159000,2,0,47700,1,0,22260,111300,89040
01SCS19E110059,AR.PUB-SE030,20ARSE0117,L,1,224250,345000,2,0,69000,1,0,69000,276000,207000
01SCS19E110060,BSC.AR-PI0025,00ARPI0025,ALL,1,43334,130000,2,0,80000,1,0,10000,50000,40000
01SCS19E110060,ESH.AR-RB0007,00ARRB0052,36,1,90000,265000,2,0,90000,1,0,35000,175000,140000
01SCS19E110060,ESH.AR-RD0020,00ARRD0188,M,1,43000,150000,2,0,82500,1,0,13500,67500,54000
01SCS19E110060,ESH.AR-RE0013,00ARRE0090,M,1,42000,135000,2,0,67500,1,0,13500,67500,54000
01SCS19E110061,AR.MKV-RE009,20ARRE0850,30,1,117000,180000,2,0,90000,1,0,22500,90000,67500
01SCS19E110061,BSC.AR-RH0008,00ARRH0051,L,1,110000,350000,2,0,105000,1,0,49000,245000,196000
01SCS19E110061,ESH.AR-RF0007,00ARRF0043,M,1,150000,395000,2,0,220000,1,0,35000,175000,140000
01SCS19E110062,ESH.AR-QL0004,00ARQL0019,M,1,42000,135000,2,0,67500,1,0,13500,67500,54000
01SCS19E110062,ESH.AR-RD0021,00ARRD0191,S,1,42000,135000,2,0,67500,1,0,13500,67500,54000
01SCS19E110063,AR.ESB-RB014,20ARRB0372,ALL,1,91000,140000,2,0,42000,1,0,24500,98000,73500
01SCS19E110063,ESH.AR-SD0018,00ARSD0136,S,1,125000,315000,2,0,94500,1,0,44100,220500,176400
01SCS19E110064,AR.ESB-SC001,20ARSC0306,L,1,204750,315000,2,0,63000,1,0,63000,252000,189000
01SCS19E110065,AR.REC-RA005,20ARRA0251,M,1,107250,165000,2,0,49500,1,0,28875,115500,86625
01SCS19E110065,BSC.AR-SD0041,00ARSD0224,M,1,44500,159000,2,0,47700,1,0,22260,111300,89040
01SCS19E110065,ESH.AR-SD0007,00ARSD0058,M,1,44500,135000,2,0,40500,1,0,18900,94500,75600
01SCS19E110066,AR.CPS-SC003,20ARSC0003,ALL,1,130000,200000,2,0,60000,1,0,35000,140000,105000
01SCS19E110066,AR.CPS-SC004,20ARSC0004,ALL,1,130000,200000,2,0,60000,1,0,35000,140000,105000
01SCS19E110067,AR.YD-RL018,20ARRL0050,S,1,91000,140000,2,0,70000,1,0,17500,70000,52500
01SCS19E110068,ESH.AR-RI0018,00ARRI0146,NON,1,39000,140000,2,0,42000,1,0,19600,98000,78400
01SCS19E110069,BSC.AR-SC0028,00ARSC0196,M,1,125000,315000,2,0,94500,1,0,44100,220500,176400
01SCS19E110070,AR.SMD-QD002,20ARQD0027,M,1,84500,130000,2,0,39000,1,0,22750,91000,68250
01SCS19E110071,ESH.AR-RJ0007,00ARRJ0036,M,1,44500,135000,2,0,40500,1,0,18900,94500,75600
01SCS19E110072,AR.ESB-SB004,20ARSB0107,XL,1,91000,140000,2,0,28000,1,0,28000,112000,84000
01SCS19E110073,AR.SMD-RH004,20ARRH0416,M,1,87750,135000,2,0,40500,1,0,23625,94500,70875
01SCS19E110073,BSC.AR-SD0004,00ARSD0013,S,1,44000,159000,2,0,47700,1,0,22260,111300,89040
01SCS19E110074,AR.VCS-SC010,20ARSC0410,L,1,214500,330000,2,0,99000,1,0,57750,231000,173250
01SCS19E110075,BSC.AR-RH0018,00ARRH0078,S,1,120000,315000,2,0,94500,1,0,44100,220500,176400
01SCS19E110076,AR.PUB-SE021,20ARSE0080,M,1,159250,245000,2,0,49000,1,0,49000,196000,147000
01SCS19E110076,AR.REC-SD002,20ARSD0005,S,1,120250,185000,2,0,55500,1,0,32375,129500,97125
01SCS19E110076,ESH.AR-SC0003,00ARSC0009,S,1,125000,350000,2,0,105000,1,0,49000,245000,196000
01SCS19E110077,AR.MDS-RL005,20ARRL0371,M,1,117000,180000,2,0,36000,1,0,36000,144000,108000
01SCS19E110078,AR.MPR-SE016,20ARSE0197,S,1,243750,375000,2,0,75000,1,0,75000,300000,225000
01SCS19E110079,ESH.AR-RK0018,00ARRK0194,NON,1,105000,150000,2,0,45000,1,0,21000,105000,84000
01SCS19E110080,AR.MDS-QL015,20ARQL0066,S,1,195000,300000,2,0,60000,1,0,60000,240000,180000
01SCS19E110081,AR.ESB-QE013,20ARQE0411,L,1,97500,150000,2,0,75000,1,0,18750,75000,56250
01SCS19E110082,AR.PUB-RL028,20ARRL0436,ALL,1,97500,150000,2,0,30000,1,0,30000,120000,90000
01SCS19E110083,BSC.AR-SD0016,00ARSD0120,L,1,122000,375000,2,0,112500,1,0,52500,262500,210000
01SCS19E110084,AR.PUB-SE012,20ARSE0046,M,1,97500,150000,2,0,30000,1,0,30000,120000,90000
01SCS19E110084,ESH.AR-QI0012,00ARQI0072,ALL,1,37800,140000,2,0,90000,1,0,10000,50000,40000
01SCS19E110085,ESH.AR-RD0001,00ARRD0021,34,1,110000,350000,2,0,175000,1,0,35000,175000,140000
01SCS19E110086,ESH.AR-QL0004,00ARQL0019,M,1,42000,135000,2,0,67500,1,0,13500,67500,54000
01SCS19E110086,ESH.AR-RE0010,00ARRE0079,L,1,42000,135000,2,0,67500,1,0,13500,67500,54000
01SCS19E110087,AR.FHL-SC003,20ARSC0335,M,1,91000,140000,2,0,28000,1,0,28000,112000,84000
01SCS19E110088,ESH.AR-RE0002,00ARRE0005,S,1,42000,135000,2,0,67500,1,0,13500,67500,54000
01SCS19E110088,ESH.AR-RE0008,00ARRE0029,S,1,42000,135000,2,0,67500,1,0,13500,67500,54000
01SCS19E110089,ESH.AR-SC0001,00ARSC0003,L,1,125000,315000,2,0,94500,1,0,44100,220500,176400
01SCS19E110090,AR.TUC-SD006,20ARSD0163,XL,1,94250,145000,2,0,29000,1,0,29000,116000,87000
01SCS19E110091,BSC.AR-SA0008,00ARSA0034,NON,1,47500,140000,2,0,42000,1,0,19600,98000,78400
01SCS19E110092,DKS.AR-SE0011,00ARSE0171,30,1,417272,696000,2,0,69600,1,0,93960,626400,532440
01SCS19E110093,BSC.AR-SC0029,00ARSC0201,L,1,125000,315000,2,0,94500,1,0,44100,220500,176400
01SCS19E110094,AR.PUB-SE002,20ARSE0008,XL,1,97500,150000,2,0,30000,1,0,30000,120000,90000
01SCS19E110095,ESH.AR-RC0040,00ARRC0228,L,1,42000,135000,2,0,67500,1,0,13500,67500,54000
01SCS19E110095,ESH.AR-RF0020,00ARRF0139,M,1,42000,135000,2,0,67500,1,0,13500,67500,54000
01SCS19E110096,BSC.AR-SB0007,00ARSB0074,S,1,44500,135000,2,0,40500,1,0,18900,94500,75600
01SCS19E110096,ESH.AR-RD0035,00ARRD0271,M,1,43000,135000,2,0,67500,1,0,13500,67500,54000
01SCS19E110096,ESH.AR-RE0004,00ARRE0013,S,1,42000,135000,2,0,67500,1,0,13500,67500,54000
01SCS19E110097,AR.BPH-RB021,20ARSD0355,M,1,214500,330000,2,0,165000,1,0,41250,165000,123750
01SCS19E110097,ESH.AR-SD0019,00ARSD0141,M,1,125000,315000,2,0,94500,1,0,44100,220500,176400
01SCS19E110098,BSC.AR-SC0021,00ARSC0148,NON,1,73000,220000,2,0,66000,1,0,30800,154000,123200
01SCS19E110099,ESH.AR-QE0009,00ARQE0028,ALL,1,45000,140000,2,0,90000,1,0,10000,50000,40000
01SCS19E110100,AR.ESB-SD009,20ARSD0179,S,1,91000,140000,2,0,28000,1,0,28000,112000,84000
01SCS19E110100,AR.RDC-SB002,20ARSB0168,ALL,1,94250,145000,2,0,29000,1,0,29000,116000,87000
01SCS19E110101,AR.YAS-RH009,20ARRH0862,L,1,122850,189000,2,0,37800,1,0,37800,151200,113400
01SCS19E110102,AR.MKV-SC010,20ARSC0103,M,1,97500,150000,2,0,30000,1,0,30000,120000,90000
01SCS19E110103,AR.CPS-RL001,20ARRL0059,ALL,1,130000,200000,2,0,60000,1,0,35000,140000,105000
01SCS19E110104,AR.SMD-RH005,20ARRH0743,M,1,211250,325000,2,0,97500,1,0,56875,227500,170625
01SCS19E110105,AR.SMD-RE005,20ARRE0776,M,1,100750,155000,2,0,46500,1,0,27125,108500,81375
01SCS19E110105,AR.VRS-SB001,20ARSB0180,30,1,324350,499000,2,0,149700,1,0,87325,349300,261975
01SCS19E110106,BSC.AR-SD0039,00ARSD0212,M,1,125000,315000,2,0,94500,1,0,44100,220500,176400
01SCS19E110107,BSC.AR-RJ0002,00ARRJ0005,ALL,1,98000,140000,2,0,42000,1,0,19600,98000,78400
01SCS19E110108,BSC.AR-RC0039,00ARRC0289,L,1,155000,450000,2,0,275000,1,0,35000,175000,140000
01SCS19E110109,ESH.AR-SB0027,00ARSB0159,S,1,44000,135000,2,0,40500,1,0,18900,94500,75600
01SCS19E110109,ESH.AR-SD0027,00ARSD0272,L,1,44000,135000,2,0,40500,1,0,18900,94500,75600
01SCS19E110110,DKS.AR-SE0005,00ARSE0145,36,1,417272,696000,2,0,69600,1,0,93960,626400,532440
01SCS19E110111,AR.STY-RK007,20ARRK0529,ALL,1,61750,95000,2,0,19000,1,0,19000,76000,57000
01SCS19E110111,BSC.AR-RK0018,00ARRK0118,M,1,43000,135000,2,0,40500,1,0,18900,94500,75600
01SCS19E110112,DKS.AR-SE0007,00ARSE0153,32,1,417272,696000,2,0,69600,1,0,93960,626400,532440
01SCS19E110113,BSC.AR-RJ0031,00ARRJ0202,M,1,220500,315000,2,0,94500,1,0,44100,220500,176400
01SCS19E110114,DKS.AR-SE0009,00ARSE0160,28,1,417272,696000,2,0,69600,1,0,93960,626400,532440
01SCS19E110115,AR.CPT-SC004,20ARSC0252,S,1,304850,469000,2,0,93800,1,0,93800,375200,281400
01SCS19E110115,AR.GTW-SB003,20ARSB0156,ALL,1,91000,140000,2,0,42000,1,0,24500,98000,73500
01SCS19E110116,BSC.AR-SC0050,00ARSC0312,S,1,44000,159000,2,0,47700,1,0,22260,111300,89040
01SCS19E110117,AR.STY-RK010,20ARRK0532,ALL,1,61750,95000,2,0,19000,1,0,19000,76000,57000
01SCS19E110118,ESH.AR-RC0029,00ARRC0190,ALL,1,45000,150000,2,0,100000,1,0,10000,50000,40000
01SCS19E110119,ESH.AR-SE0001,00ARSE0003,L,1,44000,135000,2,0,40500,1,0,18900,94500,75600
01SCS19E110120,AR.PUB-SD031,20ARSD0215,32,1,211250,325000,2,0,65000,1,0,65000,260000,195000
01SCS19E110120,AR.PUB-SD031,20ARSD0216,34,1,211250,325000,2,0,65000,1,0,65000,260000,195000
01SCS19E110121,AR.MPR-SB016,20ARSB0295,M,1,230750,355000,2,0,71000,1,0,71000,284000,213000
01SCS19E110122,ARN.AR-SB0001,00ARSB0086,NON,1,107400,179000,2,0,35800,1,0,42960,143200,100240
01SCS19E110122,ESH.AR-QI0003,00ARQI0036,ALL,1,40000,140000,2,0,90000,1,0,10000,50000,40000
01SCS19E110123,BSC.AR-SD0027,00ARSD0157,M,1,125000,315000,2,0,94500,1,0,44100,220500,176400
01SCS19E110124,AR.HMR-SB021,20ARSB0395,28,1,204750,315000,2,0,63000,1,0,63000,252000,189000
01SCS19E110125,ESH.AR-RC0024,00ARRC0180,M,1,42000,135000,2,0,67500,1,0,13500,67500,54000
01SCS19E110125,ESH.AR-RE0002,00ARRE0006,M,1,42000,135000,2,0,67500,1,0,13500,67500,54000
01SCS19E110125,ESH.AR-RE0008,00ARRE0031,L,1,42000,135000,2,0,67500,1,0,13500,67500,54000
01SCS19E110125,ESH.AR-RE0013,00ARRE0091,L,1,42000,135000,2,0,67500,1,0,13500,67500,54000
01SCS19E110125,ESH.AR-SD0004,00ARSD0047,L,1,44500,135000,2,0,40500,1,0,18900,94500,75600
01SCS19E110126,AR.STY-SC005,20ARSC0204,ALL,1,64350,99000,2,0,19800,1,0,19800,79200,59400
01SCS19E110126,BSC.AR-SC0033,00ARSC0226,L,1,125000,315000,2,0,94500,1,0,44100,220500,176400
01SCS19E110127,AR.VLD-SA006,20ARSA0184,ALL,1,100750,155000,2,0,46500,1,0,27125,108500,81375
01SCS19E110127,BSC.AR-RC0039,00ARRC0288,M,1,155000,450000,2,0,275000,1,0,35000,175000,140000
01SCS19E110127,BSC.AR-RF0012,00ARRF0112,XL,1,67000,185000,2,0,117500,1,0,13500,67500,54000
01SCS19E110127,ESH.AR-QL0004,00ARQL0019,M,1,42000,135000,2,0,67500,1,0,13500,67500,54000
01SCS19E110127,ESH.AR-RC0029,00ARRC0190,ALL,1,45000,150000,2,0,100000,1,0,10000,50000,40000
01SCS19E110128,AR.HLW-SC004,20ARSC0127,M,1,195000,300000,2,0,90000,1,0,52500,210000,157500
01SCS19E110128,AR.STY-SE004,20ARSE0122,ALL,1,55250,85000,2,0,17000,1,0,17000,68000,51000
01SCS19E110128,ESH.AR-RD0028,00ARRD0245,L,1,43000,135000,2,0,67500,1,0,13500,67500,54000
01SCS19E110128,ESH.AR-RD0035,00ARRD0271,M,1,43000,135000,2,0,67500,1,0,13500,67500,54000
01SCS19E110129,BSC.AR-SD0015,00ARSD0114,S,1,122000,375000,2,0,112500,1,0,52500,262500,210000
01SCS19E110130,BSC.AR-SD0005,00ARSD0020,XL,1,44500,159000,2,0,47700,1,0,22260,111300,89040
01SCS19E110130,BSC.AR-SD0011,00ARSD0104,NON,1,18000,75000,2,0,22500,1,0,10500,52500,42000
01SCS19E110131,AR.YD-SD003,20ARSD0268,L,1,87750,135000,2,0,67500,1,0,16875,67500,50625
01SCS19E110132,AR.ESB-SC020,20ARSC0469,ALL,1,68250,105000,2,0,31500,1,0,18375,73500,55125
01SCS19E110133,AR.GTW-SB001,20ARSB0149,M,1,94250,145000,2,0,43500,1,0,25375,101500,76125
01SCS19E110134,AR.MKV-RE036,20ARRE1405,S,1,165750,255000,2,0,51000,1,0,51000,204000,153000
01SCS19E110135,ESH.AR-QE0008,00ARQE0027,ALL,1,39800,140000,2,0,90000,1,0,10000,50000,40000
01SCS19E110136,ESH.AR-SC0003,00ARSC0009,S,1,125000,350000,2,0,105000,1,0,49000,245000,196000
01SCS19E110137,BSC.AR-SA0004,00ARSA0019,M,1,125000,315000,2,0,94500,1,0,44100,220500,176400
01SCS19E110138,BSC.AR-SA0021,00ARSA0108,XL,1,44000,135000,2,0,40500,1,0,18900,94500,75600
01SCS19E110138,ESH.AR-QD0038,00ARQD0297,ALL,1,45000,140000,2,0,90000,1,0,10000,50000,40000
01SCS19E110139,BSC.AR-SD0027,00ARSD0157,M,1,125000,315000,2,0,94500,1,0,44100,220500,176400
01SCS19E110140,ESH.AR-SD0019,00ARSD0143,XL,1,125000,315000,2,0,94500,1,0,44100,220500,176400
01SCS19E110141,AR.SMD-RE010,20ARRE1280,XL,1,87750,135000,2,0,40500,1,0,23625,94500,70875
01SCS19E110141,BSC.AR-QG0010,00ARQG0099,ALL,1,80000,240000,2,0,140000,1,0,20000,100000,80000
01SCS19E110142,ESH.AR-RC0024,00ARRC0180,M,1,42000,135000,2,0,67500,1,0,13500,67500,54000
01SCS19E110142,ESH.AR-RC0040,00ARRC0228,L,1,42000,135000,2,0,67500,1,0,13500,67500,54000
01SCS19E110143,AR.MKV-QJ007,20ARQJ0033,32,1,227500,350000,2,0,175000,1,0,43750,175000,131250
01SCS19E110144,AR.MKV-RL001,20ARRL0236,M,1,204750,315000,2,0,63000,1,0,63000,252000,189000
01SCS19E110145,ESH.AR-RH0006,00ARRH0058,NON,1,45000,150000,2,0,45000,1,0,21000,105000,84000
01SCS19E110146,ESH.AR-SA0004,00ARSA0055,S,1,44500,135000,2,0,40500,1,0,18900,94500,75600
01SCS19E110147,ESH.AR-QL0004,00ARQL0019,M,1,42000,135000,2,0,67500,1,0,13500,67500,54000
01SCS19E110147,ESH.AR-RC0024,00ARRC0180,M,1,42000,135000,2,0,67500,1,0,13500,67500,54000
01SCS19E110148,ESH.AR-RC0011,00ARRC0112,L,1,180000,499000,2,0,324000,1,0,35000,175000,140000
01SCS19E110149,AR.STY-SE007,20ARSE0125,ALL,1,55250,85000,2,0,17000,1,0,17000,68000,51000
01SCS19E110149,BSC.AR-SA0022,00ARSA0113,NON,1,47500,140000,2,0,42000,1,0,19600,98000,78400
01SCS19E110150,AR.STY-SB012,20ARSB0499,ALL,1,51350,79000,2,0,15800,1,0,15800,63200,47400
01SCS19E110151,BSC.AR-SD0047,00ARSD0247,NON,1,68000,220000,2,0,66000,1,0,30800,154000,123200
01SCS19E110152,BSC.AR-SC0050,00ARSC0313,M,1,44000,159000,2,0,47700,1,0,22260,111300,89040
01SCS19E110153,AR.VCS-SC005,20ARSC0388,S,1,97500,150000,2,0,45000,1,0,26250,105000,78750
01SCS19E110154,BSC.AR-SC0039,00ARSC0254,M,1,190000,475000,2,0,142500,1,0,66500,332500,266000
01SCS19E110154,BSC.AR-SD0046,00ARSD0244,M,1,44500,159000,2,0,47700,1,0,22260,111300,89040
01SCS19E110155,AR.ESB-SC004,20ARSC0423,M,1,94250,145000,2,0,29000,1,0,29000,116000,87000
01SCS19E110155,AR.HLW-SA017,20ARSA0116,M,1,100750,155000,2,0,46500,1,0,27125,108500,81375
01SCS19E110155,AR.STY-SE007,20ARSE0125,ALL,1,55250,85000,2,0,17000,1,0,17000,68000,51000
01SCS19E110155,AR.TUC-RK039,20ARRK0170,L,1,204750,315000,2,0,63000,1,0,63000,252000,189000
01SCS19E110155,BSC.AR-RH0026,00ARRH0165,32,1,245000,350000,2,0,105000,1,0,49000,245000,196000
01SCS19E110155,BSC.AR-SA0007,00ARSA0032,L,1,94500,135000,2,0,40500,1,0,18900,94500,75600
01SCS19E110155,ESH.AR-SB0033,00ARSB0213,M,1,44500,135000,2,0,40500,1,0,18900,94500,75600
01SCS19E110155,ESH.AR-SD0006,00ARSD0055,L,1,44500,135000,2,0,40500,1,0,18900,94500,75600
01SCS19E110156,ESH.AR-QL0004,00ARQL0020,L,1,42000,135000,2,0,67500,1,0,13500,67500,54000
01SCS19E110156,ESH.AR-RE0019,00ARRE0205,M,1,43000,150000,2,0,82500,1,0,13500,67500,54000
01SCS19E110157,ESH.AR-SB0028,00ARSB0172,M,1,44000,135000,2,0,40500,1,0,18900,94500,75600
01SCS19E110158,AR.MKV-RL007,20ARRL0454,XL,1,107250,165000,2,0,33000,1,0,33000,132000,99000
01SCS19E110158,AR.PUB-SB029,20ARSB0451,XL,1,97500,150000,2,0,30000,1,0,30000,120000,90000
01SCS19E110159,BSC.AR-SD0014,00ARSD0110,S,1,122000,375000,2,0,112500,1,0,52500,262500,210000
01SCS19E110160,AR.SMD-RL002,20ARRL0266,ALL,1,22750,35000,2,0,7000,1,0,7000,28000,21000
01SCS19E110160,BSC.AR-RJ0032,00ARRJ0215,NON,1,18000,75000,2,0,22500,1,0,10500,52500,42000
01SCS19E110161,BE.RAK-SB001,00BESB0003,L,1,217750,335000,2,0,67000,1,0,67000,268000,201000
01SCS19E110162,ESH.AR-RG0004,00ARRG0011,M,1,90000,255000,2,0,76500,1,0,35700,178500,142800
01SCS19E110163,AR.STY-SB012,20ARSB0499,ALL,1,51350,79000,2,0,15800,1,0,15800,63200,47400
01SCS19E110164,ESH.AR-SA0008,00ARSA0083,S,1,113450,350000,2,0,105000,1,0,49000,245000,196000
01SCS19E110165,AR.YD-SC001,20ARSC0017,S,1,195000,300000,2,0,90000,1,0,52500,210000,157500
01SCS19E110166,BSC.AR-SA0017,00ARSA0053,L,1,125000,315000,2,0,94500,1,0,44100,220500,176400
01SCS19E110167,AR.YD-RL009,20ARRL0025,ALL,1,55250,85000,2,0,25500,1,0,14875,59500,44625
01SCS19E110167,BSC.AR-SA0006,00ARSA0029,XL,1,44500,135000,2,0,40500,1,0,18900,94500,75600
01SCS19E110168,AR.MKV-SD002,20ARSD0222,S,1,97500,150000,2,0,30000,1,0,30000,120000,90000
01SCS19E110169,BSC.AR-QG0018,00ARQG0151,M,1,135000,395000,2,0,220000,1,0,35000,175000,140000
01SCS19E110170,AR.CPT-RI006,20ARRI0061,M,1,94250,145000,2,0,29000,1,0,29000,116000,87000
01SCS19E110170,BSC.AR-SC0045,00ARSC0297,NON,1,45000,150000,2,0,45000,1,0,21000,105000,84000
01SCS19E110171,AR.PUB-SE028,20ARSE0109,L,1,204750,315000,2,0,63000,1,0,63000,252000,189000
01SCS19E110172,BSC.AR-SC0035,00ARSC0232,S,1,125000,315000,2,0,94500,1,0,44100,220500,176400
01SCS19E110173,ESH.AR-RJ0028,00ARRJ0236,NON,1,94500,135000,2,0,40500,1,0,18900,94500,75600
01SCS19E110174,BSC.AR-SC0006,00ARSC0038,S,1,44000,135000,2,0,40500,1,0,18900,94500,75600
01SCS19E110175,AR.MPR-SB005,20ARSB0252,L,1,230750,355000,2,0,71000,1,0,71000,284000,213000
01SCS19E110176,AR.PCT-RE013,20ARRE1441,L,1,81250,125000,2,0,62500,1,0,15625,62500,46875
01SCS19E110177,AR.PUB-SA007,20ARSA0321,S,1,97500,150000,2,0,30000,1,0,30000,120000,90000
01SCS19E110178,AR.VCS-SC006,20ARSC0394,L,1,214500,330000,2,0,99000,1,0,57750,231000,173250
01SCS19E110179,BSC.AR-SD0039,00ARSD0211,S,1,125000,315000,2,0,94500,1,0,44100,220500,176400
01SCS19E110180,BSC.AR-RD0001,00ARRD0002,M,1,155,450000,2,0,275000,1,0,35000,175000,140000
01SCS19E110180,ESH.AR-RD0020,00ARRD0188,M,1,43000,150000,2,0,82500,1,0,13500,67500,54000
01SCS19E110180,ESH.AR-RE0019,00ARRE0205,M,1,43000,150000,2,0,82500,1,0,13500,67500,54000
01SCS19E110181,ESH.AR-SD0012,00ARSD0079,34,1,145000,375000,2,0,112500,1,0,52500,262500,210000
01SCS19E110182,DKS.AR-SE0009,00ARSE0161,30,1,417272,696000,2,0,69600,1,0,93960,626400,532440
01SCS19E110183,AR.ESB-SC018,20ARSC0466,L,1,91000,140000,2,0,28000,1,0,28000,112000,84000
01SCS19E110183,AR.TUC-SD006,20ARSD0162,L,1,94250,145000,2,0,29000,1,0,29000,116000,87000
01SCS19E110184,ESH.AR-QA0024,00ARQA0129,ALL,1,37800,140000,2,0,90000,1,0,10000,50000,40000
01SCS19E110184,ESH.AR-RF0004,00ARRF0032,L,1,110000,315000,2,0,155000,1,0,32000,160000,128000
01SCS19E110185,AR.TUC-SD003,20ARSD0150,L,1,204750,315000,2,0,63000,1,0,63000,252000,189000
01SCS19E110186,BSC.AR-RC0039,00ARRC0289,L,1,155000,450000,2,0,275000,1,0,35000,175000,140000
01SCS19E110187,AR.HMR-SB020,20ARSB0392,32,1,204750,315000,2,0,63000,1,0,63000,252000,189000
01SCS19E120001,AR.ESB-RE036,20ARRE0795,M,1,65000,100000,2,0,50000,1,0,12500,50000,37500
01SCS19E120001,AR.PCT-RE010,20ARRE1430,S,1,81250,125000,2,0,62500,1,0,15625,62500,46875
01SCS19E120001,AR.TUC-SA004,20ARSA0014,M,1,87750,135000,2,0,27000,1,0,27000,108000,81000
01SCS19E120001,AR.VLD-RK019,20ARRK0353,S,1,91000,140000,2,0,42000,1,0,24500,98000,73500
01SCS19E120001,BSC.AR-SD0022,00ARSD0128,S,1,44000,159000,2,0,47700,1,0,22260,111300,89040
01SCS19E120002,AR.ESB-RE007,20ARRE0356,L,1,87750,135000,2,0,67500,1,0,16875,67500,50625
01SCS19E120002,AR.ESB-RE021,20ARRE0398,L,1,91000,140000,2,0,70000,1,0,17500,70000,52500
01SCS19E120003,AR.MPR-SE016,20ARSE0197,S,1,243750,375000,2,0,75000,1,0,75000,300000,225000
01SCS19E120003,BSC.AR-RJ0029,00ARRJ0168,M,1,120000,315000,2,0,94500,1,0,44100,220500,176400
01SCS19E120003,BSC.AR-SD0011,00ARSD0104,NON,1,18000,75000,2,0,22500,1,0,10500,52500,42000
01SCS19E120004,BSC.AR-SC0012,00ARSC0074,L,1,44000,159000,2,0,47700,1,0,22260,111300,89040
01SCS19E120004,ESH.AR-SD0027,00ARSD0272,L,1,44000,135000,2,0,40500,1,0,18900,94500,75600
01SCS19E120005,BSC.AR-RH0030,00ARRH0184,XL,1,37000,155000,2,0,46500,1,0,21700,108500,86800
01SCS19E120005,BSC.AR-SA0019,00ARSA0066,XL,1,44000,135000,2,0,40500,1,0,18900,94500,75600
01SCS19E120006,AR.CPT-SD011,20ARSD0456,XL,1,94250,145000,2,0,29000,1,0,29000,116000,87000
01SCS19E120007,AR.HMR-SB020,20ARSB0393,34,1,204750,315000,2,0,63000,1,0,63000,252000,189000
01SCS19E120008,AR.PUB-SE011,20ARSE0042,M,1,97500,150000,2,0,30000,1,0,30000,120000,90000
01SCS19E120008,AR.RDC-SB003,20ARSB0169,ALL,1,87750,135000,2,0,27000,1,0,27000,108000,81000
01SCS19E120008,AR.TUC-RL023,20ARRL0347,ALL,1,87750,135000,2,0,27000,1,0,27000,108000,81000
01SCS19E120008,BSC.AR-SA0015,00ARSA0044,M,1,44500,135000,2,0,40500,1,0,18900,94500,75600
01SCS19E120008,BSC.AR-SD0028,00ARSD0160,S,1,125000,315000,2,0,94500,1,0,44100,220500,176400
01SCS19E120009,BSC.AR-SC0014,00ARSC0097,M,1,44000,159000,2,0,47700,1,0,22260,111300,89040
01SCS19E120010,ESH.AR-QK0012,00ARQK0072,M,1,100000,310000,2,0,150000,1,0,32000,160000,128000
01SCS19E120011,AR.ESB-RL004,20ARRL0016,XL,1,100750,155000,2,0,31000,1,0,31000,124000,93000
01SCS19E120011,BSC.AR-SB0020,00ARSB0170,XL,1,44000,135000,2,0,40500,1,0,18900,94500,75600
01SCS19E120012,ESH.AR-RC0024,00ARRC0180,M,1,42000,135000,2,0,67500,1,0,13500,67500,54000
01SCS19E120012,ESH.AR-RE0008,00ARRE0029,S,1,42000,135000,2,0,67500,1,0,13500,67500,54000
01SCS19E120012,ESH.AR-SD0013,00ARSD0082,32,1,145000,375000,2,0,112500,1,0,52500,262500,210000
01SCS19E120013,AR.CPT-RI008,20ARRI0069,M,1,94250,145000,2,0,29000,1,0,29000,116000,87000
01SCS19E120013,AR.SMD-RL003,20ARRL0267,ALL,1,22750,35000,2,0,7000,1,0,7000,28000,21000
01SCS19E120013,BSC.AR-SB0011,00ARSB0097,M,1,44500,135000,2,0,40500,1,0,18900,94500,75600
01SCS19E120013,ESH.AR-RD0008,00ARRD0055,NON,1,80500,115000,2,0,34500,1,0,16100,80500,64400
01SCS19E120013,ESH.AR-RL0012,00ARRL0125,NON,1,47000,130000,2,0,39000,1,0,18200,91000,72800
01SCS19E120014,AR.MDS-RE001,20ARRE0631,L,1,130000,200000,2,0,40000,1,0,40000,160000,120000
01SCS19E120014,ESH.AR-RK0019,00ARRK0197,L,1,192500,275000,2,0,82500,1,0,38500,192500,154000
01SCS19E120015,ESH.AR-SD0024,00ARSD0258,S,1,44500,135000,2,0,40500,1,0,18900,94500,75600
01SCS19E120015,ESH.AR-SD0039,00ARSD0347,S,1,122500,350000,2,0,105000,1,0,49000,245000,196000
01SCS19E120016,AR.PUB-SE002,20ARSE0005,S,1,97500,150000,2,0,30000,1,0,30000,120000,90000
01SCS19E120016,BSC.AR-RJ0018,00ARRJ0107,S,1,94500,135000,2,0,40500,1,0,18900,94500,75600
01SCS19E120017,BSC.AR-RL0020,00ARRL0117,S,1,125000,315000,2,0,94500,1,0,44100,220500,176400
01SCS19E120017,BSC.AR-SD0061,00ARSD0336,NON,1,45000,150000,2,0,45000,1,0,21000,105000,84000
01SCS19E120018,BSC.AR-RL0019,00ARRL0113,S,1,125000,315000,2,0,94500,1,0,44100,220500,176400
01SCS19E120018,BSC.AR-SC0029,00ARSC0200,M,1,125000,315000,2,0,94500,1,0,44100,220500,176400
01SCS19E120018,BSC.AR-SD0054,00ARSD0287,NON,1,50000,150000,2,0,45000,1,0,21000,105000,84000
01SCS19E120019,AR.REC-SD018,20ARSD0056,ALL,1,107250,165000,2,0,49500,1,0,28875,115500,86625
01SCS19E120019,AR.TUC-SB002,20ARSB0029,L,1,204750,315000,2,0,63000,1,0,63000,252000,189000
01SCS19E120020,AR.PUB-RH040,20ARRH0732,ALL,1,81250,125000,2,0,25000,1,0,25000,100000,75000
01SCS19E120020,AR.YD-RL020,20ARRL0058,ALL,1,94250,145000,2,0,72500,1,0,18125,72500,54375
01SCS19E120020,BSC.AR-RH0026,00ARRH0165,32,1,245000,350000,2,0,105000,1,0,49000,245000,196000
01SCS19E120020,BSC.AR-SD0028,00ARSD0160,S,1,125000,315000,2,0,94500,1,0,44100,220500,176400
01SCS19E120020,ESH.AR-RA0017,00ARRA0074,ALL,1,40000,140000,2,0,90000,1,0,10000,50000,40000
01SCS19E120021,BSC.AR-SC0015,00ARSC0100,S,1,44000,159000,2,0,47700,1,0,22260,111300,89040
01SCS19E120021,ESH.AR-SB0003,00ARSB0007,S,1,44000,135000,2,0,40500,1,0,18900,94500,75600
01SCS19E120022,ESH.AR-SD0002,00ARSD0038,M,1,44500,135000,2,0,40500,1,0,18900,94500,75600
01SCS19E120023,ESH.AR-RK0016,00ARRK0192,NON,1,105000,150000,2,0,45000,1,0,21000,105000,84000
01SCS19E120024,AR.PCT-RE010,20ARRE1431,M,1,81250,125000,2,0,62500,1,0,15625,62500,46875
01SCS19E120024,ARN.AR-RK0003,00ARRK0227,M,1,120000,315000,2,0,63000,1,0,75600,252000,176400
01SCS19E120024,ESH.AR-RE0002,00ARRE0006,M,1,42000,135000,2,0,67500,1,0,13500,67500,54000
01SCS19E120024,ESH.AR-RE0007,00ARRE0026,M,1,42000,135000,2,0,67500,1,0,13500,67500,54000
01SCS19E120024,ESH.AR-SD0021,00ARSD0165,M,1,125000,315000,2,0,94500,1,0,44100,220500,176400
01SCS19E120025,AR.MPR-SE020,20ARSE0204,ALL,1,97500,150000,2,0,45000,1,0,26250,105000,78750
01SCS19E120025,AR.PUB-SA008,20ARSA0326,M,1,204750,315000,2,0,63000,1,0,63000,252000,189000
01SCS19E120025,AR.TUC-SD019,20ARSD0494,M,1,94250,145000,2,0,29000,1,0,29000,116000,87000
01SCS19E120026,DKS.AR-SE0008,00ARSE0157,30,1,41727,696000,2,0,69600,1,0,93960,626400,532440
01SCS19E120027,ESH.AR-SA0008,00ARSA0083,S,1,113450,350000,2,0,105000,1,0,49000,245000,196000
01SCS19E120028,BSC.AR-SD0016,00ARSD0119,M,1,122000,375000,2,0,112500,1,0,52500,262500,210000
01SCS19E120029,BSC.AR-RK0002,00ARRK0055,L,1,94500,135000,2,0,40500,1,0,18900,94500,75600
01SCS19E120030,ESH.AR-QL0004,00ARQL0020,L,1,42000,135000,2,0,67500,1,0,13500,67500,54000
01SCS19E120030,ESH.AR-RC0024,00ARRC0181,L,1,42000,135000,2,0,67500,1,0,13500,67500,54000
01SCS19E120031,AR.STY-SC006,20ARSC0205,ALL,1,77350,119000,2,0,23800,1,0,23800,95200,71400
01SCS19E120032,AR.PUB-SE008,20ARSE0030,M,1,97500,150000,2,0,30000,1,0,30000,120000,90000
01SCS19E120032,AR.SMD-SD005,20ARSD0293,M,1,87750,135000,2,0,27000,1,0,27000,108000,81000
01SCS19E120033,BSC.AR-SD0038,00ARSD0207,S,1,125000,315000,2,0,94500,1,0,44100,220500,176400
01SCS19E120033,ESH.AR-RC0024,00ARRC0180,M,1,42000,135000,2,0,67500,1,0,13500,67500,54000
01SCS19E120033,ESH.AR-RE0010,00ARRE0078,M,1,42000,135000,2,0,67500,1,0,13500,67500,54000
01SCS19E120033,ESH.AR-SC0005,00ARSC0026,S,1,125000,315000,2,0,94500,1,0,44100,220500,176400
01SCS19E120034,AR.MKV-QF003,20ARQF0127,32,1,162500,250000,2,0,125000,1,0,31250,125000,93750
01SCS19E120034,ESH.AR-RF0007,00ARRF0043,M,1,150000,395000,2,0,220000,1,0,35000,175000,140000
01SCS19E120035,AR.CPT-SD007,20ARSD0438,M,1,204750,315000,2,0,63000,1,0,63000,252000,189000
01SCS19E120036,AR.TUC-SA021,20ARSA0139,M,1,87750,135000,2,0,27000,1,0,27000,108000,81000
01SCS19E120036,BSC.AR-RJ0013,00ARRJ0088,M,1,44500,135000,2,0,40500,1,0,18900,94500,75600
01SCS19E120037,AR.MKV-SC018,20ARSC0223,ALL,1,91000,140000,2,0,70000,1,0,17500,70000,52500
01SCS19E120038,AR.MKV-SC019,20ARSC0224,ALL,1,91000,140000,2,0,70000,1,0,17500,70000,52500
01SCS19E120038,AR.TUC-SD007,20ARSD0167,XL,1,185250,285000,2,0,57000,1,0,57000,228000,171000
01SCS19E120039,ESH.AR-RD0018,00ARRD0185,NON,1,55000,150000,2,0,100000,1,0,10000,50000,40000
01SCS19E120040,AR.HLW-SA017,20ARSA0116,M,1,100750,155000,2,0,46500,1,0,27125,108500,81375
01SCS19E120040,AR.MKV-RJ030,20ARRJ0447,M,1,165750,255000,2,0,51000,1,0,51000,204000,153000
01SCS19E120040,BSC.AR-SB0002,00ARSB0019,S,1,44500,135000,2,0,40500,1,0,18900,94500,75600
01SCS19E120041,AR.MPR-SE026,20ARSE0222,S,1,230750,355000,2,0,71000,1,0,71000,284000,213000
01SCS19E120042,AR.MKV-RE035,20ARRE1404,XL,1,165750,255000,2,0,51000,1,0,51000,204000,153000
01SCS19E120042,ESH.AR-SC0002,00ARSC0008,XL,1,44500,135000,2,0,40500,1,0,18900,94500,75600
01SCS19E120043,AR.ESB-SC018,20ARSC0467,XL,1,91000,140000,2,0,28000,1,0,28000,112000,84000
01SCS19E120044,ESH.AR-RB0028,00ARRB0154,34,1,130000,350000,2,0,175000,1,0,35000,175000,140000
01SCS19E120044,ESH.AR-RG0004,00ARRG0012,L,1,178500,255000,2,0,76500,1,0,35700,178500,142800
01SCS19E120045,ESH.AR-SD0004,00ARSD0047,L,1,44500,135000,2,0,40500,1,0,18900,94500,75600
01SCS19E120046,AR.MPR-SE004,20ARSE0150,M,1,97500,150000,2,0,45000,1,0,26250,105000,78750
01SCS19E120046,AR.TUC-SD024,20ARSD0515,L,1,204750,315000,2,0,63000,1,0,63000,252000,189000
01SCS19E120047,ESH.AR-SD0001,00ARSD0030,M,1,44500,135000,2,0,40500,1,0,18900,94500,75600
01SCS19E120048,AR.PUB-RI001,20ARRI0096,S,1,97500,150000,2,0,30000,1,0,30000,120000,90000
01SCS19E120048,AR.STY-SB007,20ARSB0494,ALL,1,55250,85000,2,0,17000,1,0,17000,68000,51000
01SCS19E120048,ESH.AR-SD0010,00ARSD0069,S,1,44500,135000,2,0,40500,1,0,18900,94500,75600
01SCS19E120049,AR.SMD-SA002,20ARSA0226,XL,1,87750,135000,2,0,27000,1,0,27000,108000,81000
01SCS19E120049,AR.SMD-SD018,20ARSD0580,ALL,1,97500,150000,2,0,30000,1,0,30000,120000,90000
01SCS19E120049,AR.TUC-SD016,20ARSD0482,M,1,94250,145000,2,0,29000,1,0,29000,116000,87000
01SCS19E120049,ESH.AR-SD0038,00ARSD0344,M,1,122500,350000,2,0,105000,1,0,49000,245000,196000
01SCS19E120050,ESH.AR-SB0028,00ARSB0171,S,1,44000,135000,2,0,40500,1,0,18900,94500,75600
01SCS19E120051,BSC.AR-SC0015,00ARSC0101,M,1,44000,159000,2,0,47700,1,0,22260,111300,89040
01SCS19E120052,ESH.AR-RJ0001,00ARRJ0012,M,1,44500,135000,2,0,40500,1,0,18900,94500,75600
01SCS19E120053,BSC.AR-RK0009,00ARRK0081,S,1,52000,155000,2,0,46500,1,0,21700,108500,86800
01SCS19E120054,AR.CPT-SC002,20ARSC0247,34,1,227500,350000,2,0,70000,1,0,70000,280000,210000
01SCS19E120055,AR.MKV-RE005,20ARRE0842,ALL,1,91000,140000,2,0,70000,1,0,17500,70000,52500
01SCS19E120056,AR.MKV-RJ002,20ARRJ0146,M,1,91000,140000,2,0,28000,1,0,28000,112000,84000
01SCS19E120057,BSC.AR-SC0029,00ARSC0201,L,1,125000,315000,2,0,94500,1,0,44100,220500,176400
01SCS19E120058,ESH.AR-SB0034,00ARSB0217,M,1,125000,315000,2,0,94500,1,0,44100,220500,176400
01SCS19E120059,BSC.AR-RC0034,00ARRC0235,M,1,120000,360000,2,0,185000,1,0,35000,175000,140000
01SCS19E120059,ESH.AR-PL0032,00ARPL0231,ALL,1,39800,140000,2,0,90000,1,0,10000,50000,40000
01SCS19E120060,AR.PUB-RL003,20ARRL0117,L,1,97500,150000,2,0,30000,1,0,30000,120000,90000
01SCS19E120060,AR.TUC-SD001,20ARSD0143,XL,1,204750,315000,2,0,63000,1,0,63000,252000,189000
01SCS19E120061,BSC.AR-RH0017,00ARRH0075,M,1,120000,315000,2,0,94500,1,0,44100,220500,176400
01SCS19E120062,BSC.AR-SC0012,00ARSC0072,S,1,44000,159000,2,0,47700,1,0,22260,111300,89040
01SCS19E120062,ESH.AR-RH0016,00ARRH0091,S,1,43000,135000,2,0,40500,1,0,18900,94500,75600
01SCS19E120063,BSC.AR-RK0022,00ARRK0209,L,1,120000,315000,2,0,94500,1,0,44100,220500,176400
01SCS19E120064,BSC.AR-RL0018,00ARRL0111,L,1,125000,315000,2,0,94500,1,0,44100,220500,176400
01SCS19E120065,BSC.AR-RJ0021,00ARRJ0122,XL,1,94500,135000,2,0,40500,1,0,18900,94500,75600
01SCS19E120066,AR.MKV-RJ003,20ARRJ0151,M,1,91000,140000,2,0,28000,1,0,28000,112000,84000
01SCS19E120066,AR.SMD-RH004,20ARRH0416,M,1,87750,135000,2,0,40500,1,0,23625,94500,70875
01SCS19E120066,AR.TUC-SD017,20ARSD0486,M,1,94250,145000,2,0,29000,1,0,29000,116000,87000
01SCS19E120067,AR.STY-SE008,20ARSE0126,ALL,1,55250,85000,2,0,17000,1,0,17000,68000,51000
01SCS19E120068,AR.ASH-RJ007,20ARRJ0270,S,1,91000,140000,2,0,42000,1,0,24500,98000,73500
01SCS19E120068,BSC.AR-SA0006,00ARSA0026,S,1,44500,135000,2,0,40500,1,0,18900,94500,75600
01SCS19E120068,ESH.AR-SB0028,00ARSB0171,S,1,44000,135000,2,0,40500,1,0,18900,94500,75600
01SCS19E120069,AR.SMD-SD006,20ARSD0296,S,1,87750,135000,2,0,27000,1,0,27000,108000,81000
01SCS19E120070,BSC.AR-SD0016,00ARSD0119,M,1,122000,375000,2,0,112500,1,0,52500,262500,210000
01SCS19E120071,AR.HLW-SC004,20ARSC0127,M,1,195000,300000,2,0,90000,1,0,52500,210000,157500
01SCS19E120071,AR.MKV-RE009,20ARRE0851,32,1,117000,180000,2,0,90000,1,0,22500,90000,67500
01SCS19E120072,AR.MPR-SB007,20ARSB0258,S,1,97500,150000,2,0,45000,1,0,26250,105000,78750
01SCS19E120073,ESH.AR-RD0035,00ARRD0271,M,1,43000,135000,2,0,67500,1,0,13500,67500,54000
01SCS19E120073,ESH.AR-RE0007,00ARRE0027,L,1,42000,135000,2,0,67500,1,0,13500,67500,54000
01SCS19E120073,ESH.AR-SD0019,00ARSD0140,S,1,125000,315000,2,0,94500,1,0,44100,220500,176400
01SCS19E120074,AR.ESB-QF011,20ARQF0037,L,1,97500,150000,2,0,75000,1,0,18750,75000,56250
01SCS19E120074,AR.MKV-RL001,20ARRL0237,L,1,204750,315000,2,0,63000,1,0,63000,252000,189000
01SCS19E120075,AR.SLS-SE008,20ARSE0135,XL,1,255000,300000,0,0,0,0,0,45000,300000,255000
01SCS19E120075,AR.SMD-SD010,20ARSD0313,34,1,211250,325000,2,0,65000,1,0,65000,260000,195000
01SCS19E120076,BSC.AR-RJ0008,00ARRJ0067,S,1,94500,135000,2,0,40500,1,0,18900,94500,75600
01SCS19E120077,AR.MPR-SB007,20ARSB0258,S,1,97500,150000,2,0,45000,1,0,26250,105000,78750
01SCS19E120078,AR.CPT-SB001,20ARSB0083,M,1,204750,315000,2,0,63000,1,0,63000,252000,189000
01SCS19E120078,BSC.AR-RE0018,00ARRE0118,NON,1,36837,115000,2,0,15000,1,0,20000,100000,80000
01SCS19E120078,BSC.AR-RJ0013,00ARRJ0088,M,1,44500,135000,2,0,40500,1,0,18900,94500,75600
01SCS19E120078,BSC.AR-RK0007,00ARRK0074,M,1,52000,155000,2,0,46500,1,0,21700,108500,86800
01SCS19E120079,AR.CPT-RE012,20ARRE0716,XL,1,94250,145000,2,0,29000,1,0,29000,116000,87000
01SCS19E120080,AR.MKV-RJ027,20ARRJ0224,34,1,214500,330000,2,0,66000,1,0,66000,264000,198000
01SCS19E120081,AR.KNR-RK004,20ARRK0261,S,1,136500,210000,2,0,63000,1,0,36750,147000,110250
01SCS19E120081,AR.MKV-SC010,20ARSC0102,S,1,97500,150000,2,0,30000,1,0,30000,120000,90000
01SCS19E120082,BSC.AR-SC0010,00ARSC0058,L,1,125000,315000,2,0,94500,1,0,44100,220500,176400
01SCS19E120083,BSC.AR-SD0038,00ARSD0209,L,1,125000,315000,2,0,94500,1,0,44100,220500,176400
01SCS19E120084,AR.REC-RA005,20ARRA0251,M,1,107250,165000,2,0,49500,1,0,28875,115500,86625
01SCS19E120085,BSC.AR-SD0064,00ARSD0340,M,1,125000,315000,2,0,94500,1,0,44100,220500,176400
01SCS19E120085,ESH.AR-RD0021,00ARRD0192,M,1,42000,135000,2,0,67500,1,0,13500,67500,54000
01SCS19E120085,ESH.AR-RE0007,00ARRE0026,M,1,42000,135000,2,0,67500,1,0,13500,67500,54000
01SCS19E120086,BSC.AR-SD0016,00ARSD0119,M,1,122000,375000,2,0,112500,1,0,52500,262500,210000
01SCS19E120087,BSC.AR-RH0019,00ARRH0114,XL,1,94500,135000,2,0,40500,1,0,18900,94500,75600
01SCS19E120087,BSC.AR-SA0018,00ARSA0061,L,1,44000,135000,2,0,40500,1,0,18900,94500,75600
01SCS19E120088,AR.PUB-SE016,20ARSE0062,M,1,159250,245000,2,0,49000,1,0,49000,196000,147000
01SCS19E120089,AR.STY-SE009,20ARSE0127,ALL,1,55250,85000,2,0,17000,1,0,17000,68000,51000
01SCS19E120089,ESH.AR-SD0029,00ARSD0278,NON,1,58000,175000,2,0,52500,1,0,24500,122500,98000
01SCS19E120090,AR.ESB-RE015,20ARRE0380,L,1,87750,135000,2,0,67500,1,0,16875,67500,50625
01SCS19E120090,AR.TUC-RC002,20ARRC0062,L,1,87750,135000,2,0,67500,1,0,16875,67500,50625
01SCS19E120091,BSC.AR-RH0003,00ARRH0015,L,1,94500,135000,2,0,40500,1,0,18900,94500,75600
01SCS19E120091,BSC.AR-SD0006,00ARSD0022,M,1,44000,159000,2,0,47700,1,0,22260,111300,89040
01SCS19E120091,ESH.AR-RH0020,00ARRH0108,M,1,94500,135000,2,0,40500,1,0,18900,94500,75600
01SCS19E120092,AR.CPT-RL004,20ARRL0083,M,1,94250,145000,2,0,29000,1,0,29000,116000,87000
01SCS19E120092,AR.MPR-SE011,20ARSE0177,S,1,97500,150000,2,0,45000,1,0,26250,105000,78750
01SCS19E120092,BSC.AR-PI0019,00ARPI0019,ALL,1,58334,175000,2,0,75000,1,0,20000,100000,80000
01SCS19E120092,BSC.AR-RJ0032,00ARRJ0215,NON,1,18000,75000,2,0,22500,1,0,10500,52500,42000
01SCS19E120092,BSC.AR-SC0008,00ARSC0051,NON,1,73000,220000,2,0,66000,1,0,30800,154000,123200
01SCS19E120093,AR.MPR-SE024,20ARSE0214,S,1,230750,355000,2,0,71000,1,0,71000,284000,213000
01SCS19E120093,BSC.AR-SD0039,00ARSD0211,S,1,125000,315000,2,0,94500,1,0,44100,220500,176400
01SCS19E120094,ESH.AR-PL0015,00ARPL0125,S,1,110000,325000,2,0,165000,1,0,32000,160000,128000
01SCS19E120095,DKS.AR-SE0008,00ARSE0157,30,1,41727,696000,2,0,69600,1,0,93960,626400,532440
01SCS19E120096,AR.MPR-SE016,20ARSE0198,M,1,243750,375000,2,0,75000,1,0,75000,300000,225000
01SCS19E120096,AR.PUB-RG028,20ARRG0140,L,1,224250,345000,2,0,69000,1,0,69000,276000,207000
01SCS19E120096,AR.PUB-SE009,20ARSE0033,S,1,97500,150000,2,0,30000,1,0,30000,120000,90000
01SCS19E120096,ESH.AR-QJ0007,00ARQJ0029,S,1,100000,310000,2,0,150000,1,0,32000,160000,128000
01SCS19E120097,ESH.AR-SA0014,00ARSA0103,L,1,44000,135000,2,0,40500,1,0,18900,94500,75600
01SCS19E120097,ESH.AR-SB0031,00ARSB0206,L,1,44500,135000,2,0,40500,1,0,18900,94500,75600
01SCS19E120097,ESH.AR-SC0007,00ARSC0062,L,1,125000,350000,2,0,105000,1,0,49000,245000,196000
01SCS19E120098,AR.PUB-SE029,20ARSE0112,M,1,224250,345000,2,0,69000,1,0,69000,276000,207000
01SCS19E120099,ESH.AR-QI0012,00ARQI0072,ALL,1,37800,140000,2,0,90000,1,0,10000,50000,40000
01SCS19E120100,AR.PUB-SE029,20ARSE0113,L,1,224250,345000,2,0,69000,1,0,69000,276000,207000
01SCS19E120101,ESH.AR-SB0015,00ARSB0063,M,1,125000,315000,2,0,94500,1,0,44100,220500,176400
01SCS19E120102,ESH.AR-PK0043,00ARPK0198,S,1,110000,325000,2,0,165000,1,0,32000,160000,128000
01SCS19E120103,BSC.AR-RJ0011,00ARRJ0081,L,1,44500,135000,2,0,40500,1,0,18900,94500,75600
01SCS19E120104,ESH.AR-SD0043,00ARSD0394,S,1,125000,315000,2,0,94500,1,0,44100,220500,176400
01SCS19E120105,AR.TUC-SD007,20ARSD0166,L,1,185250,285000,2,0,57000,1,0,57000,228000,171000
01SCS19E120106,AR.MPR-SE001,20ARSE0137,S,1,97500,150000,2,0,45000,1,0,26250,105000,78750
01SCS19E120106,ESH.AR-RF0007,00ARRF0044,L,1,150000,395000,2,0,220000,1,0,35000,175000,140000
01SCS19E120107,BSC.AR-SB0015,00ARSB0127,S,1,125000,315000,2,0,94500,1,0,44100,220500,176400
01SCS19E120107,ESH.AR-SC0014,00ARSC0109,M,1,44500,135000,2,0,40500,1,0,18900,94500,75600
01SCS19E120108,BSC.AR-SC0017,00ARSC0117,M,1,44500,135000,2,0,40500,1,0,18900,94500,75600
01SCS19E120108,BSC.AR-SD0026,00ARSD0152,S,1,44500,159000,2,0,47700,1,0,22260,111300,89040
01SCS19E120109,AR.ESB-RE024,20ARRE0404,ALL,1,94250,145000,2,0,43500,1,0,25375,101500,76125
01SCS19E120110,ESH.AR-RB0028,00ARRB0154,34,1,130000,350000,2,0,175000,1,0,35000,175000,140000
01SCS19E120111,BE.RAK-RX538,00BERX2230,M,1,91000,140000,2,0,28000,1,0,28000,112000,84000
01SCS19E120111,BSC.AR-SC0050,00ARSC0313,M,2,44000,159000,2,0,47700,1,0,22260,222600,178080
01SCS19E120112,AR.HMR-SB030,20ARSB0438,32,1,96850,149000,2,0,29800,1,0,29800,119200,89400
01SCS19E120112,AR.TUC-SD019,20ARSD0494,M,1,94250,145000,2,0,29000,1,0,29000,116000,87000
01SCS19E120112,BE.RAK-RX615,00BERX2618,M,1,110500,170000,2,0,34000,1,0,34000,136000,102000
01SCS19E120112,BSC.AR-RH0017,00ARRH0076,L,1,120000,315000,2,0,94500,1,0,44100,220500,176400
01SCS19E120112,BSC.AR-SC0025,00ARSC0182,M,1,125000,315000,2,0,94500,1,0,44100,220500,176400
01SCS19E120112,BSC.AR-SC0029,00ARSC0201,L,1,125000,315000,2,0,94500,1,0,44100,220500,176400
01SCS19E120113,ESH.AR-RC0002,00ARRC0006,M,1,85000,240000,2,0,115000,1,0,25000,125000,100000
01SCS19E120114,AR.ESB-SE007,20ARSE0262,S,1,94250,145000,2,0,29000,1,0,29000,116000,87000
01SCS19E120114,AR.TUC-SA024,20ARSA0151,M,1,87750,135000,2,0,27000,1,0,27000,108000,81000
01SCS19E120114,BSC.AR-QG0008,00ARQG0094,ALL,1,80000,225000,2,0,125000,1,0,20000,100000,80000
01SCS19E120115,BSC.AR-RL0019,00ARRL0114,M,1,125000,315000,2,0,94500,1,0,44100,220500,176400
01SCS19E120115,ESH.AR-QE0009,00ARQE0028,ALL,1,45000,140000,2,0,90000,1,0,10000,50000,40000
01SCS19E120116,AR.HMR-SD008,20ARSD0548,S,1,198250,305000,2,0,61000,1,0,61000,244000,183000
01SCS19E120117,BSC.AR-SD0004,00ARSD0014,M,1,44000,159000,2,0,47700,1,0,22260,111300,89040
01SCS19E120117,ESH.AR-RD0021,00ARRD0192,M,1,42000,135000,2,0,67500,1,0,13500,67500,54000
01SCS19E120117,ESH.AR-RD0021,00ARRD0193,L,1,42000,135000,2,0,67500,1,0,13500,67500,54000
01SCS19E120118,ESH.AR-RE0014,00ARRE0094,M,1,105000,330000,2,0,155000,1,0,35000,175000,140000
01SCS19E120119,BSC.AR-SC0045,00ARSC0297,NON,1,45000,150000,2,0,45000,1,0,21000,105000,84000
01SCS19E120119,ESH.AR-SD0021,00ARSD0165,M,1,125000,315000,2,0,94500,1,0,44100,220500,176400
01SCS19E120120,AR.MPR-SE023,20ARSE0210,S,1,230750,355000,2,0,71000,1,0,71000,284000,213000
01SCS19E120121,BSC.AR-SD0047,00ARSD0247,NON,1,68000,220000,2,0,66000,1,0,30800,154000,123200
01SCS19E120122,AR.MKV-QA010,20ARQA0047,32,1,97500,150000,2,0,75000,1,0,18750,75000,56250
01SCS19E120122,ESH.AR-RD0035,00ARRD0272,L,1,43000,135000,2,0,67500,1,0,13500,67500,54000
01SCS19E120122,ESH.AR-RE0008,00ARRE0031,L,1,42000,135000,2,0,67500,1,0,13500,67500,54000
01SCS19E120123,AR.TUC-RK017,20ARRK0113,ALL,1,42250,65000,2,0,13000,1,0,13000,52000,39000
01SCS19E120124,AR.ESB-SD005,20ARSD0115,XL,1,91000,140000,2,0,28000,1,0,28000,112000,84000
01SCS19E120124,AR.ESB-SE005,20ARSE0255,M,1,94250,145000,2,0,29000,1,0,29000,116000,87000
01SCS19E120124,AR.PUB-RK001,20ARRK0065,S,1,97500,150000,2,0,30000,1,0,30000,120000,90000
01SCS19E120124,BSC.AR-RI0003,00ARRI0009,XL,1,94500,135000,2,0,40500,1,0,18900,94500,75600
01SCS19E120124,BSC.AR-SD0052,00ARSD0279,S,1,44500,159000,2,0,47700,1,0,22260,111300,89040
01SCS19E120125,BE.RAK-SB011,00BESB0052,M,1,201500,310000,2,0,62000,1,0,62000,248000,186000
01SCS19E120126,ESH.AR-QE0003,00ARQE0022,ALL,1,39800,140000,2,0,90000,1,0,10000,50000,40000
01SCS19E120126,ESH.AR-QE0009,00ARQE0028,ALL,1,45000,140000,2,0,90000,1,0,10000,50000,40000
01SCS19E120127,ESH.AR-RC0005,00ARRC0066,M,1,95000,310000,2,0,150000,1,0,32000,160000,128000
01SCS19E120127,ESH.AR-SC0034,00ARSC0293,M,1,125000,315000,2,0,94500,1,0,44100,220500,176400
01SCS19E120128,ESH.AR-RB0021,00ARRB0132,M,1,95000,310000,2,0,150000,1,0,32000,160000,128000
01SCS19E120128,ESH.AR-SD0021,00ARSD0166,L,1,125000,315000,2,0,94500,1,0,44100,220500,176400
01SCS19E120129,ESH.AR-SD0044,00ARSD0400,L,1,125000,315000,2,0,94500,1,0,44100,220500,176400
01SCS19E120130,ESH.AR-RK0023,00ARRK0248,M,1,276500,395000,2,0,118500,1,0,55300,276500,221200
01SCS19E120131,ESH.AR-SD0044,00ARSD0399,M,1,125000,315000,2,0,94500,1,0,44100,220500,176400
01SCS19E120132,BE.RAK-SB030,00BESB0095,ALL,1,104000,160000,2,0,32000,1,0,32000,128000,96000
01SCS19E120132,ESH.AR-QI0012,00ARQI0072,ALL,1,37800,140000,2,0,90000,1,0,10000,50000,40000
01SCS19E120132,ESH.AR-RD0003,00ARRD0028,34,1,110000,350000,2,0,175000,1,0,35000,175000,140000
01SCS19E120133,AR.MKV-RJ026,20ARRJ0220,ALL,1,97500,150000,2,0,30000,1,0,30000,120000,90000
01SCS19E120133,DKS.AR-SE0001,00ARSE0129,28,1,417272,696000,2,0,69600,1,0,93960,626400,532440
01SCS19E120134,AR.SMD-SA002,20ARSA0226,XL,1,87750,135000,2,0,27000,1,0,27000,108000,81000
01SCS19E120134,BSC.AR-RL0018,00ARRL0111,L,1,125000,315000,2,0,94500,1,0,44100,220500,176400
01SCS19E120135,AR.ASH-RJ001,20ARRJ0118,30,1,273000,420000,2,0,210000,1,0,52500,210000,157500
01SCS19E120136,AR.PUB-SE016,20ARSE0061,S,1,159250,245000,2,0,49000,1,0,49000,196000,147000
01SCS19E120136,AR.SMD-SD017,20ARSD0579,ALL,1,97500,150000,2,0,30000,1,0,30000,120000,90000
01SCS19E120137,DKS.AR-SE0007,00ARSE0153,32,1,417272,696000,2,0,69600,1,0,93960,626400,532440
01SCS19E120138,AR.SMD-SD017,20ARSD0579,ALL,1,97500,150000,2,0,30000,1,0,30000,120000,90000
01SCS19E120139,AR.ESB-SE007,20ARSE0262,S,1,94250,145000,2,0,29000,1,0,29000,116000,87000
01SCS19E120140,AR.PUB-SE019,20ARSE0074,M,1,159250,245000,2,0,49000,1,0,49000,196000,147000
01SCS19E120141,ESH.AR-SB0025,00ARSB0157,NON,1,35300,120000,2,0,36000,1,0,16800,84000,67200
01SCS19E120142,AR.PUB-SB016,20ARSB0063,XL,1,159250,245000,2,0,49000,1,0,49000,196000,147000
01SCS19E120143,ESH.AR-SD0018,00ARSD0136,S,1,125000,315000,2,0,94500,1,0,44100,220500,176400
01SCS19E120144,AR.RDC-RH012,20ARRH0643,L,1,97500,150000,2,0,30000,1,0,30000,120000,90000
01SCS19E120144,AR.TUC-SD011,20ARSD0463,L,1,94250,145000,2,0,29000,1,0,29000,116000,87000
01SCS19E120145,AR.MPR-SE001,20ARSE0140,XL,1,97500,150000,2,0,45000,1,0,26250,105000,78750
01SCS19E120145,AR.VCS-SC005,20ARSC0390,L,1,97500,150000,2,0,45000,1,0,26250,105000,78750
01SCS19E120145,ESH.AR-SD0025,00ARSD0264,L,1,44000,135000,2,0,40500,1,0,18900,94500,75600
01SCS19E120146,AR.PUB-SC010,20ARSC0293,M,1,97500,150000,2,0,30000,1,0,30000,120000,90000
01SCS19E120147,ESH.AR-RF0004,00ARRF0033,XL,1,110000,315000,2,0,155000,1,0,32000,160000,128000
01SCS19E120148,BSC.AR-SB0009,00ARSB0083,M,1,44500,135000,2,0,40500,1,0,18900,94500,75600
01SCS19E120148,ESH.AR-QE0009,00ARQE0028,ALL,1,45000,140000,2,0,90000,1,0,10000,50000,40000
01SCS19E120149,AR.BPH-RL001,20ARRL0069,ALL,1,96850,149000,2,0,44700,1,0,26075,104300,78225
01SCS19E120149,AR.ESB-RL010,20ARRL0461,ALL,1,91000,140000,2,0,42000,1,0,24500,98000,73500
01SCS19E120149,AR.PUB-SB003,20ARSB0007,ALL,1,97500,150000,2,0,30000,1,0,30000,120000,90000
01SCS19E120149,AR.RDC-RK012,20ARRK0502,ALL,1,140400,185000,2,0,37000,1,0,37000,148000,111000
01SCS19E120149,AR.VLD-RK002,20ARRK0312,M,1,211250,325000,2,0,97500,1,0,56875,227500,170625
01SCS19E120150,ESH.AR-QE0009,00ARQE0028,ALL,1,45000,140000,2,0,90000,1,0,10000,50000,40000
01SCS19E120151,AR.MKV-QH012,20ARQH0217,ALL,1,78000,120000,2,0,60000,1,0,15000,60000,45000
01SCS19E120152,ESH.AR-RD0035,00ARRD0272,L,1,43000,135000,2,0,67500,1,0,13500,67500,54000
01SCS19E120152,ESH.AR-RE0007,00ARRE0026,M,1,42000,135000,2,0,67500,1,0,13500,67500,54000
01SCS19E120153,BSC.AR-SC0050,00ARSC0314,L,1,44000,159000,2,0,47700,1,0,22260,111300,89040
01SCS19E120154,AR.ESB-SC003,20ARSC0419,M,1,91000,140000,2,0,28000,1,0,28000,112000,84000
01SCS19E120154,AR.PUB-RG010,20ARRG0056,L,1,97500,150000,2,0,30000,1,0,30000,120000,90000
01SCS19E120155,AR.STY-SB007,20ARSB0494,ALL,1,55250,85000,2,0,17000,1,0,17000,68000,51000
01SCS19E120156,ESH.AR-PL0015,00ARPL0125,S,1,110000,325000,2,0,165000,1,0,32000,160000,128000
01SCS19E120156,ESH.AR-RE0002,00ARRE0005,S,1,42000,135000,2,0,67500,1,0,13500,67500,54000
01SCS19E120156,ESH.AR-RE0004,00ARRE0013,S,1,42000,135000,2,0,67500,1,0,13500,67500,54000
01SCS19E120157,BSC.AR-SA0018,00ARSA0060,M,1,44000,135000,2,0,40500,1,0,18900,94500,75600
01SCS19E120158,AR.ESB-RB002,20ARRB0336,M,1,84500,130000,2,0,65000,1,0,16250,65000,48750
01SCS19E120158,AR.ESB-RE022,20ARRE0401,L,1,91000,140000,2,0,70000,1,0,17500,70000,52500
01SCS19E120159,BSC.AR-SD0054,00ARSD0287,NON,1,50000,150000,2,0,45000,1,0,21000,105000,84000
01SCS19E120160,BSC.AR-RE0015,00ARRE0108,NON,1,35000,120000,2,0,36000,1,0,16800,84000,67200
01SCS19E120160,BSC.AR-RK0008,00ARRK0079,L,1,52000,155000,2,0,46500,1,0,21700,108500,86800
01SCS19E120161,ESH.AR-SB0034,00ARSB0216,S,1,125000,315000,2,0,94500,1,0,44100,220500,176400
01SCS19E120162,AR.MPR-SE012,20ARSE0181,S,1,97500,150000,2,0,45000,1,0,26250,105000,78750
01SCS19E120162,AR.PUB-SC015,20ARSC0360,S,1,97500,150000,2,0,30000,1,0,30000,120000,90000
01SCS19E120162,BSC.AR-SD0039,00ARSD0211,S,1,125000,315000,2,0,94500,1,0,44100,220500,176400
01SCS19E120162,ESH.AR-SB0007,00ARSB0027,S,1,44000,135000,2,0,40500,1,0,18900,94500,75600
01SCS19E120163,AR.ESB-SC019,20ARSC0468,ALL,1,68250,105000,2,0,31500,1,0,18375,73500,55125
01SCS19E120163,AR.ESB-SC020,20ARSC0469,ALL,1,68250,105000,2,0,31500,1,0,18375,73500,55125
01SCS19E120163,AR.PCT-RE006,20ARRE0623,L,1,87750,135000,2,0,67500,1,0,16875,67500,50625
01SCS19E120163,AR.STY-SE008,20ARSE0126,ALL,1,55250,85000,2,0,17000,1,0,17000,68000,51000
01SCS19E120164,ESH.AR-RK0022,00ARRK0244,M,1,276500,395000,2,0,118500,1,0,55300,276500,221200
01SCS19E120165,ESH.AR-RD0021,00ARRD0194,XL,1,42000,135000,2,0,67500,1,0,13500,67500,54000
01SCS19E120165,ESH.AR-RD0035,00ARRD0273,XL,1,43000,135000,2,0,67500,1,0,13500,67500,54000
01SCS19E120166,ESH.AR-RK0014,00ARRK0189,L,1,245000,350000,2,0,105000,1,0,49000,245000,196000
01SCS19E120167,AR.MPR-SB003,20ARSB0243,M,1,230750,355000,2,0,71000,1,0,71000,284000,213000
01SCS19E120167,BSC.AR-RE0014,00ARRE0107,NON,1,35000,120000,2,0,36000,1,0,16800,84000,67200
01SCS19E120168,BSC.AR-SC0049,00ARSC0309,M,1,44500,159000,2,0,47700,1,0,22260,111300,89040
01SCS19E120168,ESH.AR-RI0009,00ARRI0104,L,1,94500,135000,2,0,40500,1,0,18900,94500,75600
01SCS19E120169,ESH.AR-RH0019,00ARRH0104,M,1,94500,135000,2,0,40500,1,0,18900,94500,75600
01SCS19E120170,ESH.AR-RF0004,00ARRF0032,L,1,110000,315000,2,0,155000,1,0,32000,160000,128000
01SCS19E120170,ESH.AR-SD0004,00ARSD0047,L,1,44500,135000,2,0,40500,1,0,18900,94500,75600
01SCS19E120171,AR.MPR-SE001,20ARSE0137,S,1,97500,150000,2,0,45000,1,0,26250,105000,78750
01SCS19E120171,ESH.AR-PL0015,00ARPL0126,M,1,110000,325000,2,0,165000,1,0,32000,160000,128000
01SCS19E120172,AR.SMD-SD011,20ARSD0315,30,1,211250,325000,2,0,65000,1,0,65000,260000,195000
01SCS19E120173,AR.TUC-SD003,20ARSD0150,L,1,204750,315000,2,0,63000,1,0,63000,252000,189000
01SCS19E120174,BSC.AR-SC0017,00ARSC0117,M,1,44500,135000,2,0,40500,1,0,18900,94500,75600
01SCS19E120174,ESH.AR-SD0026,00ARSD0267,M,1,44500,135000,2,0,40500,1,0,18900,94500,75600
01SCS19E120175,ESH.AR-SC0001,00ARSC0002,M,1,125000,315000,2,0,94500,1,0,44100,220500,176400
01SCS19E120176,ESH.AR-SD0021,00ARSD0166,L,1,125000,315000,2,0,94500,1,0,44100,220500,176400
01SCS19E120177,AR.CPT-SC014,20ARSC0487,S,1,94250,145000,2,0,29000,1,0,29000,116000,87000
01SCS19E120177,AR.PUB-SE008,20ARSE0029,S,1,97500,150000,2,0,30000,1,0,30000,120000,90000
01SCS19E120178,AR.PUB-RG010,20ARRG0056,L,1,97500,150000,2,0,30000,1,0,30000,120000,90000
01SCS19E120179,AR.PUB-SA008,20ARSA0328,XL,1,204750,315000,2,0,63000,1,0,63000,252000,189000
01SCS19E120180,AR.GTW-SB003,20ARSB0156,ALL,1,91000,140000,2,0,42000,1,0,24500,98000,73500
01SCS19E120180,ESH.AR-SC0010,00ARSC0081,M,1,44500,135000,2,0,40500,1,0,18900,94500,75600
01SCS19E120181,AR.MKV-SD002,20ARSD0222,S,1,97500,150000,2,0,30000,1,0,30000,120000,90000
01SCS19E120182,AR.TUC-RK009,20ARRK0105,ALL,1,87750,135000,2,0,27000,1,0,27000,108000,81000
01SCS19E120183,AR.MKV-RJ004,20ARRJ0156,M,1,91000,140000,2,0,28000,1,0,28000,112000,84000
01SCS19E120183,ESH.AR-SB0021,00ARSB0120,M,1,44500,135000,2,0,40500,1,0,18900,94500,75600
01SCS19E130001,AR.MKV-SA010,20ARSA0315,34,1,214500,330000,2,0,66000,1,0,66000,264000,198000
01SCS19E130001,AR.PUB-SD030,20ARSD0211,34,1,211250,325000,2,0,65000,1,0,65000,260000,195000
01SCS19E130001,ESH.AR-SA0014,00ARSA0103,L,1,44000,135000,2,0,40500,1,0,18900,94500,75600
01SCS19E130002,AR.SMD-SD018,20ARSD0580,ALL,1,97500,150000,2,0,30000,1,0,30000,120000,90000
01SCS19E130003,BSC.AR-SC0012,00ARSC0073,M,1,44000,159000,2,0,47700,1,0,22260,111300,89040
01SCS19E130003,BSC.AR-SD0046,00ARSD0244,M,1,44500,159000,2,0,47700,1,0,22260,111300,89040
01SCS19E130003,ESH.AR-SC0032,00ARSC0281,M,1,44500,135000,2,0,40500,1,0,18900,94500,75600
01SCS19E130004,AR.TUC-RK031,20ARRK0143,L,1,87750,135000,2,0,27000,1,0,27000,108000,81000
01SCS19E130004,AR.TUC-SC005,20ARSC0062,32,1,185250,285000,2,0,57000,1,0,57000,228000,171000
01SCS19E130005,AR.ESB-SB001,20ARSB0020,S,1,204750,315000,2,0,63000,1,0,63000,252000,189000
01SCS19E130006,BSC.AR-SB0019,00ARSB0165,L,1,125000,315000,2,0,94500,1,0,44100,220500,176400
01SCS19E130007,AR.HLW-SA006,20ARSA0093,ALL,1,71500,110000,2,0,22000,1,0,22000,88000,66000
01SCS19E130008,BSC.AR-SD0002,00ARSD0005,S,1,44000,159000,2,0,47700,1,0,22260,111300,89040
01SCS19E130008,ESH.AR-RD0020,00ARRD0189,L,1,43000,150000,2,0,82500,1,0,13500,67500,54000
01SCS19E130008,ESH.AR-RD0035,00ARRD0272,L,1,43000,135000,2,0,67500,1,0,13500,67500,54000
01SCS19E130009,ESH.AR-QE0009,00ARQE0028,ALL,1,45000,140000,2,0,90000,1,0,10000,50000,40000
01SCS19E130009,ESH.AR-QI0003,00ARQI0036,ALL,1,40000,140000,2,0,90000,1,0,10000,50000,40000
01SCS19E130009,ESH.AR-RC0011,00ARRC0113,XL,1,180000,499000,2,0,324000,1,0,35000,175000,140000
01SCS19E130009,ESH.AR-RC0028,00ARRC0189,ALL,1,45000,150000,2,0,100000,1,0,10000,50000,40000
01SCS19E130010,AR.TUC-RK009,20ARRK0105,ALL,1,87750,135000,2,0,27000,1,0,27000,108000,81000
01SCS19E130010,BSC.AR-SC0015,00ARSC0101,M,1,44000,159000,2,0,47700,1,0,22260,111300,89040
01SCS19E130010,ESH.AR-SD0003,00ARSD0042,M,1,44000,135000,2,0,40500,1,0,18900,94500,75600
01SCS19E130011,AR.MPR-SE010,20ARSE0173,S,1,97500,150000,2,0,45000,1,0,26250,105000,78750
01SCS19E130011,ESH.AR-SA0008,00ARSA0083,S,1,113450,350000,2,0,105000,1,0,49000,245000,196000
01SCS19E130012,ESH.AR-RL0012,00ARRL0125,NON,1,47000,130000,2,0,39000,1,0,18200,91000,72800
01SCS19E130013,AR.MDS-RF001,20ARRF0075,M,1,389350,599000,2,0,119800,1,0,119800,479200,359400
01SCS19E130013,BSC.AR-SD0018,00ARSD0123,NON,1,45000,150000,2,0,45000,1,0,21000,105000,84000
01SCS19E130014,AR.GTW-SC003,20ARSC0031,L,1,204750,315000,2,0,94500,1,0,55125,220500,165375
01SCS19E130015,AR.SMD-RC002,20ARRC0619,ALL,1,97500,150000,2,0,45000,1,0,26250,105000,78750
01SCS19E130015,BE.RAK-RX211,00BERX0575,M,1,130000,200000,2,0,40000,1,0,40000,160000,120000
01SCS19E130015,ESH.AR-RJ0013,00ARRJ0176,M,1,94500,135000,2,0,40500,1,0,18900,94500,75600
01SCS19E130016,AR.MPR-SE001,20ARSE0137,S,1,97500,150000,2,0,45000,1,0,26250,105000,78750
01SCS19E130017,ESH.AR-SD0045,00ARSD0405,M,1,125000,315000,2,0,94500,1,0,44100,220500,176400
01SCS19E130018,ESH.AR-SD0043,00ARSD0397,XL,1,125000,315000,2,0,94500,1,0,44100,220500,176400
01SCS19E130019,AR.STY-SE009,20ARSE0127,ALL,1,55250,85000,2,0,17000,1,0,17000,68000,51000
01SCS19E130020,BSC.AR-RI0011,00ARRI0039,M,1,43000,135000,2,0,40500,1,0,18900,94500,75600
01SCS19E130021,BSC.AR-RK0012,00ARRK0094,M,1,43000,135000,2,0,40500,1,0,18900,94500,75600
01SCS19E130022,BSC.AR-SD0022,00ARSD0129,M,1,44000,159000,2,0,47700,1,0,22260,111300,89040
01SCS19E130023,BSC.AR-SC0044,00ARSC0296,NON,1,45000,150000,2,0,45000,1,0,21000,105000,84000
01SCS19E130024,BSC.AR-SB0003,00ARSB0043,S,1,125000,315000,2,0,94500,1,0,44100,220500,176400
01SCS19E130025,AR.HMR-SB009,20ARSB0368,S,1,90350,139000,2,0,27800,1,0,27800,111200,83400
01SCS19E130025,AR.MDS-RL004,20ARRL0367,M,1,117000,180000,2,0,36000,1,0,36000,144000,108000
01SCS19E130025,AR.YD-RL001,20ARRL0017,ALL,1,91000,140000,2,0,70000,1,0,17500,70000,52500
01SCS19E130025,BSC.AR-RJ0032,00ARRJ0215,NON,1,18000,75000,2,0,22500,1,0,10500,52500,42000
01SCS19E130025,ESH.AR-SA0006,00ARSA0073,L,1,44500,135000,2,0,40500,1,0,18900,94500,75600
01SCS19E130026,BSC.AR-SC0010,00ARSC0058,L,1,125000,315000,2,0,94500,1,0,44100,220500,176400
01SCS19E130026,BSC.AR-SD0029,00ARSD0170,S,1,44500,159000,2,0,47700,1,0,22260,111300,89040
01SCS19E130027,BSC.AR-RH0011,00ARRH0055,NON,1,46500,140000,2,0,42000,1,0,19600,98000,78400
01SCS19E130027,BSC.AR-SB0019,00ARSB0165,L,1,125000,315000,2,0,94500,1,0,44100,220500,176400
01SCS19E130028,BE.RAK-SB010,00BESB0047,M,1,201500,310000,2,0,62000,1,0,62000,248000,186000
01SCS19E130028,BE.RAK-SB036,00BESB0111,L,1,91000,140000,2,0,28000,1,0,28000,112000,84000
01SCS19E130029,AR.ESB-QJ016,20ARQJ0097,ALL,1,91000,140000,2,0,42000,1,0,24500,98000,73500
01SCS19E130029,BSC.AR-SD0061,00ARSD0336,NON,1,45000,150000,2,0,45000,1,0,21000,105000,84000
01SCS19E130030,ESH.AR-SD0041,00ARSD0370,S,1,125000,315000,2,0,94500,1,0,44100,220500,176400
01SCS19E130031,AR.MPR-SE024,20ARSE0214,S,1,230750,355000,2,0,71000,1,0,71000,284000,213000
01SCS19E130031,ESH.AR-QE0009,00ARQE0028,ALL,1,45000,140000,2,0,90000,1,0,10000,50000,40000
01SCS19E130032,AR.PUB-RL014,20ARRL0161,XL,1,191750,295000,2,0,59000,1,0,59000,236000,177000
01SCS19E130033,ESH.AR-SB0033,00ARSB0214,L,1,44500,135000,2,0,40500,1,0,18900,94500,75600
01SCS19E130033,ESH.AR-SD0001,00ARSD0031,L,1,44500,135000,2,0,40500,1,0,18900,94500,75600
01SCS19E130034,AR.PUB-SB033,20ARSB0464,ALL,1,97500,150000,2,0,30000,1,0,30000,120000,90000
01SCS19E130035,AR.PUB-RK016,20ARRK0458,ALL,1,97500,150000,2,0,30000,1,0,30000,120000,90000
01SCS19E130035,ESH.AR-SC0014,00ARSC0108,S,1,44500,135000,2,0,40500,1,0,18900,94500,75600
01SCS19E130035,ESH.AR-SD0018,00ARSD0137,M,1,125000,315000,2,0,94500,1,0,44100,220500,176400
01SCS19E130036,BSC.AR-SD0014,00ARSD0111,M,1,122000,375000,2,0,112500,1,0,52500,262500,210000
01SCS19E130037,AR.YD-RL001,20ARRL0017,ALL,1,91000,140000,2,0,70000,1,0,17500,70000,52500
01SCS19E130038,ESH.AR-RL0012,00ARRL0125,NON,1,47000,130000,2,0,39000,1,0,18200,91000,72800
01SCS19E130039,ESH.AR-SB0022,00ARSB0124,M,1,44000,135000,2,0,40500,1,0,18900,94500,75600
01SCS19E130039,ESH.AR-SD0026,00ARSD0267,M,1,44500,135000,2,0,40500,1,0,18900,94500,75600
01SCS19E130040,ESH.AR-RA0017,00ARRA0074,ALL,1,40000,140000,2,0,90000,1,0,10000,50000,40000
01SCS19E130041,ESH.AR-SD0027,00ARSD0271,M,1,44000,135000,2,0,40500,1,0,18900,94500,75600
01SCS19E130042,BSC.AR-SD0016,00ARSD0119,M,1,122000,375000,2,0,112500,1,0,52500,262500,210000
01SCS19E130043,AR.SMD-QD002,20ARQD0027,M,1,84500,130000,2,0,39000,1,0,22750,91000,68250
01SCS19E130043,AR.STY-SB007,20ARSB0494,ALL,1,55250,85000,2,0,17000,1,0,17000,68000,51000
01SCS19E130044,AR.PUB-SE029,20ARSE0114,XL,1,224250,345000,2,0,69000,1,0,69000,276000,207000
01SCS19E130045,AR.MPR-SE020,20ARSE0204,ALL,1,97500,150000,2,0,45000,1,0,26250,105000,78750
01SCS19E130046,AR.GTW-SB001,20ARSB0150,L,1,94250,145000,2,0,43500,1,0,25375,101500,76125
01SCS19E130046,AR.REC-SD010,20ARSD0038,M,1,178750,275000,2,0,82500,1,0,48125,192500,144375
01SCS19E130046,AR.VCS-SC003,20ARSC0381,M,1,97500,150000,2,0,45000,1,0,26250,105000,78750
01SCS19E130046,ESH.AR-SC0017,00ARSC0141,M,1,44000,135000,2,0,40500,1,0,18900,94500,75600
01SCS19E130046,ESH.AR-SD0004,00ARSD0047,L,1,44500,135000,2,0,40500,1,0,18900,94500,75600
01SCS19E130047,BSC.AR-RK0016,00ARRK0110,M,1,43000,135000,2,0,40500,1,0,18900,94500,75600
01SCS19E130047,BSC.AR-SC0007,00ARSC0042,S,1,44000,135000,2,0,40500,1,0,18900,94500,75600
01SCS19E130048,AR.STY-SE007,20ARSE0125,ALL,1,55250,85000,2,0,17000,1,0,17000,68000,51000
01SCS19E130049,AR.TUC-SB022,20ARSB0486,ALL,1,87750,135000,2,0,27000,1,0,27000,108000,81000
01SCS19E130050,AR.MPR-SE025,20ARSE0220,L,1,230750,355000,2,0,71000,1,0,71000,284000,213000
01SCS19E130051,ESH.AR-SD0035,00ARSD0333,NON,1,50000,150000,2,0,45000,1,0,21000,105000,84000
01SCS19E130052,AR.PCT-RE010,20ARRE1432,L,1,81250,125000,2,0,62500,1,0,15625,62500,46875
01SCS19E130053,BSC.AR-RH0017,00ARRH0076,L,1,120000,315000,2,0,94500,1,0,44100,220500,176400
01SCS19E130053,ESH.AR-RA0017,00ARRA0074,ALL,1,40000,140000,2,0,90000,1,0,10000,50000,40000
01SCS19E130054,ESH.AR-QD0016,00ARQD0150,M,1,110000,325000,2,0,165000,1,0,32000,160000,128000
01SCS19E130054,ESH.AR-RE0014,00ARRE0094,M,1,105000,330000,2,0,155000,1,0,35000,175000,140000
01SCS19E130054,ESH.AR-RF0014,00ARRF0081,S,1,105000,315000,2,0,190000,1,0,25000,125000,100000
01SCS19E130055,BSC.AR-RF0005,00ARRF0070,M,1,85000,240000,2,0,115000,1,0,25000,125000,100000
01SCS19E130056,BSC.AR-SB0001,00ARSB0003,S,1,44000,135000,2,0,40500,1,0,18900,94500,75600
01SCS19E130057,AR.TUC-SD019,20ARSD0495,L,1,94250,145000,2,0,29000,1,0,29000,116000,87000
01SCS19E130057,ESH.AR-RD0001,00ARRD0021,34,1,110000,350000,2,0,175000,1,0,35000,175000,140000
01SCS19E130058,AR.PUB-RG011,20ARRG0059,M,1,97500,150000,2,0,30000,1,0,30000,120000,90000
01SCS19E130059,BSC.AR-RH0018,00ARRH0080,L,1,120000,315000,2,0,94500,1,0,44100,220500,176400
01SCS19E130059,BSC.AR-RK0014,00ARRK0104,XL,1,43000,135000,2,0,40500,1,0,18900,94500,75600
01SCS19E130059,BSC.AR-SC0050,00ARSC0314,L,1,44000,159000,2,0,47700,1,0,22260,111300,89040
01SCS19E130060,BSC.AR-SD0041,00ARSD0224,M,1,44500,159000,2,0,47700,1,0,22260,111300,89040
01SCS19E130060,ESH.AR-SD0026,00ARSD0267,M,1,44500,135000,2,0,40500,1,0,18900,94500,75600
01SCS19E130061,AR.PUB-RK001,20ARRK0065,S,1,97500,150000,2,0,30000,1,0,30000,120000,90000
01SCS19E130062,ESH.AR-SD0022,00ARSD0168,NON,1,43000,120000,2,0,36000,1,0,16800,84000,67200
01SCS19E130063,ESH.AR-SA0014,00ARSA0103,L,1,44000,135000,2,0,40500,1,0,18900,94500,75600
01SCS19E130064,AR.STY-SE005,20ARSE0123,ALL,1,55250,85000,2,0,17000,1,0,17000,68000,51000
01SCS19E130065,SLT-PI0085,2016I03576,M,1,520000,650000,2,0,65000,1,0,87750,585000,497250
01SCS19E130066,ESH.AR-SD0044,00ARSD0401,XL,1,125000,315000,2,0,94500,1,0,44100,220500,176400
01SCS19E130067,ESH.AR-QH0026,00ARQH0137,ALL,1,39700,140000,2,0,90000,1,0,10000,50000,40000
01SCS19E130068,DKS.AR-SE0010,00ARSE0165,28,1,417272,696000,2,0,69600,1,0,93960,626400,532440
01SCS19E130069,BSC.AR-SC0003,00ARSC0025,NON,1,73000,220000,2,0,66000,1,0,30800,154000,123200
01SCS19E130070,DKS.AR-SE0008,00ARSE0156,28,1,41727,696000,2,0,69600,1,0,93960,626400,532440
01SCS19E130071,AR.ESB-RL004,20ARRL0013,S,1,100750,155000,2,0,31000,1,0,31000,124000,93000
01SCS19E130071,AR.TUC-RK009,20ARRK0105,ALL,1,87750,135000,2,0,27000,1,0,27000,108000,81000
01SCS19E130071,BSC.AR-SD0052,00ARSD0279,S,1,44500,159000,2,0,47700,1,0,22260,111300,89040
01SCS19E130072,AR.MKV-RL001,20ARRL0238,XL,1,204750,315000,2,0,63000,1,0,63000,252000,189000
01SCS19E130073,BSC.AR-SD0015,00ARSD0117,XL,1,122000,375000,2,0,112500,1,0,52500,262500,210000
01SCS19E130074,AR.SMD-RC002,20ARRC0619,ALL,1,97500,150000,2,0,45000,1,0,26250,105000,78750
01SCS19E130075,BE.RAK-SB011,00BESB0052,M,1,201500,310000,2,0,62000,1,0,62000,248000,186000
01SCS19E130076,AR.TUC-SD024,20ARSD0515,L,1,204750,315000,2,0,63000,1,0,63000,252000,189000
01SCS19E130076,ESH.AR-SD0010,00ARSD0071,L,1,44500,135000,2,0,40500,1,0,18900,94500,75600
01SCS19E130077,BSC.AR-SD0038,00ARSD0208,M,1,125000,315000,2,0,94500,1,0,44100,220500,176400
01SCS19E130078,BSC.AR-SB0001,00ARSB0003,S,1,44000,135000,2,0,40500,1,0,18900,94500,75600
01SCS19E130079,AR.HLW-SC004,20ARSC0127,M,1,195000,300000,2,0,90000,1,0,52500,210000,157500
01SCS19E130080,BSC.AR-RK0016,00ARRK0111,L,1,43000,135000,2,0,40500,1,0,18900,94500,75600
01SCS19E130081,BSC.AR-SC0001,00ARSC0014,M,1,125000,315000,2,0,94500,1,0,44100,220500,176400
01SCS19E130082,AR.CPT-RL002,20ARRL0076,L,1,94250,145000,2,0,29000,1,0,29000,116000,87000
01SCS19E130082,AR.ESB-RL004,20ARRL0014,M,1,100750,155000,2,0,31000,1,0,31000,124000,93000
01SCS19E130082,AR.PUB-RH018,20ARRH0277,32,1,211250,325000,2,0,65000,1,0,65000,260000,195000
01SCS19E130082,AR.PUB-SE002,20ARSE0006,M,1,97500,150000,2,0,30000,1,0,30000,120000,90000
01SCS19E130082,AR.VRS-SC010,20ARSC0196,S,1,96850,149000,2,0,44700,1,0,26075,104300,78225
01SCS19E130082,ESH.AR-SC0014,00ARSC0108,S,1,44500,135000,2,0,40500,1,0,18900,94500,75600
01SCS19E130083,AR.STY-SE005,20ARSE0123,ALL,1,55250,85000,2,0,17000,1,0,17000,68000,51000
01SCS19E130084,AR.CPT-SC007,20ARSC0264,S,1,94250,145000,2,0,29000,1,0,29000,116000,87000
01SCS19E130085,BSC.AR-SB0012,00ARSB0103,M,1,110000,325000,2,0,97500,1,0,45500,227500,182000
01SCS19E130086,BSC.AR-RH0010,00ARRH0054,NON,1,46500,140000,2,0,42000,1,0,19600,98000,78400
01SCS19E130087,ESH.AR-SC0014,00ARSC0109,M,1,44500,135000,2,0,40500,1,0,18900,94500,75600
01SCS19E130087,ESH.AR-SC0017,00ARSC0141,M,1,44000,135000,2,0,40500,1,0,18900,94500,75600
01SCS19E130088,ESH.AR-RF0007,00ARRF0044,L,1,150000,395000,2,0,220000,1,0,35000,175000,140000
01SCS19E130089,BSC.AR-RI0017,00ARRI0063,M,1,43000,135000,2,0,40500,1,0,18900,94500,75600
01SCS19E130089,BSC.AR-RI0017,00ARRI0064,L,1,43000,135000,2,0,40500,1,0,18900,94500,75600
01SCS19E130090,BSC.AR-RI0006,00ARRI0020,L,1,43000,135000,2,0,40500,1,0,18900,94500,75600
01SCS19E130091,ESH.AR-RB0030,00ARRB0165,36,1,130000,350000,2,0,175000,1,0,35000,175000,140000
01SCS19E130092,ESH.AR-SD0026,00ARSD0267,M,1,44500,135000,2,0,40500,1,0,18900,94500,75600
01SCS19E130093,BSC.AR-PI0019,00ARPI0019,ALL,1,58334,175000,2,0,75000,1,0,20000,100000,80000
01SCS19E130094,AR.PUB-RL006,20ARRL0129,L,1,97500,150000,2,0,30000,1,0,30000,120000,90000
01SCS19E130095,ESH.AR-SB0012,00ARSB0057,34,1,90,285000,2,0,85500,1,0,39900,199500,159600
01SCS19E130096,AR.CPT-SC009,20ARSC0273,M,1,94250,145000,2,0,29000,1,0,29000,116000,87000
01SCS19E130097,BSC.AR-SD0047,00ARSD0247,NON,1,68000,220000,2,0,66000,1,0,30800,154000,123200
01SCS19E130098,AR.TUC-RK042,20ARRK0182,L,1,211250,325000,2,0,65000,1,0,65000,260000,195000
01SCS19E130099,AR.HMR-SB025,20ARSB0415,30,1,194350,299000,2,0,59800,1,0,59800,239200,179400
01SCS19E130100,AR.TUC-SD024,20ARSD0515,L,1,204750,315000,2,0,63000,1,0,63000,252000,189000
01SCS19E130101,ESH.AR-QE0004,00ARQE0023,ALL,1,39800,140000,2,0,90000,1,0,10000,50000,40000
01SCS19E130101,ESH.AR-RC0040,00ARRC0228,L,1,42000,135000,2,0,67500,1,0,13500,67500,54000
01SCS19E130101,ESH.AR-RD0020,00ARRD0189,L,1,43000,150000,2,0,82500,1,0,13500,67500,54000
01SCS19E130101,ESH.AR-RJ0023,00ARRJ0218,NON,1,18000,75000,2,0,22500,1,0,10500,52500,42000
01SCS19E130102,AR.ESB-RK009,20ARRK0362,M,1,87750,135000,2,0,27000,1,0,27000,108000,81000
01SCS19E130103,AR.ESB-SD009,20ARSD0179,S,1,91000,140000,2,0,28000,1,0,28000,112000,84000
01SCS19E130104,AR.PUB-SE002,20ARSE0007,L,1,97500,150000,2,0,30000,1,0,30000,120000,90000
01SCS19E130104,BSC.AR-RD0001,00ARRD0004,XL,1,155,450000,2,0,275000,1,0,35000,175000,140000
01SCS19E130105,AR.STY-RK003,20ARRK0525,ALL,1,61750,95000,2,0,19000,1,0,19000,76000,57000
01SCS19E130105,AR.STY-SA006,20ARSA0065,ALL,1,61750,95000,2,0,19000,1,0,19000,76000,57000
01SCS19E130106,AR.STY-RK007,20ARRK0529,ALL,1,61750,95000,2,0,19000,1,0,19000,76000,57000
01SCS19E130106,ESH.AR-RD0024,00ARRD0228,M,1,145000,435000,2,0,260000,1,0,35000,175000,140000
01SCS19E130107,AR.FHL-SC001,20ARSC0329,XL,1,91000,140000,2,0,28000,1,0,28000,112000,84000
01SCS19E130108,BSC.AR-SB0011,00ARSB0098,L,1,44500,135000,2,0,40500,1,0,18900,94500,75600
01SCS19E130109,AR.ESB-SC017,20ARSC0460,S,1,91000,140000,2,0,28000,1,0,28000,112000,84000
01SCS19E130109,AR.PUB-SE012,20ARSE0045,S,1,97500,150000,2,0,30000,1,0,30000,120000,90000
01SCS19E130110,BSC.AR-RC0039,00ARRC0289,L,1,155000,450000,2,0,275000,1,0,35000,175000,140000
01SCS19E130111,AR.TUC-SB007,20ARSB0035,ALL,1,61750,95000,2,0,19000,1,0,19000,76000,57000
01SCS19E130111,BSC.AR-RH0017,00ARRH0077,XL,1,120000,315000,2,0,94500,1,0,44100,220500,176400
01SCS19E130111,BSC.AR-SC0018,00ARSC0127,XL,1,44500,159000,2,0,47700,1,0,22260,111300,89040
01SCS19E130111,BSC.AR-SD0039,00ARSD0212,M,1,125000,315000,2,0,94500,1,0,44100,220500,176400
01SCS19E130112,BSC.AR-RH0020,00ARRH0117,L,1,52000,155000,2,0,46500,1,0,21700,108500,86800
01SCS19E130112,BSC.AR-RK0008,00ARRK0079,L,1,52000,155000,2,0,46500,1,0,21700,108500,86800
01SCS19E130113,ESH.AR-SD0045,00ARSD0404,S,1,125000,315000,2,0,94500,1,0,44100,220500,176400
01SCS19E130114,BSC.AR-RE0015,00ARRE0108,NON,1,35000,120000,2,0,36000,1,0,16800,84000,67200
01SCS19E130115,BSC.AR-QH0001,00ARQH0005,ALL,1,37800,140000,2,0,90000,1,0,10000,50000,40000
01SCS19E130116,BSC.AR-SA0006,00ARSA0027,M,1,44500,135000,2,0,40500,1,0,18900,94500,75600
01SCS19E130116,BSC.AR-SD0018,00ARSD0123,NON,1,45000,150000,2,0,45000,1,0,21000,105000,84000
01SCS19E130116,BSC.AR-SD0043,00ARSD0231,S,1,44500,159000,2,0,47700,1,0,22260,111300,89040
01SCS19E130116,BSC.AR-SD0043,00ARSD0232,M,1,44500,159000,2,0,47700,1,0,22260,111300,89040
01SCS19E130116,ESH.AR-RF0007,00ARRF0043,M,1,150000,395000,2,0,220000,1,0,35000,175000,140000
01SCS19E130117,ESH.AR-SD0043,00ARSD0395,M,1,125000,315000,2,0,94500,1,0,44100,220500,176400
01SCS19E130118,ESH.AR-RD0003,00ARRD0028,34,1,110000,350000,2,0,175000,1,0,35000,175000,140000
01SCS19E130119,ESH.AR-SA0015,00ARSA0109,S,1,122500,350000,2,0,105000,1,0,49000,245000,196000
01SCS19E130120,AR.MKV-QH011,20ARQH0216,ALL,1,175500,270000,2,0,135000,1,0,33750,135000,101250
01SCS19E130121,ESH.AR-RB0030,00ARRB0164,34,1,130000,350000,2,0,175000,1,0,35000,175000,140000
01SCS19E130122,AR.FHL-SC001,20ARSC0327,M,1,91000,140000,2,0,28000,1,0,28000,112000,84000
01SCS19E130123,AR.ESB-SE004,20ARSE0250,S,1,94250,145000,2,0,29000,1,0,29000,116000,87000
01SCS19E130123,BE.RAK-SA019,00BESA0073,L,1,91000,140000,2,0,28000,1,0,28000,112000,84000
01SCS19E130123,BSC.AR-SC0042,00ARSC0277,M,1,135000,375000,2,0,112500,1,0,52500,262500,210000
01SCS19E130123,BSC.AR-SD0054,00ARSD0287,NON,1,50000,150000,2,0,45000,1,0,21000,105000,84000
01SCS19E130124,ESH.AR-SA0016,00ARSA0115,NON,1,55000,150000,2,0,45000,1,0,21000,105000,84000
01SCS19E130125,AR.CPT-SC013,20ARSC0484,M,1,94250,145000,2,0,29000,1,0,29000,116000,87000
01SCS19E130125,ESH.AR-SC0015,00ARSC0121,M,1,44000,135000,2,0,40500,1,0,18900,94500,75600
01SCS19E130126,BSC.AR-SD0064,00ARSD0341,L,1,125000,315000,2,0,94500,1,0,44100,220500,176400
01SCS19E130127,AR.REC-SD024,20ARSD0071,ALL,1,117000,180000,2,0,54000,1,0,31500,126000,94500
01SCS19E130128,BSC.AR-SC0012,00ARSC0073,M,1,44000,159000,2,0,47700,1,0,22260,111300,89040
01SCS19E130128,BSC.AR-SC0013,00ARSC0092,S,1,44000,135000,2,0,40500,1,0,18900,94500,75600
01SCS19E130128,BSC.AR-SD0043,00ARSD0231,S,1,44500,159000,2,0,47700,1,0,22260,111300,89040
01SCS19E130129,AR.MKV-RL001,20ARRL0238,XL,1,204750,315000,2,0,63000,1,0,63000,252000,189000
01SCS19E130130,BSC.AR-SD0027,00ARSD0158,L,1,125000,315000,2,0,94500,1,0,44100,220500,176400
01SCS19E130131,ESH.AR-SC0027,00ARSC0261,S,1,125000,315000,2,0,94500,1,0,44100,220500,176400
01SCS19E130132,AR.YD-RL020,20ARRL0058,ALL,1,94250,145000,2,0,72500,1,0,18125,72500,54375
01SCS19E130133,AR.HLW-SC004,20ARSC0127,M,1,195000,300000,2,0,90000,1,0,52500,210000,157500
01SCS19E130134,AR.MDG-RL008,20ARRL0468,L,1,185250,285000,2,0,85500,1,0,49875,199500,149625
01SCS19E130134,AR.MYA-SC001,20ARSC0039,L,1,220350,339000,2,0,101700,1,0,59325,237300,177975
01SCS19E130135,AR.ESB-SC003,20ARSC0419,M,1,91000,140000,2,0,28000,1,0,28000,112000,84000
01SCS19E130135,AR.PUB-SE010,20ARSE0038,M,1,97500,150000,2,0,30000,1,0,30000,120000,90000
01SCS19E130135,BSC.AR-RH0008,00ARRH0051,L,1,110000,350000,2,0,105000,1,0,49000,245000,196000
01SCS19E130136,BSC.AR-RI0006,00ARRI0020,L,1,43000,135000,2,0,40500,1,0,18900,94500,75600
01SCS19E130137,AR.REC-SD021,20ARSD0062,M,1,224250,345000,2,0,103500,1,0,60375,241500,181125
01SCS19E130138,AR.PCT-RK001,20ARRK0249,ALL,1,178750,275000,2,0,55000,1,0,55000,220000,165000
01SCS19E130139,BSC.AR-RJ0012,00ARRJ0085,L,1,44500,135000,2,0,40500,1,0,18900,94500,75600
01SCS19E130139,BSC.AR-SD0043,00ARSD0233,L,1,44500,159000,2,0,47700,1,0,22260,111300,89040
01SCS19E130140,BE.RAK-RL039,00BERL0145,ALL,1,97500,150000,2,0,30000,1,0,30000,120000,90000
01SCS19E130141,AR.SMD-RH003,20ARRH0399,M,1,211250,325000,2,0,97500,1,0,56875,227500,170625
01SCS19E130142,AR.PUB-SE020,20ARSE0077,M,1,159250,245000,2,0,49000,1,0,49000,196000,147000
01SCS19E130143,AR.STY-RK013,20ARRK0535,ALL,1,61750,95000,2,0,19000,1,0,19000,76000,57000
01SCS19E130143,AR.STY-SE004,20ARSE0122,ALL,1,55250,85000,2,0,17000,1,0,17000,68000,51000
01SCS19E130144,AR.REC-SD009,20ARSD0033,S,1,178750,275000,2,0,82500,1,0,48125,192500,144375
01SCS19E130145,AR.STY-SA003,20ARSA0062,ALL,1,61750,95000,2,0,19000,1,0,19000,76000,57000
01SCS19E130145,AR.STY-SB010,20ARSB0497,ALL,1,51350,79000,2,0,15800,1,0,15800,63200,47400
01SCS19E130146,AR.BPH-RK003,20ARRK0046,S,1,103350,159000,2,0,47700,1,0,27825,111300,83475
01SCS19E130146,AR.TUC-RC005,20ARRC0072,S,1,87750,135000,2,0,67500,1,0,16875,67500,50625
01SCS19E130146,BSC.AR-SC0004,00ARSC0031,M,1,125000,315000,2,0,94500,1,0,44100,220500,176400
01SCS19E130147,AR.MKV-SD007,20ARSD0411,34,1,117000,180000,2,0,90000,1,0,22500,90000,67500
01SCS19E130147,AR.SMD-QF005,20ARQF0705,XL,1,104000,160000,2,0,48000,1,0,28000,112000,84000
01SCS19E130147,AR.STY-SA014,20ARSA0073,ALL,1,51350,79000,2,0,15800,1,0,15800,63200,47400
01SCS19E130147,AR.STY-SE004,20ARSE0122,ALL,1,55250,85000,2,0,17000,1,0,17000,68000,51000
01SCS19E130147,ARN.AR-SB0002,00ARSB0087,NON,1,149400,249000,2,0,49800,1,0,59760,199200,139440
01SCS19E130148,BSC.AR-SD0043,00ARSD0233,L,1,44500,159000,2,0,47700,1,0,22260,111300,89040
01SCS19E130148,ESH.AR-SD0044,00ARSD0401,XL,1,125000,315000,2,0,94500,1,0,44100,220500,176400
01SCS19E130149,ESH.AR-SD0027,00ARSD0272,L,1,44000,135000,2,0,40500,1,0,18900,94500,75600
01SCS19E130149,THR.AR-RK0002,00ARRK0162,M,1,332000,415000,2,0,41500,1,0,56025,373500,317475
01SCS19E130150,ESH.AR-RC0028,00ARRC0189,ALL,1,45000,150000,2,0,100000,1,0,10000,50000,40000
01SCS19E130151,ESH.AR-RE0002,00ARRE0006,M,1,42000,135000,2,0,67500,1,0,13500,67500,54000
01SCS19E130151,ESH.AR-RE0007,00ARRE0026,M,1,42000,135000,2,0,67500,1,0,13500,67500,54000
01SCS19E130152,ESH.AR-QK0012,00ARQK0073,L,1,100000,310000,2,0,150000,1,0,32000,160000,128000
01SCS19E130153,AR.PUB-SE010,20ARSE0038,M,1,97500,150000,2,0,30000,1,0,30000,120000,90000
01SCS19E130153,AR.TUC-RL007,20ARRL0323,M,1,204750,315000,2,0,63000,1,0,63000,252000,189000
01SCS19E130153,AR.TUC-SD019,20ARSD0494,M,1,94250,145000,2,0,29000,1,0,29000,116000,87000
01SCS19E130153,BSC.AR-SB0012,00ARSB0104,L,1,110000,325000,2,0,97500,1,0,45500,227500,182000
01SCS19E140001,BSC.AR-SA0002,00ARSA0006,M,1,120000,315000,2,0,94500,1,0,44100,220500,176400
01SCS19E140002,BSC.AR-RJ0005,00ARRJ0055,S,1,94500,135000,2,0,40500,1,0,18900,94500,75600
01SCS19E140003,AR.MPR-SE001,20ARSE0139,L,1,97500,150000,2,0,45000,1,0,26250,105000,78750
01SCS19E140004,AR.PUB-SE025,20ARSE0097,L,1,159250,245000,2,0,49000,1,0,49000,196000,147000
01SCS19E140005,AR.MPR-SE002,20ARSE0141,S,1,97500,150000,2,0,45000,1,0,26250,105000,78750
01SCS19E140006,AR.ESB-RE016,20ARRE0383,L,1,94250,145000,2,0,72500,1,0,18125,72500,54375
01SCS19E140006,ESH.AR-RI0016,00ARRI0144,NON,1,65000,185000,2,0,55500,1,0,25900,129500,103600
01SCS19E140007,AR.STY-RK002,20ARRK0524,ALL,1,61750,95000,2,0,19000,1,0,19000,76000,57000
01SCS19E140008,ESH.AR-PL0032,00ARPL0231,ALL,1,39800,140000,2,0,90000,1,0,10000,50000,40000
01SCS19E140008,ESH.AR-PL0035,00ARPL0234,ALL,1,39800,140000,2,0,90000,1,0,10000,50000,40000
01SCS19E140009,AR.FHL-SC008,20ARSC0351,ALL,1,110500,170000,2,0,34000,1,0,34000,136000,102000
01SCS19E140010,AR.MKV-RJ025,20ARRJ0219,ALL,1,97500,150000,2,0,30000,1,0,30000,120000,90000
01SCS19E140011,BSC.AR-SA0018,00ARSA0060,M,1,44000,135000,2,0,40500,1,0,18900,94500,75600
01SCS19E140012,ESH.AR-RF0007,00ARRF0042,S,1,150000,395000,2,0,220000,1,0,35000,175000,140000
01SCS19E140013,BSC.AR-SD0053,00ARSD0283,S,1,44000,159000,2,0,47700,1,0,22260,111300,89040
01SCS19E140014,ESH.AR-SB0031,00ARSB0206,L,1,44500,135000,2,0,40500,1,0,18900,94500,75600
01SCS19E140014,ESH.AR-SC0028,00ARSC0267,L,1,44500,135000,2,0,40500,1,0,18900,94500,75600
01SCS19E140015,BSC.AR-RC0024,00ARRC0165,ALL,1,43000,185000,2,0,85000,1,0,20000,100000,80000
01SCS19E140015,ESH.AR-RJ0023,00ARRJ0218,NON,1,18000,75000,2,0,22500,1,0,10500,52500,42000
01SCS19E140015,ESH.AR-SB0026,00ARSB0158,NON,1,35300,120000,2,0,36000,1,0,16800,84000,67200
01SCS19E140016,BSC.AR-SB0008,00ARSB0079,M,1,44500,135000,2,0,40500,1,0,18900,94500,75600
01SCS19E140017,DKS.AR-SE0007,00ARSE0152,30,1,417272,696000,2,0,69600,1,0,93960,626400,532440
01SCS19E140018,BSC.AR-RL0018,00ARRL0110,M,1,125000,315000,2,0,94500,1,0,44100,220500,176400
01SCS19E140019,AR.SMD-RH008,20ARRH0756,L,1,87750,135000,2,0,40500,1,0,23625,94500,70875
01SCS19E140020,AR.ESB-SD005,20ARSD0113,M,1,91000,140000,2,0,28000,1,0,28000,112000,84000
01SCS19E140021,AR.MPR-SE009,20ARSE0169,S,1,97500,150000,2,0,45000,1,0,26250,105000,78750
01SCS19E140022,BSC.AR-RI0015,00ARRI0057,XL,1,94500,135000,2,0,40500,1,0,18900,94500,75600
01SCS19E140023,AR.ESB-SC013,20ARSC0438,M,1,198250,305000,2,0,61000,1,0,61000,244000,183000
01SCS19E140024,AR.MKV-SB008,20ARSB0332,M,1,292500,450000,2,0,90000,1,0,90000,360000,270000
01SCS19E140025,AR.ESB-SD005,20ARSD0113,M,1,91000,140000,2,0,28000,1,0,28000,112000,84000
01SCS19E140025,AR.MYA-RK001,20ARRK0002,32,1,220350,339000,2,0,101700,1,0,59325,237300,177975
01SCS19E140026,BSC.AR-RC0034,00ARRC0234,S,1,120000,360000,2,0,185000,1,0,35000,175000,140000
01SCS19E140027,BSC.AR-RJ0013,00ARRJ0088,M,1,44500,135000,2,0,40500,1,0,18900,94500,75600
01SCS19E140027,BSC.AR-SD0062,00ARSD0337,NON,1,45000,150000,2,0,45000,1,0,21000,105000,84000
01SCS19E140027,ESH.AR-SA0004,00ARSA0056,M,1,44500,135000,2,0,40500,1,0,18900,94500,75600
01SCS19E140028,AR.ESB-RH013,20ARRH0484,XL,1,87750,135000,2,0,67500,1,0,16875,67500,50625
01SCS19E140028,AR.ESB-SB003,20ARSB0103,XL,1,100750,155000,2,0,31000,1,0,31000,124000,93000
01SCS19E140029,AR.PUB-SB011,20ARSB0018,34,1,211250,325000,2,0,65000,1,0,65000,260000,195000
01SCS19E140030,AR.PUB-SE006,20ARSE0022,M,1,97500,150000,2,0,30000,1,0,30000,120000,90000
01SCS19E140031,BSC.AR-SD0004,00ARSD0014,M,1,44000,159000,2,0,47700,1,0,22260,111300,89040
01SCS19E140032,ESH.AR-SC0032,00ARSC0280,S,1,44500,135000,2,0,40500,1,0,18900,94500,75600
01SCS19E140033,ESH.AR-RK0015,00ARRK0191,NON,1,43000,150000,2,0,45000,1,0,21000,105000,84000
01SCS19E140033,ESH.AR-SA0002,00ARSA0041,NON,1,55000,150000,2,0,45000,1,0,21000,105000,84000
01SCS19E140034,AR.ESB-RE010,20ARRE0364,M,1,87750,135000,2,0,67500,1,0,16875,67500,50625
01SCS19E140034,AR.TUC-RC005,20ARRC0073,M,1,87750,135000,2,0,67500,1,0,16875,67500,50625
01SCS19E140035,AR.MPR-SE012,20ARSE0183,L,1,97500,150000,2,0,45000,1,0,26250,105000,78750
01SCS19E140036,AR.PUB-SE030,20ARSE0118,XL,1,224250,345000,2,0,69000,1,0,69000,276000,207000
01SCS19E140037,AR.MPR-SE006,20ARSE0158,M,1,97500,150000,2,0,45000,1,0,26250,105000,78750
01SCS19E140038,BSC.AR-SD0054,00ARSD0287,NON,1,50000,150000,2,0,45000,1,0,21000,105000,84000
01SCS19E140039,AR.MPR-SE003,20ARSE0145,S,1,97500,150000,2,0,45000,1,0,26250,105000,78750
01SCS19E140040,DKS.AR-SE0007,00ARSE0151,28,1,417272,696000,2,0,69600,1,0,93960,626400,532440
01SCS19E140041,AR.PUB-SE001,20ARSE0001,S,1,97500,150000,2,0,30000,1,0,30000,120000,90000
01SCS19E140042,BE.RAK-RL021,00BERL0068,L,1,211250,325000,2,0,65000,1,0,65000,260000,195000
01SCS19E140043,AR.TUC-SA029,20ARSA0164,ALL,1,87750,135000,2,0,27000,1,0,27000,108000,81000
01SCS19E140044,AR.MKV-RJ030,20ARRJ0447,M,1,165750,255000,2,0,51000,1,0,51000,204000,153000
01SCS19E140045,AR.MPR-SE028,20ARSE0231,M,1,230750,355000,2,0,71000,1,0,71000,284000,213000
01SCS19E140046,AR.REC-SD018,20ARSD0056,ALL,1,107250,165000,2,0,49500,1,0,28875,115500,86625
01SCS19E140047,AR.MKV-SC003,20ARSC0077,ALL,1,87750,135000,2,0,27000,1,0,27000,108000,81000
01SCS19E140048,AR.PUB-SE010,20ARSE0037,S,1,97500,150000,2,0,30000,1,0,30000,120000,90000
01SCS19E140048,AR.PUB-SE021,20ARSE0080,M,1,159250,245000,2,0,49000,1,0,49000,196000,147000
01SCS19E140049,BE.RAK-SB010,00BESB0049,XL,1,201500,310000,2,0,62000,1,0,62000,248000,186000
01SCS19E140050,ESH.AR-RC0040,00ARRC0228,L,1,42000,135000,2,0,67500,1,0,13500,67500,54000
01SCS19E140050,ESH.AR-RD0021,00ARRD0193,L,1,42000,135000,2,0,67500,1,0,13500,67500,54000
01SCS19E140051,BSC.AR-SD0058,00ARSD0294,NON,1,50000,150000,2,0,45000,1,0,21000,105000,84000
01SCS19E140052,ESH.AR-RC0040,00ARRC0228,L,1,42000,135000,2,0,67500,1,0,13500,67500,54000
01SCS19E140052,ESH.AR-RE0008,00ARRE0031,L,1,42000,135000,2,0,67500,1,0,13500,67500,54000
01SCS19E140053,BSC.AR-SD0022,00ARSD0129,M,1,44000,159000,2,0,47700,1,0,22260,111300,89040
01SCS19E140054,ESH.AR-RA0017,00ARRA0074,ALL,1,40000,140000,2,0,90000,1,0,10000,50000,40000
01SCS19E140055,ESH.AR-RD0024,00ARRD0229,L,1,145000,435000,2,0,260000,1,0,35000,175000,140000
01SCS19E140056,AR.STY-SB007,20ARSB0494,ALL,1,55250,85000,2,0,17000,1,0,17000,68000,51000
01SCS19E140056,BSC.AR-SD0043,00ARSD0233,L,1,44500,159000,2,0,47700,1,0,22260,111300,89040
01SCS19E140057,ESH.AR-RE0004,00ARRE0014,M,1,42000,135000,2,0,67500,1,0,13500,67500,54000
01SCS19E140057,ESH.AR-RE0007,00ARRE0025,S,1,42000,135000,2,0,67500,1,0,13500,67500,54000
01SCS19E140058,BSC.AR-RL0018,00ARRL0110,M,1,125000,315000,2,0,94500,1,0,44100,220500,176400
01SCS19E140059,AR.ESB-SE007,20ARSE0263,M,1,94250,145000,2,0,29000,1,0,29000,116000,87000
01SCS19E140060,AR.MKV-SC002,20ARSC0073,28,1,117000,180000,2,0,36000,1,0,36000,144000,108000
01SCS19E140060,AR.SMD-SD012,20ARSD0565,S,1,87750,135000,2,0,27000,1,0,27000,108000,81000
01SCS19E140060,ESH.AR-RJ0005,00ARRJ0027,S,1,94500,135000,2,0,40500,1,0,18900,94500,75600
01SCS19E140061,AR.CPT-SD006,20ARSD0436,XL,1,200850,309000,2,0,61800,1,0,61800,247200,185400
01SCS19E140061,AR.TUC-SD003,20ARSD0150,L,1,204750,315000,2,0,63000,1,0,63000,252000,189000
01SCS19E140062,BSC.AR-SD0027,00ARSD0158,L,1,125000,315000,2,0,94500,1,0,44100,220500,176400
01SCS19E140063,BSC.AR-SC0002,00ARSC0020,XL,1,52000,155000,2,0,46500,1,0,21700,108500,86800
01SCS19E140064,AR.PUB-SC015,20ARSC0361,M,1,97500,150000,2,0,30000,1,0,30000,120000,90000
01SCS19E140065,AR.PUB-SE014,20ARSE0055,L,1,159250,245000,2,0,49000,1,0,49000,196000,147000
01SCS19E140066,AR.MDS-RL002,20ARRL0359,M,1,117000,180000,2,0,36000,1,0,36000,144000,108000
01SCS19E140067,BSC.AR-SC0026,00ARSC0186,M,1,106400,350000,2,0,105000,1,0,49000,245000,196000
01SCS19E140068,AR.MPR-SE020,20ARSE0204,ALL,1,97500,150000,2,0,45000,1,0,26250,105000,78750
01SCS19E140068,AR.PUB-SE006,20ARSE0022,M,1,97500,150000,2,0,30000,1,0,30000,120000,90000
01SCS19E140068,BSC.AR-RJ0014,00ARRJ0092,M,1,43000,135000,2,0,40500,1,0,18900,94500,75600
01SCS19E140069,BSC.AR-RJ0002,00ARRJ0005,ALL,1,98000,140000,2,0,42000,1,0,19600,98000,78400
01SCS19E140070,AR.MKV-RC001,20ARRC0205,XL,1,214500,330000,2,0,66000,1,0,66000,264000,198000
01SCS19E140071,AR.TUC-RK002,20ARRK0082,M,1,204750,315000,2,0,63000,1,0,63000,252000,189000
01SCS19E140071,ESH.AR-SC0018,00ARSC0145,M,1,44000,135000,2,0,40500,1,0,18900,94500,75600
01SCS19E140072,ESH.AR-SD0043,00ARSD0395,M,1,125000,315000,2,0,94500,1,0,44100,220500,176400
01SCS19E140073,BSC.AR-SD0054,00ARSD0287,NON,1,50000,150000,2,0,45000,1,0,21000,105000,84000
01SCS19E140073,ESH.AR-RE0002,00ARRE0005,S,1,42000,135000,2,0,67500,1,0,13500,67500,54000
01SCS19E140073,ESH.AR-RE0004,00ARRE0014,M,1,42000,135000,2,0,67500,1,0,13500,67500,54000
01SCS19E140073,ESH.AR-RE0004,00ARRE0016,XL,1,42000,135000,2,0,67500,1,0,13500,67500,54000
01SCS19E140073,ESH.AR-RE0009,00ARRE0036,XL,1,42000,135000,2,0,67500,1,0,13500,67500,54000
01SCS19E140074,AR.CPT-SD006,20ARSD0436,XL,1,200850,309000,2,0,61800,1,0,61800,247200,185400
01SCS19E140074,BSC.AR-QJ0014,00ARQJ0113,M,1,100000,310000,2,0,150000,1,0,32000,160000,128000
01SCS19E140075,ESH.AR-SD0044,00ARSD0398,S,1,125000,315000,2,0,94500,1,0,44100,220500,176400
01SCS19E140076,BSC.AR-RK0002,00ARRK0053,S,1,43000,135000,2,0,40500,1,0,18900,94500,75600
01SCS19E140076,BSC.AR-SD0004,00ARSD0013,S,1,44000,159000,2,0,47700,1,0,22260,111300,89040
01SCS19E140077,AR.TUC-SD022,20ARSD0505,S,1,94250,145000,2,0,29000,1,0,29000,116000,87000
01SCS19E140078,AR.MPR-SB016,20ARSB0295,M,1,230750,355000,2,0,71000,1,0,71000,284000,213000
01SCS19E140078,AR.MPR-SE001,20ARSE0137,S,1,97500,150000,2,0,45000,1,0,26250,105000,78750
01SCS19E140078,AR.TUC-SB014,20ARSB0204,M,1,94250,145000,2,0,29000,1,0,29000,116000,87000
01SCS19E140079,AR.PUB-SC009,20ARSC0289,M,1,97500,150000,2,0,30000,1,0,30000,120000,90000
01SCS19E140080,AR.PUB-SC010,20ARSC0293,M,1,97500,150000,2,0,30000,1,0,30000,120000,90000
01SCS19E140080,AR.TUC-SD022,20ARSD0505,S,1,94250,145000,2,0,29000,1,0,29000,116000,87000
01SCS19E140081,AR.PUB-RK011,20ARRK0395,32,1,113750,175000,2,0,35000,1,0,35000,140000,105000
01SCS19E140082,BE.RAK-SB011,00BESB0053,L,1,201500,310000,2,0,62000,1,0,62000,248000,186000
01SCS19E140082,ESH.AR-SE0001,00ARSE0001,S,1,44000,135000,2,0,40500,1,0,18900,94500,75600
01SCS19E140083,AR.ESB-SE010,20ARSE0274,S,1,227500,350000,2,0,70000,1,0,70000,280000,210000
01SCS19E140084,BSC.AR-RK0002,00ARRK0053,S,1,43000,135000,2,0,40500,1,0,18900,94500,75600
01SCS19E140085,AR.TUC-SA041,20ARSA0273,ALL,1,94250,145000,2,0,29000,1,0,29000,116000,87000
01SCS19E140086,ESH.AR-SD0044,00ARSD0398,S,1,125000,315000,2,0,94500,1,0,44100,220500,176400
01SCS19E140087,ARN.AR-RK0001,00ARRK0219,M,1,43000,140000,2,0,28000,1,0,33600,112000,78400
01SCS19E140087,BSC.AR-SD0039,00ARSD0212,M,1,125000,315000,2,0,94500,1,0,44100,220500,176400
01SCS19E140088,AR.HMR-SD004,20ARSD0537,S,1,273000,420000,2,0,84000,1,0,84000,336000,252000
01SCS19E140089,ESH.AR-SA0010,00ARSA0091,NON,1,53000,155000,2,0,46500,1,0,21700,108500,86800
01SCS19E140090,BSC.AR-SD0043,00ARSD0233,L,1,44500,159000,2,0,47700,1,0,22260,111300,89040
01SCS19E140090,ESH.AR-SA0004,00ARSA0057,L,1,44500,135000,2,0,40500,1,0,18900,94500,75600
01SCS19E140091,BSC.AR-SD0048,00ARSD0248,NON,1,45000,135000,2,0,40500,1,0,18900,94500,75600
01SCS19E140092,AR.YRX-RH005,20ARRH0722,ALL,1,146250,225000,2,0,45000,1,0,45000,180000,135000
01SCS19E140092,ESH.AR-SD0041,00ARSD0370,S,1,125000,315000,2,0,94500,1,0,44100,220500,176400
01SCS19E140093,AR.PUB-SE015,20ARSE0059,L,1,159250,245000,2,0,49000,1,0,49000,196000,147000
01SCS19E140094,ESH.AR-SC0013,00ARSC0104,S,1,44500,135000,2,0,40500,1,0,18900,94500,75600
01SCS19E140094,ESH.AR-SC0037,00ARSC0302,NON,1,40000,140000,2,0,42000,1,0,19600,98000,78400
01SCS19E140095,AR.SMD-SD011,20ARSD0315,30,1,211250,325000,2,0,65000,1,0,65000,260000,195000
01SCS19E140096,AR.CLK-SA006,20ARSA0055,ALL,1,110500,170000,2,0,34000,1,0,34000,136000,102000
01SCS19E140097,AR.PUB-RJ002,20ARRJ0007,L,1,97500,150000,2,0,30000,1,0,30000,120000,90000
01SCS19E140097,BSC.AR-SB0011,00ARSB0097,M,1,44500,135000,2,0,40500,1,0,18900,94500,75600
01SCS19E140097,BSC.AR-SC0005,00ARSC0034,S,1,44500,159000,2,0,47700,1,0,22260,111300,89040
01SCS19E140097,ESH.AR-PL0032,00ARPL0231,ALL,1,39800,140000,2,0,90000,1,0,10000,50000,40000
01SCS19E140097,ESH.AR-QA0024,00ARQA0129,ALL,1,37800,140000,2,0,90000,1,0,10000,50000,40000
01SCS19E140097,ESH.AR-SC0017,00ARSC0140,S,1,44000,135000,2,0,40500,1,0,18900,94500,75600
01SCS19E140098,AR.TUC-SD012,20ARSD0467,L,1,94250,145000,2,0,29000,1,0,29000,116000,87000
01SCS19E140099,AR.BPH-RB005,20ARRB0443,L,1,182000,280000,2,0,140000,1,0,35000,140000,105000
01SCS19E140099,AR.ESB-RA001,20ARRA0007,M,1,65000,100000,2,0,50000,1,0,12500,50000,37500
01SCS19E140099,AR.ESB-SC020,20ARSC0469,ALL,1,68250,105000,2,0,31500,1,0,18375,73500,55125
01SCS19E140099,AR.GTW-RK001,20ARRK0373,ALL,1,103935,159900,2,0,47970,1,0,27982,111930,83948
01SCS19E140100,BSC.AR-SD0040,00ARSD0215,S,1,44500,159000,2,0,47700,1,0,22260,111300,89040
01SCS19E140101,ESH.AR-QH0004,00ARQH0004,ALL,1,37800,140000,2,0,90000,1,0,10000,50000,40000
01SCS19E140102,BSC.AR-SD0039,00ARSD0213,L,1,125000,315000,2,0,94500,1,0,44100,220500,176400
01SCS19E140103,AR.ESB-SE004,20ARSE0252,L,1,94250,145000,2,0,29000,1,0,29000,116000,87000
01SCS19E140103,BSC.AR-SB0007,00ARSB0076,L,1,44500,135000,2,0,40500,1,0,18900,94500,75600
01SCS19E140103,ESH.AR-SA0008,00ARSA0083,S,1,113450,350000,2,0,105000,1,0,49000,245000,196000
01SCS19E140104,BSC.AR-RH0018,00ARRH0078,S,1,120000,315000,2,0,94500,1,0,44100,220500,176400
01SCS19E140105,AR.FHL-SC002,20ARSC0331,M,1,91000,140000,2,0,28000,1,0,28000,112000,84000
01SCS19E140106,ESH.AR-SB0021,00ARSB0119,S,1,44500,135000,2,0,40500,1,0,18900,94500,75600
01SCS19E140106,ESH.AR-SD0018,00ARSD0138,L,1,125000,315000,2,0,94500,1,0,44100,220500,176400
01SCS19E140107,ESH.AR-SD0041,00ARSD0371,M,1,125000,315000,2,0,94500,1,0,44100,220500,176400
01SCS19E140108,AR.TUC-RK002,20ARRK0083,L,1,204750,315000,2,0,63000,1,0,63000,252000,189000
01SCS19E140108,ARN.AR-RK0001,00ARRK0218,S,1,43000,140000,2,0,28000,1,0,33600,112000,78400
01SCS19E140109,AR.MKV-RJ030,20ARRJ0448,L,1,165750,255000,2,0,51000,1,0,51000,204000,153000
01SCS19E140110,AR.MKV-RJ005,20ARRJ0161,M,1,91000,140000,2,0,28000,1,0,28000,112000,84000
01SCS19E140111,ESH.AR-SC0002,00ARSC0008,XL,1,44500,135000,2,0,40500,1,0,18900,94500,75600
01SCS19E140112,AR.REC-SD024,20ARSD0071,ALL,1,117000,180000,2,0,54000,1,0,31500,126000,94500
01SCS19E140112,BSC.AR-RI0035,00ARRI0210,L,1,220500,315000,2,0,94500,1,0,44100,220500,176400
01SCS19E140113,ESH.AR-RL0018,00ARRL0146,30,1,122500,175000,2,0,52500,1,0,24500,122500,98000
01SCS19E140113,ESH.AR-SC0032,00ARSC0281,M,1,44500,135000,2,0,40500,1,0,18900,94500,75600
01SCS19E140114,BSC.AR-SC0035,00ARSC0233,M,1,125000,315000,2,0,94500,1,0,44100,220500,176400
01SCS19E140115,ESH.AR-RB0028,00ARRB0155,36,1,130000,350000,2,0,175000,1,0,35000,175000,140000
01SCS19E140115,ESH.AR-RG0004,00ARRG0013,XL,1,90000,255000,2,0,76500,1,0,35700,178500,142800
01SCS19E140116,AR.YD-RL001,20ARRL0017,ALL,1,91000,140000,2,0,70000,1,0,17500,70000,52500
01SCS19E140116,ESH.AR-SD0025,00ARSD0264,L,1,44000,135000,2,0,40500,1,0,18900,94500,75600
01SCS19E140117,AR.CPT-SC001,20ARSC0243,ALL,1,97500,150000,2,0,30000,1,0,30000,120000,90000
01SCS19E140117,AR.TUC-RK028,20ARRK0132,S,1,94250,145000,2,0,29000,1,0,29000,116000,87000
01SCS19E140118,ESH.AR-SB0023,00ARSB0135,NON,1,52800,185000,2,0,55500,1,0,25900,129500,103600
01SCS19E140119,ESH.AR-QI0003,00ARQI0036,ALL,1,40000,140000,2,0,90000,1,0,10000,50000,40000
01SCS19E140120,AR.MPR-SB016,20ARSB0296,L,1,230750,355000,2,0,71000,1,0,71000,284000,213000
01SCS19E150001,AR.TUC-SA041,20ARSA0273,ALL,1,94250,145000,2,0,29000,1,0,29000,116000,87000
01SCS19E150002,AR.HLW-SC001,20ARSC0118,M,1,126750,195000,2,0,58500,1,0,34125,136500,102375
01SCS19E150002,AR.TUC-SD022,20ARSD0506,M,1,94250,145000,2,0,29000,1,0,29000,116000,87000
01SCS19E150003,ESH.AR-SA0010,00ARSA0091,NON,1,53000,155000,2,0,46500,1,0,21700,108500,86800
01SCS19E150004,AR.CPT-SB001,20ARSB0083,M,1,204750,315000,2,0,63000,1,0,63000,252000,189000
01SCS19E150005,ESH.AR-RD0008,00ARRD0055,NON,1,80500,115000,2,0,34500,1,0,16100,80500,64400
01SCS19E150006,ESH.AR-RB0021,00ARRB0133,L,1,95000,310000,2,0,150000,1,0,32000,160000,128000
01SCS19E150007,ESH.AR-RK0014,00ARRK0188,M,1,112500,350000,2,0,105000,1,0,49000,245000,196000
01SCS19E150008,BE.RAK-SB014,00BESB0068,L,1,91000,140000,2,0,28000,1,0,28000,112000,84000
01SCS19E150009,ESH.AR-RF0014,00ARRF0081,S,1,105000,315000,2,0,190000,1,0,25000,125000,100000
01SCS19E150010,BSC.AR-SD0004,00ARSD0013,S,1,44000,159000,2,0,47700,1,0,22260,111300,89040
01SCS19E150011,BSC.AR-SC0050,00ARSC0313,M,1,44000,159000,2,0,47700,1,0,22260,111300,89040
01SCS19E150011,ESH.AR-SC0028,00ARSC0266,M,1,44500,135000,2,0,40500,1,0,18900,94500,75600
01SCS19E150012,BSC.AR-RK0026,00ARRK0240,32,1,262500,375000,2,0,112500,1,0,52500,262500,210000
01SCS19E150012,BSC.AR-SD0022,00ARSD0129,M,1,44000,159000,2,0,47700,1,0,22260,111300,89040
01SCS19E150013,ESH.AR-SD0001,00ARSD0029,S,1,44500,135000,2,0,40500,1,0,18900,94500,75600
01SCS19E150014,BSC.AR-SC0012,00ARSC0073,M,1,44000,159000,2,0,47700,1,0,22260,111300,89040
01SCS19E150015,BSC.AR-SA0001,00ARSA0001,S,1,120000,315000,2,0,94500,1,0,44100,220500,176400
01SCS19E150016,AR.STY-SC006,20ARSC0205,ALL,1,77350,119000,2,0,23800,1,0,23800,95200,71400
01SCS19E150017,ESH.AR-SA0010,00ARSA0091,NON,1,53000,155000,2,0,46500,1,0,21700,108500,86800
01SCS19E150018,AR.SMD-RE005,20ARRE0776,M,1,100750,155000,2,0,46500,1,0,27125,108500,81375
01SCS19E150018,BSC.AR-RK0018,00ARRK0119,L,1,94500,135000,2,0,40500,1,0,18900,94500,75600
01SCS19E150019,BSC.AR-RI0026,00ARRI0135,NON,1,98000,140000,2,0,42000,1,0,19600,98000,78400
01SCS19E150020,BSC.AR-SD0028,00ARSD0161,M,1,125000,315000,2,0,94500,1,0,44100,220500,176400
01SCS19E150021,BSC.AR-RL0019,00ARRL0113,S,1,125000,315000,2,0,94500,1,0,44100,220500,176400
01SCS19E150022,ESH.AR-SA0010,00ARSA0091,NON,1,53000,155000,2,0,46500,1,0,21700,108500,86800
01SCS19E150023,AR.KNR-RK003,20ARRK0257,S,1,136500,210000,2,0,63000,1,0,36750,147000,110250
01SCS19E150023,ARN.AR-SB0001,00ARSB0086,NON,1,107400,179000,2,0,35800,1,0,42960,143200,100240
01SCS19E150023,BSC.AR-RI0009,00ARRI0032,L,1,94500,135000,2,0,40500,1,0,18900,94500,75600
01SCS19E150023,BSC.AR-SD0036,00ARSD0201,L,1,44500,159000,2,0,47700,1,0,22260,111300,89040
01SCS19E150023,BSC.AR-SD0060,00ARSD0332,NON,1,45000,140000,2,0,42000,1,0,19600,98000,78400
01SCS19E150024,AR.MKV-SC003,20ARSC0077,ALL,1,87750,135000,2,0,27000,1,0,27000,108000,81000
01SCS19E150025,AR.TUC-SC006,20ARSC0067,34,1,204750,315000,2,0,63000,1,0,63000,252000,189000
01SCS19E150026,BSC.AR-SC0045,00ARSC0297,NON,1,45000,150000,2,0,45000,1,0,21000,105000,84000
01SCS19E150026,BSC.AR-SC0050,00ARSC0313,M,1,44000,159000,2,0,47700,1,0,22260,111300,89040
01SCS19E150027,BSC.AR-SA0001,00ARSA0002,M,1,120000,315000,2,0,94500,1,0,44100,220500,176400
01SCS19E150028,BSC.AR-SC0050,00ARSC0313,M,1,44000,159000,2,0,47700,1,0,22260,111300,89040
01SCS19E150029,BSC.AR-RK0002,00ARRK0053,S,1,43000,135000,2,0,40500,1,0,18900,94500,75600
01SCS19E150030,BSC.AR-SC0013,00ARSC0093,M,1,44000,135000,2,0,40500,1,0,18900,94500,75600
01SCS19E150031,BSC.AR-SC0010,00ARSC0056,S,1,125000,315000,2,0,94500,1,0,44100,220500,176400
01SCS19E150032,AR.PUB-RL002,20ARRL0114,ALL,1,97500,150000,2,0,30000,1,0,30000,120000,90000
01SCS19E150033,AR.STY-SB007,20ARSB0494,ALL,1,55250,85000,2,0,17000,1,0,17000,68000,51000
01SCS19E150034,ESH.AR-SC0026,00ARSC0237,M,1,44500,135000,2,0,40500,1,0,18900,94500,75600
01SCS19E150035,BSC.AR-RJ0016,00ARRJ0099,S,1,43000,135000,2,0,40500,1,0,18900,94500,75600
01SCS19E150036,ESH.AR-RD0035,00ARRD0272,L,1,43000,135000,2,0,67500,1,0,13500,67500,54000
01SCS19E150036,ESH.AR-RE0019,00ARRE0206,L,1,43000,150000,2,0,82500,1,0,13500,67500,54000
01SCS19E150036,ESH.AR-SC0017,00ARSC0140,S,1,44000,135000,2,0,40500,1,0,18900,94500,75600
01SCS19E150037,AR.SMD-SD010,20ARSD0312,32,1,211250,325000,2,0,65000,1,0,65000,260000,195000
01SCS19E150038,ESH.AR-SD0044,00ARSD0398,S,1,125000,315000,2,0,94500,1,0,44100,220500,176400
01SCS19E150039,AR.CPT-SC013,20ARSC0486,XL,1,94250,145000,2,0,29000,1,0,29000,116000,87000
01SCS19E150040,BE.RAK-SA024,00BESA0096,S,1,104000,160000,2,0,32000,1,0,32000,128000,96000
01SCS19E150041,BSC.AR-SC0002,00ARSC0020,XL,1,52000,155000,2,0,46500,1,0,21700,108500,86800
01SCS19E150041,ESH.AR-RE0017,00ARRE0120,NON,1,157500,225000,2,0,67500,1,0,31500,157500,126000
01SCS19E150042,BSC.AR-RI0035,00ARRI0209,M,1,120000,315000,2,0,94500,1,0,44100,220500,176400
01SCS19E150043,AR.TUC-SB013,20ARSB0200,M,1,94250,145000,2,0,29000,1,0,29000,116000,87000
01SCS19E150044,AR.TUC-RI009,20ARRI0360,L,1,87750,135000,2,0,27000,1,0,27000,108000,81000
01SCS19E150044,AR.TUC-SB013,20ARSB0201,L,1,94250,145000,2,0,29000,1,0,29000,116000,87000
01SCS19E150044,BSC.AR-SD0026,00ARSD0154,L,1,44500,159000,2,0,47700,1,0,22260,111300,89040
01SCS19E150045,BSC.AR-SC0035,00ARSC0234,L,1,125000,315000,2,0,94500,1,0,44100,220500,176400
01SCS19E150046,AR.ASH-RJ001,20ARRJ0117,28,1,273000,420000,2,0,210000,1,0,52500,210000,157500
01SCS19E150046,ESH.AR-RK0011,00ARRK0045,S,1,44500,135000,2,0,40500,1,0,18900,94500,75600
01SCS19E150047,ESH.AR-RB0015,00ARRB0085,34,1,105000,285000,2,0,110000,1,0,35000,175000,140000
01SCS19E150048,BSC.AR-RI0032,00ARRI0151,L,1,120000,315000,2,0,94500,1,0,44100,220500,176400
01SCS19E150049,ESH.AR-RD0024,00ARRD0229,L,1,145000,435000,2,0,260000,1,0,35000,175000,140000
01SCS19E150050,AR.STY-SE006,20ARSE0124,ALL,1,55250,85000,2,0,17000,1,0,17000,68000,51000
01SCS19E150051,AR.MPR-SE028,20ARSE0230,S,1,230750,355000,2,0,71000,1,0,71000,284000,213000
01SCS19E150052,ESH.AR-SD0041,00ARSD0372,L,1,125000,315000,2,0,94500,1,0,44100,220500,176400
01SCS19E150053,AR.PUB-SC012,20ARSC0300,S,1,113750,175000,2,0,35000,1,0,35000,140000,105000
01SCS19E150054,AR.FHL-RJ002,20ARRJ0421,M,1,91000,140000,2,0,28000,1,0,28000,112000,84000
01SCS19E150054,ESH.AR-RJ0001,00ARRJ0012,M,1,44500,135000,2,0,40500,1,0,18900,94500,75600
01SCS19E150055,THR.AR-QG0009,00ARQG0038,L,1,1030000,1030000,2,0,103000,1,0,139050,927000,787950
01SCS19E150056,AR.CPT-SC001,20ARSC0243,ALL,1,97500,150000,2,0,30000,1,0,30000,120000,90000
01SCS19E150057,AR.MKV-SD004,20ARSD0233,34,1,117000,180000,2,0,36000,1,0,36000,144000,108000
01SCS19E150057,ESH.AR-RL0018,00ARRL0149,36,1,122500,175000,2,0,52500,1,0,24500,122500,98000
01SCS19E150058,ARN.AR-SD0001,00ARSD0220,M,1,44500,150000,1,0,15000,0,0,45000,135000,105000
01SCS19E150058,ARN.AR-SD0001,00ARSD0222,XL,1,44500,150000,1,0,15000,0,0,45000,135000,105000
01SCS19E150059,AR.MKV-SA010,20ARSA0315,34,1,214500,330000,2,0,66000,1,0,66000,264000,198000
01SCS19E150059,ESH.AR-SC0011,00ARSC0086,L,1,44000,135000,2,0,40500,1,0,18900,94500,75600
01SCS19E150060,BSC.AR-RJ0017,00ARRJ0106,XL,1,43000,135000,2,0,40500,1,0,18900,94500,75600
01SCS19E150061,BSC.AR-SC0010,00ARSC0056,S,1,125000,315000,2,0,94500,1,0,44100,220500,176400
01SCS19E150062,ESH.AR-SB0015,00ARSB0065,XL,1,125000,315000,2,0,94500,1,0,44100,220500,176400
01SCS19E150063,DKS.AR-SE0005,00ARSE0143,30,1,417272,696000,2,0,69600,1,0,93960,626400,532440
01SCS19E150064,AR.MPR-SE033,20ARSE0303,S,1,230750,355000,2,0,71000,1,0,71000,284000,213000
01SCS19E150065,ESH.AR-SC0007,00ARSC0063,XL,1,125000,350000,2,0,105000,1,0,49000,245000,196000
01SCS19E150066,AR.TUC-SB014,20ARSB0204,M,1,94250,145000,2,0,29000,1,0,29000,116000,87000
01SCS19E150066,ESH.AR-SE0001,00ARSE0002,M,1,44000,135000,2,0,40500,1,0,18900,94500,75600
01SCS19E150067,AR.TUC-SA021,20ARSA0140,L,1,87750,135000,2,0,27000,1,0,27000,108000,81000
01SCS19E150068,AR.MYA-RE005,20ARRE1309,34,1,207350,319000,2,0,159500,1,0,39875,159500,119625
01SCS19E150069,ESH.AR-RK0002,00ARRK0005,S,1,120000,315000,2,0,94500,1,0,44100,220500,176400
01SCS19E150069,ESH.AR-SD0045,00ARSD0404,S,1,125000,315000,2,0,94500,1,0,44100,220500,176400
01SCS19E150070,AR.ASH-RJ007,20ARSD0389,XL,1,91000,140000,2,0,42000,1,0,24500,98000,73500
01SCS19E150070,AR.ASH-RJ013,20ARRJ0495,S,1,94250,145000,2,0,43500,1,0,25375,101500,76125
01SCS19E150070,AR.FHL-SC005,20ARSC0342,S,1,110500,170000,2,0,34000,1,0,34000,136000,102000
01SCS19E150070,AR.REC-SD010,20ARSD0037,S,1,178750,275000,2,0,82500,1,0,48125,192500,144375
01SCS19E150070,AR.TUC-SD014,20ARSD0473,S,1,94250,145000,2,0,29000,1,0,29000,116000,87000
01SCS19E150070,ESH.AR-SB0017,00ARSB0100,NON,1,41000,120000,2,0,36000,1,0,16800,84000,67200
01SCS19E150071,ARN.AR-RK0005,00ARRK0234,28,1,110000,350000,2,0,70000,1,0,84000,280000,196000
01SCS19E150072,AR.PUB-RL031,20ARRL0439,ALL,1,97500,150000,2,0,30000,1,0,30000,120000,90000
01SCS19E150072,BSC.AR-SD0041,00ARSD0223,S,1,44500,159000,2,0,47700,1,0,22260,111300,89040
01SCS19E150073,BSC.AR-SD0026,00ARSD0152,S,1,44500,159000,2,0,47700,1,0,22260,111300,89040
01SCS19E150074,AR.STY-SB010,20ARSB0497,ALL,1,51350,79000,2,0,15800,1,0,15800,63200,47400
01SCS19E150075,ESH.AR-QI0003,00ARQI0036,ALL,1,40000,140000,2,0,90000,1,0,10000,50000,40000
01SCS19E150076,ESH.AR-QH0026,00ARQH0137,ALL,1,39700,140000,2,0,90000,1,0,10000,50000,40000
01SCS19E150077,BSC.AR-SC0050,00ARSC0312,S,1,44000,159000,2,0,47700,1,0,22260,111300,89040
01SCS19E150077,ESH.AR-QH0026,00ARQH0137,ALL,1,39700,140000,2,0,90000,1,0,10000,50000,40000
01SCS19E150078,BSC.AR-RI0006,00ARRI0020,L,1,43000,135000,2,0,40500,1,0,18900,94500,75600
01SCS19E150078,BSC.AR-SC0007,00ARSC0044,L,1,44000,135000,2,0,40500,1,0,18900,94500,75600
01SCS19E150078,ESH.AR-RA0017,00ARRA0074,ALL,1,40000,140000,2,0,90000,1,0,10000,50000,40000
01SCS19E150079,ESH.AR-SD0022,00ARSD0168,NON,1,43000,120000,2,0,36000,1,0,16800,84000,67200
01SCS19E150080,AR.MKV-RL004,20ARRL0247,M,1,253500,390000,2,0,78000,1,0,78000,312000,234000
01SCS19E150081,AR.SMD-SD011,20ARSD0317,34,1,211250,325000,2,0,65000,1,0,65000,260000,195000
01SCS19E150081,BSC.AR-RJ0012,00ARRJ0086,XL,1,94500,135000,2,0,40500,1,0,18900,94500,75600
01SCS19E150081,ESH.AR-RB0015,00ARRB0085,34,1,105000,285000,2,0,110000,1,0,35000,175000,140000
01SCS19E150081,ESH.AR-SE0001,00ARSE0004,XL,1,44000,135000,2,0,40500,1,0,18900,94500,75600
01SCS19E150082,ESH.AR-RE0002,00ARRE0005,S,1,42000,135000,2,0,67500,1,0,13500,67500,54000
01SCS19E150082,ESH.AR-RE0007,00ARRE0027,L,1,42000,135000,2,0,67500,1,0,13500,67500,54000
01SCS19E150083,ESH.AR-RJ0028,00ARRJ0236,NON,1,94500,135000,2,0,40500,1,0,18900,94500,75600
01SCS19E150084,AR.MPR-SE011,20ARSE0177,S,1,97500,150000,2,0,45000,1,0,26250,105000,78750
01SCS19E150085,BSC.AR-SC0048,00ARSC0304,S,1,44500,159000,2,0,47700,1,0,22260,111300,89040
01SCS19E150085,ESH.AR-SC0002,00ARSC0005,S,1,44500,135000,2,0,40500,1,0,18900,94500,75600
01SCS19E150086,BSC.AR-SD0059,00ARSD0331,NON,1,45000,140000,2,0,42000,1,0,19600,98000,78400
01SCS19E150087,AR.ESB-SE002,20ARSE0245,XL,1,204750,315000,2,0,63000,1,0,63000,252000,189000
01SCS19E150088,BSC.AR-SC0020,00ARSC0133,M,1,44000,159000,2,0,47700,1,0,22260,111300,89040
01SCS19E150088,ESH.AR-SD0045,00ARSD0405,M,1,125000,315000,2,0,94500,1,0,44100,220500,176400
01SCS19E150089,BE.RAK-SA001,00BESA0003,S,1,259350,399000,2,0,79800,1,0,79800,319200,239400
01SCS19E150090,BSC.AR-SC0010,00ARSC0056,S,1,125000,315000,2,0,94500,1,0,44100,220500,176400
01SCS19E150091,AR.YD-SC001,20ARSC0018,M,1,195000,300000,2,0,90000,1,0,52500,210000,157500
01SCS19E150091,ESH.AR-RH0006,00ARRH0058,NON,1,45000,150000,2,0,45000,1,0,21000,105000,84000
01SCS19E150091,ESH.AR-SA0008,00ARSA0084,M,1,113450,350000,2,0,105000,1,0,49000,245000,196000
01SCS19E150092,AR.TUC-SB002,20ARSB0028,M,1,204750,315000,2,0,63000,1,0,63000,252000,189000
01SCS19E150093,AR.MPR-SE003,20ARSE0148,XL,1,97500,150000,2,0,45000,1,0,26250,105000,78750
01SCS19E150093,AR.SMD-RI001,20ARRI0221,L,1,87750,135000,2,0,40500,1,0,23625,94500,70875
01SCS19E150094,ESH.AR-SC0002,00ARSC0005,S,1,44500,135000,2,0,40500,1,0,18900,94500,75600
01SCS19E150095,AR.MKV-SB003,20ARSB0316,34,1,165750,255000,2,0,51000,1,0,51000,204000,153000
01SCS19E150096,ESH.AR-SC0007,00ARSC0061,M,1,125000,350000,2,0,105000,1,0,49000,245000,196000
01SCS19E150097,BSC.AR-SC0040,00ARSC0258,M,1,52000,155000,2,0,46500,1,0,21700,108500,86800
01SCS19E150097,DKS.AR-SE0011,00ARSE0172,32,1,417272,696000,2,0,69600,1,0,93960,626400,532440
01SCS19E150098,AR.ESB-SE012,20ARSE0285,XL,1,198250,305000,2,0,61000,1,0,61000,244000,183000
01SCS19E150098,AR.SMD-RH002,20ARRH0072,L,1,211250,325000,2,0,97500,1,0,56875,227500,170625
01SCS19E150098,BSC.AR-SD0039,00ARSD0213,L,1,125000,315000,2,0,94500,1,0,44100,220500,176400
01SCS19E150098,THR.AR-RK0006,00ARRK0177,L,1,824000,1030000,2,0,103000,1,0,139050,927000,787950
01SCS19E150099,AR.ESB-SE004,20ARSE0250,S,1,94250,145000,2,0,29000,1,0,29000,116000,87000
01SCS19E150099,DKS.AR-SE0009,00ARSE0160,28,1,417272,696000,2,0,69600,1,0,93960,626400,532440
01SCS19E150100,ESH.AR-SB0015,00ARSB0063,M,1,125000,315000,2,0,94500,1,0,44100,220500,176400
01SCS19E150101,AR.HLW-SA006,20ARSA0093,ALL,1,71500,110000,2,0,22000,1,0,22000,88000,66000
01SCS19E150101,AR.PUB-SE007,20ARSE0026,M,1,97500,150000,2,0,30000,1,0,30000,120000,90000
01SCS19E150101,AR.TUC-SB014,20ARSB0205,L,1,94250,145000,2,0,29000,1,0,29000,116000,87000
01SCS19E150102,AR.TUC-SD001,20ARSD0141,M,1,204750,315000,2,0,63000,1,0,63000,252000,189000
01SCS19E150103,ESH.AR-SC0003,00ARSC0010,M,1,125000,350000,2,0,105000,1,0,49000,245000,196000
01SCS19E150104,AR.TUC-SD001,20ARSD0142,L,1,204750,315000,2,0,63000,1,0,63000,252000,189000
01SCS19E150104,BSC.AR-RJ0014,00ARRJ0093,L,1,94500,135000,2,0,40500,1,0,18900,94500,75600
01SCS19E150105,ESH.AR-RB0021,00ARRB0133,L,1,95000,310000,2,0,150000,1,0,32000,160000,128000
01SCS19E150105,ESH.AR-SD0026,00ARSD0267,M,1,44500,135000,2,0,40500,1,0,18900,94500,75600
01SCS19E150106,AR.REC-SD023,20ARSD0070,L,1,224250,345000,2,0,103500,1,0,60375,241500,181125
01SCS19E150107,AR.PUB-SE002,20ARSE0006,M,1,97500,150000,2,0,30000,1,0,30000,120000,90000
01SCS19E150108,BSC.AR-RH0027,00ARRH0171,34,1,245000,350000,2,0,105000,1,0,49000,245000,196000
01SCS19E150108,ESH.AR-SB0033,00ARSB0213,M,1,44500,135000,2,0,40500,1,0,18900,94500,75600
01SCS19E160001,SLT.AR-SB0023,00ARSB0189,S,1,235000,235000,2,0,23500,1,0,31725,211500,179775
01SCS19E160002,BSC.AR-RD0001,00ARRD0003,L,1,155,450000,2,0,275000,1,0,35000,175000,140000
01SCS19E160003,AR.CPT-SC009,20ARSC0272,S,1,94250,145000,2,0,29000,1,0,29000,116000,87000
01SCS19E160003,ESH.AR-SA0010,00ARSA0091,NON,1,53000,155000,2,0,46500,1,0,21700,108500,86800
01SCS19E160004,AR.ESB-QJ015,20ARQJ0096,ALL,1,91000,140000,2,0,70000,1,0,17500,70000,52500
01SCS19E160004,AR.PCT-RE010,20ARRE1432,L,1,81250,125000,2,0,62500,1,0,15625,62500,46875
01SCS19E160004,AR.PCT-RE013,20ARRE1441,L,1,81250,125000,2,0,62500,1,0,15625,62500,46875
01SCS19E160005,AR.SMD-SD010,20ARSD0311,30,1,211250,325000,2,0,65000,1,0,65000,260000,195000
01SCS19E160006,BSC.AR-SC0048,00ARSC0306,L,1,44500,159000,2,0,47700,1,0,22260,111300,89040
01SCS19E160006,BSC.AR-SD0005,00ARSD0019,L,1,44500,159000,2,0,47700,1,0,22260,111300,89040
01SCS19E160007,BSC.AR-SD0060,00ARSD0332,NON,1,45000,140000,2,0,42000,1,0,19600,98000,78400
01SCS19E160008,AR.PUB-RG005,20ARRG0036,L,1,97500,150000,2,0,30000,1,0,30000,120000,90000
01SCS19E160009,AR.CPT-SD011,20ARSD0455,L,1,94250,145000,2,0,29000,1,0,29000,116000,87000
01SCS19E160010,AR.FHL-SC003,20ARSC0336,L,1,91000,140000,2,0,28000,1,0,28000,112000,84000
01SCS19E160010,ARN.AR-SB0001,00ARSB0086,NON,1,107400,179000,2,0,35800,1,0,42960,143200,100240
01SCS19E160011,AR.HMR-SD007,20ARSD0545,M,1,243750,375000,2,0,75000,1,0,75000,300000,225000
01SCS19E160012,BSC.AR-RK0023,00ARRK0214,XL,1,120000,315000,2,0,94500,1,0,44100,220500,176400
01SCS19E160013,BSC.AR-RK0009,00ARRK0082,M,1,52000,155000,2,0,46500,1,0,21700,108500,86800
01SCS19E160013,BSC.AR-SA0002,00ARSA0006,M,1,120000,315000,2,0,94500,1,0,44100,220500,176400
01SCS19E160014,BSC.AR-SC0001,00ARSC0014,M,1,125000,315000,2,0,94500,1,0,44100,220500,176400
01SCS19E160015,ESH.AR-RD0020,00ARRD0190,XL,1,43000,150000,2,0,82500,1,0,13500,67500,54000
01SCS19E160015,ESH.AR-RE0002,00ARRE0007,L,1,42000,135000,2,0,67500,1,0,13500,67500,54000
01SCS19E160016,AR.CPT-SC013,20ARSC0485,L,1,94250,145000,2,0,29000,1,0,29000,116000,87000
01SCS19E160016,BSC.AR-SD0061,00ARSD0336,NON,1,45000,150000,2,0,45000,1,0,21000,105000,84000
01SCS19E160017,AR.PUB-RK011,20ARSD0350,L,1,113750,175000,2,0,35000,1,0,35000,140000,105000
01SCS19E160017,AR.TUC-SD005,20ARSD0159,XL,1,185250,285000,2,0,57000,1,0,57000,228000,171000
01SCS19E160017,ESH.AR-RB0006,00ARRB0046,34,1,90000,265000,2,0,90000,1,0,35000,175000,140000
01SCS19E160018,BSC.AR-RJ0014,00ARRJ0091,S,1,43000,135000,2,0,40500,1,0,18900,94500,75600
01SCS19E160018,BSC.AR-SD0004,00ARSD0013,S,1,44000,159000,2,0,47700,1,0,22260,111300,89040
01SCS19E160019,ESH.AR-SD0009,00ARSD0066,M,1,44500,135000,2,0,40500,1,0,18900,94500,75600
01SCS19E160019,ESH.AR-SD0026,00ARSD0267,M,1,44500,135000,2,0,40500,1,0,18900,94500,75600
01SCS19E160020,AR.SLT-RD018,20ARRD0050,32,1,505750,595000,2,0,59500,1,0,80325,535500,455175
01SCS19E160020,DKS.AR-SE0002,00ARSE0135,32,1,417272,696000,2,0,69600,1,0,93960,626400,532440
01SCS19E160021,ESH.AR-RJ0014,00ARRJ0181,L,1,44500,135000,2,0,40500,1,0,18900,94500,75600
01SCS19E160022,BSC.AR-RL0018,00ARRL0109,S,1,125000,315000,2,0,94500,1,0,44100,220500,176400
01SCS19E160023,ESH.AR-SD0022,00ARSD0168,NON,1,43000,120000,2,0,36000,1,0,16800,84000,67200
01SCS19E160024,BSC.AR-RI0009,00ARRI0032,L,1,94500,135000,2,0,40500,1,0,18900,94500,75600
01SCS19E160025,ARN.AR-SB0001,00ARSB0086,NON,1,107400,179000,2,0,35800,1,0,42960,143200,100240
01SCS19E160026,ESH.AR-RE0014,00ARRE0095,L,1,105000,330000,2,0,155000,1,0,35000,175000,140000
01SCS19E160027,ESH.AR-SD0038,00ARSD0343,S,1,122500,350000,2,0,105000,1,0,49000,245000,196000
01SCS19E160028,ESH.AR-SC0022,00ARSC0161,S,1,125000,315000,2,0,94500,1,0,44100,220500,176400
01SCS19E160029,AR.PUB-RK012,20ARRK0454,ALL,1,97500,150000,2,0,30000,1,0,30000,120000,90000
01SCS19E160030,AR.TUC-SD022,20ARSD0506,M,1,94250,145000,2,0,29000,1,0,29000,116000,87000
01SCS19E160031,AR.TUC-SD019,20ARSD0494,M,1,94250,145000,2,0,29000,1,0,29000,116000,87000
01SCS19E160031,AR.VRS-QJ008,20ARQJ0342,M,1,96850,149000,2,0,44700,1,0,26075,104300,78225
01SCS19E160032,BSC.AR-SC0044,00ARSC0296,NON,1,45000,150000,2,0,45000,1,0,21000,105000,84000
01SCS19E160033,BSC.AR-SD0027,00ARSD0156,S,1,125000,315000,2,0,94500,1,0,44100,220500,176400
01SCS19E160034,ESH.AR-RK0006,00ARRK0026,M,1,43000,135000,2,0,40500,1,0,18900,94500,75600
01SCS19E160035,AR.TUC-RK010,20ARRK0106,ALL,1,81250,125000,2,0,25000,1,0,25000,100000,75000
01SCS19E160036,BSC.AR-SD0043,00ARSD0232,M,1,44500,159000,2,0,47700,1,0,22260,111300,89040
01SCS19E160036,ESH.AR-RL0016,00ARRL0133,S,1,94500,135000,2,0,40500,1,0,18900,94500,75600
01SCS19E160037,BSC.AR-RL0020,00ARRL0118,M,1,125000,315000,2,0,94500,1,0,44100,220500,176400
01SCS19E160038,BSC.AR-RJ0019,00ARRJ0112,M,1,94500,135000,2,0,40500,1,0,18900,94500,75600
01SCS19E160039,ESH.AR-SB0011,00ARSB0051,S,1,125000,315000,2,0,94500,1,0,44100,220500,176400
01SCS19E160039,ESH.AR-SB0022,00ARSB0124,M,1,44000,135000,2,0,40500,1,0,18900,94500,75600
01SCS19E160040,AR.STY-SB010,20ARSB0497,ALL,1,51350,79000,2,0,15800,1,0,15800,63200,47400
01SCS19E160041,BSC.AR-SC0033,00ARSC0227,XL,1,125000,315000,2,0,94500,1,0,44100,220500,176400
01SCS19E160042,ESH.AR-SB0015,00ARSB0063,M,1,125000,315000,2,0,94500,1,0,44100,220500,176400
01SCS19E160043,AR.PUB-SD020,20ARSD0189,ALL,1,97500,150000,2,0,30000,1,0,30000,120000,90000
01SCS19E160044,ESH.AR-RJ0019,00ARRJ0206,NON,1,40000,115000,2,0,34500,1,0,16100,80500,64400
01SCS19E160045,AR.CPT-SD008,20ARSD0443,L,1,204750,315000,2,0,63000,1,0,63000,252000,189000
01SCS19E160046,BSC.AR-RC0034,00ARRC0236,L,1,120000,360000,2,0,185000,1,0,35000,175000,140000
01SCS19E160047,DKS.AR-SE0007,00ARSE0151,28,1,417272,696000,2,0,69600,1,0,93960,626400,532440
01SCS19E160048,AR.PUB-SE007,20ARSE0025,S,1,97500,150000,2,0,30000,1,0,30000,120000,90000
01SCS19E160048,BSC.AR-SD0059,00ARSD0331,NON,1,45000,140000,2,0,42000,1,0,19600,98000,78400
01SCS19E170001,BSC.AR-SA0002,00ARSA0006,M,1,120000,315000,2,0,94500,1,0,44100,220500,176400
01SCS19E170001,ESH.AR-RE0008,00ARRE0030,M,2,42000,135000,2,0,67500,1,0,13500,135000,108000
01SCS19E170002,BSC.AR-RK0002,00ARRK0053,S,1,43000,135000,2,0,40500,1,0,18900,94500,75600
01SCS19E170003,AR.SMD-RH005,20ARRH0743,M,1,211250,325000,2,0,97500,1,0,56875,227500,170625
01SCS19E170004,ESH.AR-SB0031,00ARSB0205,M,1,44500,135000,2,0,40500,1,0,18900,94500,75600
01SCS19E170005,BSC.AR-RH0017,00ARRH0074,S,1,120000,315000,2,0,94500,1,0,44100,220500,176400
01SCS19E170006,ESH.AR-SD0043,00ARSD0397,XL,1,125000,315000,2,0,94500,1,0,44100,220500,176400
01SCS19E170007,DKS.AR-SE0010,00ARSE0166,30,1,417272,696000,2,0,69600,1,0,93960,626400,532440
01SCS19E170008,AR.FHL-SC008,20ARSC0351,ALL,1,110500,170000,2,0,34000,1,0,34000,136000,102000
01SCS19E170009,ESH.AR-SA0013,00ARSA0097,S,1,44000,135000,2,0,40500,1,0,18900,94500,75600
01SCS19E170009,ESH.AR-SB0030,00ARSB0200,S,1,44000,135000,2,0,40500,1,0,18900,94500,75600
01SCS19E170010,BSC.AR-SC0021,00ARSC0148,NON,1,73000,220000,2,0,66000,1,0,30800,154000,123200
01SCS19E170011,AR.TUC-SD022,20ARSD0506,M,1,94250,145000,2,0,29000,1,0,29000,116000,87000
01SCS19E170012,BSC.AR-SB0009,00ARSB0084,L,1,44500,135000,2,0,40500,1,0,18900,94500,75600
01SCS19E170013,AR.TUC-RK020,20ARRK0116,ALL,1,42250,65000,2,0,13000,1,0,13000,52000,39000
01SCS19E170014,ESH.AR-SD0039,00ARSD0348,M,1,122500,350000,2,0,105000,1,0,49000,245000,196000
01SCS19E170015,BSC.AR-RI0032,00ARRI0151,L,1,120000,315000,2,0,94500,1,0,44100,220500,176400
01SCS19E170016,ESH.AR-RJ0019,00ARRJ0206,NON,1,40000,115000,2,0,34500,1,0,16100,80500,64400
01SCS19E170017,AR.CPT-RL002,20ARRL0077,XL,1,94250,145000,2,0,29000,1,0,29000,116000,87000
01SCS19E170018,AR.MPR-SE003,20ARSE0146,M,1,97500,150000,2,0,45000,1,0,26250,105000,78750
01SCS19E170018,BSC.AR-QJ0014,00ARQJ0113,M,1,100000,310000,2,0,150000,1,0,32000,160000,128000
01SCS19E170018,ESH.AR-SD0010,00ARSD0070,M,1,44500,135000,2,0,40500,1,0,18900,94500,75600
01SCS19E170019,AR.ESB-SE012,20ARSE0284,L,1,198250,305000,2,0,61000,1,0,61000,244000,183000
01SCS19E170019,AR.HMR-SB024,20ARSB0412,34,1,211250,325000,2,0,65000,1,0,65000,260000,195000
01SCS19E170019,AR.MKV-SB009,20ARSB0533,L,1,97500,150000,2,0,30000,1,0,30000,120000,90000
01SCS19E170019,AR.TUC-SB014,20ARSB0203,S,1,94250,145000,2,0,29000,1,0,29000,116000,87000
01SCS19E170019,BSC.AR-RI0038,00ARRI0216,L,1,262500,375000,2,0,112500,1,0,52500,262500,210000
01SCS19E170020,AR.MPR-SB003,20ARSB0243,M,1,230750,355000,2,0,71000,1,0,71000,284000,213000
01SCS19E170021,AR.PUB-SD032,20ARSD0238,S,1,204750,315000,2,0,63000,1,0,63000,252000,189000
01SCS19E170021,AR.TUC-SD022,20ARSD0506,M,1,94250,145000,2,0,29000,1,0,29000,116000,87000
01SCS19E170022,AR.MYA-SC002,20ARSC0041,M,1,220350,339000,2,0,101700,1,0,59325,237300,177975
01SCS19E170023,AR.PUB-RL026,20ARRL0429,M,1,97500,150000,2,0,30000,1,0,30000,120000,90000
01SCS19E170024,AR.CPT-SD005,20ARSD0432,ALL,1,94250,145000,2,0,29000,1,0,29000,116000,87000
01SCS19E170025,AR.STY-SC006,20ARSC0205,ALL,1,77350,119000,2,0,23800,1,0,23800,95200,71400
01SCS19E170026,BSC.AR-RE0028,00ARRE0303,NON,1,35000,120000,2,0,36000,1,0,16800,84000,67200
01SCS19E170027,BSC.AR-RE0027,00ARRE0302,NON,1,35000,120000,2,0,36000,1,0,16800,84000,67200
01SCS19E170028,ESH.AR-SC0003,00ARSC0010,M,1,125000,350000,2,0,105000,1,0,49000,245000,196000
01SCS19E170029,BSC.AR-RK0002,00ARRK0054,M,1,43000,135000,2,0,40500,1,0,18900,94500,75600
01SCS19E170030,BSC.AR-SC0026,00ARSC0186,M,1,106400,350000,2,0,105000,1,0,49000,245000,196000
01SCS19E170031,AR.HMR-SB024,20ARSB0413,36,1,211250,325000,2,0,65000,1,0,65000,260000,195000
01SCS19E170032,BSC.AR-RE0028,00ARRE0303,NON,1,35000,120000,2,0,36000,1,0,16800,84000,67200
01SCS19E170033,AR.FHL-SE003,20ARSE0378,ALL,1,78000,120000,2,0,24000,1,0,24000,96000,72000
01SCS19E170034,ESH.AR-RJ0030,00ARRJ0238,NON,1,94500,135000,2,0,40500,1,0,18900,94500,75600
01SCS19E170035,AR.STY-SE003,20ARSE0121,ALL,1,55250,85000,2,0,17000,1,0,17000,68000,51000
01SCS19E170035,AR.STY-SE009,20ARSE0127,ALL,1,55250,85000,2,0,17000,1,0,17000,68000,51000
01SCS19E170035,BE.RAK-SC002,00BESC0002,ALL,1,22750,35000,2,0,7000,1,0,7000,28000,21000
01SCS19E170036,ESH.AR-SD0039,00ARSD0347,S,1,122500,350000,2,0,105000,1,0,49000,245000,196000
01SCS19E170037,BSC.AR-SA0022,00ARSA0113,NON,1,47500,140000,2,0,42000,1,0,19600,98000,78400
01SCS19E170038,BE.RAK-RL021,00BERL0067,M,1,211250,325000,2,0,65000,1,0,65000,260000,195000
01SCS19E170039,AR.MPR-SB003,20ARSB0243,M,1,230750,355000,2,0,71000,1,0,71000,284000,213000
01SCS19E170039,AR.MPR-SE003,20ARSE0146,M,1,97500,150000,2,0,45000,1,0,26250,105000,78750
01SCS19E170040,AR.MPR-SE003,20ARSE0145,S,1,97500,150000,2,0,45000,1,0,26250,105000,78750
01SCS19E170040,AR.MPR-SE025,20ARSE0218,S,1,230750,355000,2,0,71000,1,0,71000,284000,213000
01SCS19E170041,AR.ESB-SD016,20ARSD0336,S,1,91000,140000,2,0,28000,1,0,28000,112000,84000
01SCS19E170042,AR.CPT-RI003,20ARRI0051,XL,1,204750,315000,2,0,63000,1,0,63000,252000,189000
01SCS19E170043,AR.ESB-SC018,20ARSC0464,S,1,91000,140000,2,0,28000,1,0,28000,112000,84000
01SCS19E170044,BSC.AR-SD0027,00ARSD0156,S,1,125000,315000,2,0,94500,1,0,44100,220500,176400
01SCS19E170045,BSC.AR-RJ0016,00ARRJ0099,S,1,43000,135000,2,0,40500,1,0,18900,94500,75600
01SCS19E170045,ESH.AR-SE0001,00ARSE0001,S,1,44000,135000,2,0,40500,1,0,18900,94500,75600
01SCS19E170046,BE.RAK-RL020,00BERL0062,M,1,211250,325000,2,0,65000,1,0,65000,260000,195000
01SCS19E170047,BSC.AR-SB0018,00ARSB0142,L,1,44500,135000,2,0,40500,1,0,18900,94500,75600
01SCS19E170047,BSC.AR-SC0031,00ARSC0209,L,1,44500,135000,2,0,40500,1,0,18900,94500,75600
01SCS19E170048,AR.VRS-SB003,20ARSB0186,32,1,324350,499000,2,0,149700,1,0,87325,349300,261975
01SCS19E170049,AR.HLW-SA014,20ARSA0109,XL,1,100750,155000,2,0,46500,1,0,27125,108500,81375
01SCS19E170050,BSC.AR-SC0021,00ARSC0148,NON,1,73000,220000,2,0,66000,1,0,30800,154000,123200
01SCS19E170051,BSC.AR-SC0009,00ARSC0054,L,1,125000,315000,2,0,94500,1,0,44100,220500,176400
01SCS19E170052,AR.MKV-SB010,20ARSB0536,M,1,97500,150000,2,0,30000,1,0,30000,120000,90000
01SCS19E170052,ESH.AR-RH0016,00ARRH0092,M,1,43000,135000,2,0,40500,1,0,18900,94500,75600
01SCS19E170053,ESH.AR-SC0017,00ARSC0140,S,1,44000,135000,2,0,40500,1,0,18900,94500,75600
01SCS19E170054,ESH.AR-SA0006,00ARSA0073,L,1,44500,135000,2,0,40500,1,0,18900,94500,75600
01SCS19E170055,AR.TUC-SD022,20ARSD0507,L,1,94250,145000,2,0,29000,1,0,29000,116000,87000
01SCS19E170055,ESH.AR-SB0005,00ARSB0017,L,1,44000,135000,2,0,40500,1,0,18900,94500,75600
01SCS19E170056,ESH.AR-SD0021,00ARSD0164,S,1,125000,315000,2,0,94500,1,0,44100,220500,176400
01SCS19E170057,AR.TUC-RC005,20ARRC0075,XL,1,87750,135000,2,0,67500,1,0,16875,67500,50625
01SCS19E170057,ESH.AR-PK0010,00ARPK0081,ALL,1,39800,140000,2,0,90000,1,0,10000,50000,40000
01SCS19E170058,BSC.AR-SC0035,00ARSC0233,M,1,125000,315000,2,0,94500,1,0,44100,220500,176400
01SCS19E170059,AR.CPT-SC003,20ARSC0251,34,1,227500,350000,2,0,70000,1,0,70000,280000,210000
01SCS19E170059,AR.PUB-RI022,20ARRI0300,L,1,97500,150000,2,0,30000,1,0,30000,120000,90000
01SCS19E170059,AR.STY-RK007,20ARRK0529,ALL,1,61750,95000,2,0,19000,1,0,19000,76000,57000
01SCS19E170059,AR.VRS-SE002,20ARSE0318,ALL,1,70850,109000,2,0,32700,1,0,19075,76300,57225
01SCS19E170060,AR.PUB-SE011,20ARSE0042,M,1,97500,150000,2,0,30000,1,0,30000,120000,90000
01SCS19E170061,BSC.AR-SD0026,00ARSD0153,M,1,44500,159000,2,0,47700,1,0,22260,111300,89040
01SCS19E170062,BSC.AR-SD0009,00ARSD0099,S,1,44000,159000,2,0,47700,1,0,22260,111300,89040
01SCS19E170062,BSC.AR-SD0044,00ARSD0235,S,1,44500,159000,2,0,47700,1,0,22260,111300,89040
01SCS19E170063,BSC.AR-SC0019,00ARSC0129,M,1,44500,159000,2,0,47700,1,0,22260,111300,89040
01SCS19E170063,BSC.AR-SC0022,00ARSC0169,S,1,44500,135000,2,0,40500,1,0,18900,94500,75600
01SCS19E170063,BSC.AR-SD0046,00ARSD0244,M,1,44500,159000,2,0,47700,1,0,22260,111300,89040
01SCS19E170063,ESH.AR-RD0003,00ARRD0027,32,1,110000,350000,2,0,175000,1,0,35000,175000,140000
01SCS19E170063,ESH.AR-SB0031,00ARSB0204,S,1,44500,135000,2,0,40500,1,0,18900,94500,75600
01SCS19E170064,ESH.AR-SB0030,00ARSB0200,S,1,44000,135000,2,0,40500,1,0,18900,94500,75600
01SCS19E170064,ESH.AR-SD0006,00ARSD0053,S,1,44500,135000,2,0,40500,1,0,18900,94500,75600
01SCS19E170065,AR.ESB-SB004,20ARSB0105,M,1,91000,140000,2,0,28000,1,0,28000,112000,84000
01SCS19E170065,AR.TUC-SD022,20ARSD0506,M,1,94250,145000,2,0,29000,1,0,29000,116000,87000
01SCS19E170066,AR.TUC-SE017,20ARSE0427,M,1,146250,225000,2,0,45000,1,0,45000,180000,135000
01SCS19E170067,AR.YRX-RH002,20ARRH0719,ALL,1,172250,265000,2,0,53000,1,0,53000,212000,159000
01SCS19E170068,ESH.AR-SB0016,00ARSB0068,L,1,125000,315000,2,0,94500,1,0,44100,220500,176400
01SCS19E170069,AR.MKV-RE007,20ARRE0844,ALL,1,91000,140000,2,0,70000,1,0,17500,70000,52500
01SCS19E170070,ESH.AR-PL0035,00ARPL0234,ALL,1,39800,140000,2,0,90000,1,0,10000,50000,40000
01SCS19E170071,BSC.AR-SD0066,00ARSD0355,S,1,44500,159000,2,0,47700,1,0,22260,111300,89040
01SCS19E170072,ESH.AR-RC0005,00ARRC0066,M,1,95000,310000,2,0,150000,1,0,32000,160000,128000
01SCS19E170073,ESH.AR-RH0008,00ARRH0060,NON,1,45000,150000,2,0,45000,1,0,21000,105000,84000
01SCS19E170074,BSC.AR-RK0002,00ARRK0054,M,1,43000,135000,2,0,40500,1,0,18900,94500,75600
01SCS19E170075,AR.VCS-SC006,20ARSC0393,M,1,214500,330000,2,0,99000,1,0,57750,231000,173250
01SCS19E170076,AR.MPR-SE013,20ARSE0185,S,1,110500,170000,2,0,51000,1,0,29750,119000,89250
01SCS19E170076,AR.TUC-SC005,20ARSC0061,30,1,185250,285000,2,0,57000,1,0,57000,228000,171000
01SCS19E170076,AR.TUC-SE008,20ARSE0391,S,1,204750,315000,2,0,63000,1,0,63000,252000,189000
01SCS19E170076,ESH.AR-SC0002,00ARSC0005,S,1,44500,135000,2,0,40500,1,0,18900,94500,75600
01SCS19E170077,BSC.AR-RI0017,00ARRI0064,L,1,43000,135000,2,0,40500,1,0,18900,94500,75600
01SCS19E170077,BSC.AR-SC0033,00ARSC0225,M,1,125000,315000,2,0,94500,1,0,44100,220500,176400
01SCS19E170077,BSC.AR-SD0026,00ARSD0153,M,1,44500,159000,2,0,47700,1,0,22260,111300,89040
01SCS19E170077,BSC.AR-SD0046,00ARSD0244,M,1,44500,159000,2,0,47700,1,0,22260,111300,89040
01SCS19E170078,ESH.AR-QE0004,00ARQE0023,ALL,1,39800,140000,2,0,90000,1,0,10000,50000,40000
01SCS19E170079,AR.STY-RJ003,20ARRJ0052,ALL,1,55250,85000,2,0,17000,1,0,17000,68000,51000
01SCS19E170080,BSC.AR-RJ0019,00ARRJ0111,S,1,94500,135000,2,0,40500,1,0,18900,94500,75600
01SCS19E170080,BSC.AR-RK0009,00ARRK0082,M,1,52000,155000,2,0,46500,1,0,21700,108500,86800
01SCS19E170081,AR.ESB-SD005,20ARSD0113,M,1,91000,140000,2,0,28000,1,0,28000,112000,84000
01SCS19E170082,BSC.AR-SD0058,00ARSD0294,NON,1,50000,150000,2,0,45000,1,0,21000,105000,84000
01SCS19E170083,BSC.AR-SA0009,00ARSA0035,NON,1,47500,140000,2,0,42000,1,0,19600,98000,78400
01SCS19E170084,BSC.AR-RL0027,00ARRL0174,S,1,94500,135000,2,0,40500,1,0,18900,94500,75600
01SCS19E170085,AR.TRF-RJ002,20ARRJ0060,M,1,97500,150000,2,0,45000,1,0,26250,105000,78750
01SCS19E170085,AR.TUC-SE012,20ARSE0408,M,1,94250,145000,2,0,29000,1,0,29000,116000,87000
01SCS19E170086,BSC.AR-RK0012,00ARRK0094,M,1,43000,135000,2,0,40500,1,0,18900,94500,75600
01SCS19E170087,ESH.AR-QH0004,00ARQH0004,ALL,1,37800,140000,2,0,90000,1,0,10000,50000,40000
01SCS19E170088,ESH.AR-RF0007,00ARRF0043,M,1,150000,395000,2,0,220000,1,0,35000,175000,140000
01SCS19E170089,BSC.AR-RH0017,00ARRH0075,M,1,120000,315000,2,0,94500,1,0,44100,220500,176400
01SCS19E170090,AR.MKV-RL005,20ARRL0253,34,1,227500,350000,2,0,70000,1,0,70000,280000,210000
01SCS19E170091,AR.TUC-RL015,20ARRL0339,ALL,1,87750,135000,2,0,27000,1,0,27000,108000,81000
01SCS19E170091,AR.TUC-SA041,20ARSA0273,ALL,1,94250,145000,2,0,29000,1,0,29000,116000,87000
01SCS19E170092,AR.TUC-SB002,20ARSB0028,M,1,204750,315000,2,0,63000,1,0,63000,252000,189000
01SCS19E170093,AR.MPR-SE007,20ARSE0162,M,1,97500,150000,2,0,45000,1,0,26250,105000,78750
01SCS19E170093,AR.TUC-RI006,20ARRI0348,L,1,211250,325000,2,0,65000,1,0,65000,260000,195000
01SCS19E170094,BSC.AR-SD0028,00ARSD0160,S,1,125000,315000,2,0,94500,1,0,44100,220500,176400
01SCS19E170095,AR.MYA-SC002,20ARSC0042,L,1,220350,339000,2,0,101700,1,0,59325,237300,177975
01SCS19E170096,AR.STY-SE003,20ARSE0121,ALL,1,55250,85000,2,0,17000,1,0,17000,68000,51000
01SCS19E170097,AR.SLT-QK011,20ARQK0462,XL,1,316000,395000,2,0,39500,1,0,53325,355500,302175
01SCS19E170098,BSC.AR-SC0010,00ARSC0056,S,1,125000,315000,2,0,94500,1,0,44100,220500,176400
01SCS19E170099,AR.CLK-RH002,20ARRH0737,ALL,1,91000,140000,2,0,28000,1,0,28000,112000,84000
01SCS19E170100,BSC.AR-RD0001,00ARRD0003,L,1,155,450000,2,0,275000,1,0,35000,175000,140000
01SCS19E170101,ESH.AR-SA0010,00ARSA0091,NON,1,53000,155000,2,0,46500,1,0,21700,108500,86800
01SCS19E170102,ESH.AR-RE0002,00ARRE0005,S,1,42000,135000,2,0,67500,1,0,13500,67500,54000
01SCS19E170102,ESH.AR-RE0008,00ARRE0030,M,1,42000,135000,2,0,67500,1,0,13500,67500,54000
01SCS19E170103,BSC.AR-RI0015,00ARRI0054,S,1,43000,135000,2,0,40500,1,0,18900,94500,75600
01SCS19E170103,ESH.AR-SA0014,00ARSA0102,M,1,44000,135000,2,0,40500,1,0,18900,94500,75600
01SCS19E170104,ESH.AR-SD0045,00ARSD0406,L,1,125000,315000,2,0,94500,1,0,44100,220500,176400
01SCS19E170105,AR.TUC-SB009,20ARSB0037,ALL,1,97500,150000,2,0,30000,1,0,30000,120000,90000
01SCS19E170105,ESH.AR-SC0005,00ARSC0026,S,1,125000,315000,2,0,94500,1,0,44100,220500,176400
01SCS19E170105,ESH.AR-SD0026,00ARSD0267,M,1,44500,135000,2,0,40500,1,0,18900,94500,75600
01SCS19E170105,ESH.AR-SE0001,00ARSE0002,M,1,44000,135000,2,0,40500,1,0,18900,94500,75600
01SCS19E170106,BSC.AR-SA0017,00ARSA0052,M,1,125000,315000,2,0,94500,1,0,44100,220500,176400
01SCS19E170107,BE.RAK-SB011,00BESB0054,XL,1,201500,310000,2,0,62000,1,0,62000,248000,186000
01SCS19E170108,AR.HLW-SA020,20ARSA0125,28,1,243750,375000,2,0,112500,1,0,65625,262500,196875
01SCS19E170109,BSC.AR-SA0006,00ARSA0026,S,1,44500,135000,2,0,40500,1,0,18900,94500,75600
01SCS19E170110,AR.ESB-QJ015,20ARQJ0096,ALL,1,91000,140000,2,0,70000,1,0,17500,70000,52500
01SCS19E170110,AR.MKV-RE020,20ARRE0894,S,1,91000,140000,2,0,28000,1,0,28000,112000,84000
01SCS19E170111,AR.CPT-SD010,20ARSD0450,M,1,94250,145000,2,0,29000,1,0,29000,116000,87000
01SCS19E170111,AR.REC-SD005,20ARSD0018,M,1,107250,165000,2,0,49500,1,0,28875,115500,86625
01SCS19E170111,ESH.AR-RK0013,00ARRK0130,M,1,44500,135000,2,0,40500,1,0,18900,94500,75600
01SCS19E170112,BSC.AR-RK0016,00ARRK0111,L,1,43000,135000,2,0,40500,1,0,18900,94500,75600
01SCS19E170113,AR.HMR-SB019,20ARSB0388,34,1,204750,315000,2,0,63000,1,0,63000,252000,189000
01SCS19E170113,AR.TUC-RK028,20ARRK0134,L,1,94250,145000,2,0,29000,1,0,29000,116000,87000
01SCS19E170114,AR.MKV-RJ004,20ARRJ0155,S,1,91000,140000,2,0,28000,1,0,28000,112000,84000
01SCS19E170114,AR.TUC-SD022,20ARSD0506,M,1,94250,145000,2,0,29000,1,0,29000,116000,87000
01SCS19E170114,ESH.AR-SB0003,00ARSB0008,M,1,44000,135000,2,0,40500,1,0,18900,94500,75600
01SCS19E170115,AR.MPR-SE002,20ARSE0144,XL,1,97500,150000,2,0,45000,1,0,26250,105000,78750
01SCS19E170115,AR.PUB-RJ044,20ARRJ0526,M,1,97500,150000,2,0,30000,1,0,30000,120000,90000
01SCS19E170115,AR.PUB-SC014,20ARSC0357,M,1,97500,150000,2,0,30000,1,0,30000,120000,90000
01SCS19E170115,ESH.AR-SD0007,00ARSD0060,XL,1,44500,135000,2,0,40500,1,0,18900,94500,75600
01SCS19E170116,AR.STY-SE002,20ARSE0120,ALL,1,55250,85000,2,0,17000,1,0,17000,68000,51000
01SCS19E170116,AR.STY-SE004,20ARSE0122,ALL,1,55250,85000,2,0,17000,1,0,17000,68000,51000
01SCS19E170116,AR.YD-RL008,20ARRL0024,ALL,1,87750,135000,2,0,67500,1,0,16875,67500,50625
01SCS19E170117,ESH.AR-SC0010,00ARSC0080,S,1,44500,135000,2,0,40500,1,0,18900,94500,75600
01SCS19E170118,BSC.AR-SD0043,00ARSD0232,M,1,44500,159000,2,0,47700,1,0,22260,111300,89040
01SCS19E170119,AR.FHL-SC002,20ARSC0331,M,1,91000,140000,2,0,28000,1,0,28000,112000,84000
01SCS19E170120,AR.REC-SD020,20ARSD0059,30,1,208000,320000,2,0,96000,1,0,56000,224000,168000
01SCS19E170121,AR.PUB-SE005,20ARSE0019,L,1,97500,150000,2,0,30000,1,0,30000,120000,90000
01SCS19E170121,AR.TUC-SD016,20ARSD0483,L,1,94250,145000,2,0,29000,1,0,29000,116000,87000
01SCS19E170122,AR.PUB-SE008,20ARSE0030,M,1,97500,150000,2,0,30000,1,0,30000,120000,90000
01SCS19E170123,BSC.AR-RJ0031,00ARRJ0203,L,1,220500,315000,2,0,94500,1,0,44100,220500,176400
01SCS19E170123,BSC.AR-RK0014,00ARRK0104,XL,1,43000,135000,2,0,40500,1,0,18900,94500,75600
01SCS19E170123,BSC.AR-SC0017,00ARSC0118,L,1,44500,135000,2,0,40500,1,0,18900,94500,75600
01SCS19E170124,ESH.AR-SE0001,00ARSE0001,S,1,44000,135000,2,0,40500,1,0,18900,94500,75600
01SCS19E170125,AR.TUC-SE012,20ARSE0408,M,1,94250,145000,2,0,29000,1,0,29000,116000,87000
01SCS19E170126,AR.MKV-RJ027,20ARRJ0223,32,1,214500,330000,2,0,66000,1,0,66000,264000,198000
01SCS19E170127,AR.ESB-SE007,20ARSE0263,M,1,94250,145000,2,0,29000,1,0,29000,116000,87000
01SCS19E170128,BSC.AR-SD0047,00ARSD0247,NON,1,68000,220000,2,0,66000,1,0,30800,154000,123200
01SCS19E170129,AR.CPT-SC006,20ARSC0260,S,1,94250,145000,2,0,29000,1,0,29000,116000,87000
01SCS19E170130,BSC.AR-RI0035,00ARRI0209,M,1,120000,315000,2,0,94500,1,0,44100,220500,176400
01SCS19E170131,BSC.AR-SD0016,00ARSD0118,S,1,122000,375000,2,0,112500,1,0,52500,262500,210000
01SCS19E170132,BSC.AR-SD0014,00ARSD0111,M,1,122000,375000,2,0,112500,1,0,52500,262500,210000
01SCS19E170133,BSC.AR-RJ0008,00ARRJ0067,S,1,94500,135000,2,0,40500,1,0,18900,94500,75600
01SCS19E170133,ESH.AR-SC0018,00ARSC0144,S,1,44000,135000,2,0,40500,1,0,18900,94500,75600
01SCS19E170134,ESH.AR-SA0008,00ARSA0084,M,1,113450,350000,2,0,105000,1,0,49000,245000,196000
01SCS19E170135,ESH.AR-SD0026,00ARSD0268,L,1,44500,135000,2,0,40500,1,0,18900,94500,75600
01SCS19E170136,AR.PUB-SD011,20ARSD0121,ALL,1,97500,150000,2,0,30000,1,0,30000,120000,90000
01SCS19E170137,AR.ESB-SE006,20ARSE0258,S,1,94250,145000,2,0,29000,1,0,29000,116000,87000
01SCS19E170137,BSC.AR-SD0004,00ARSD0013,S,1,44000,159000,2,0,47700,1,0,22260,111300,89040
01SCS19E170138,ESH.AR-RC0005,00ARRC0066,M,1,95000,310000,2,0,150000,1,0,32000,160000,128000
01SCS19E170139,AR.GTW-SA003,20ARSA0304,M,1,94250,145000,2,0,43500,1,0,25375,101500,76125
01SCS19E170140,ESH.AR-SD0029,00ARSD0278,NON,1,58000,175000,2,0,52500,1,0,24500,122500,98000
01SCS19E170141,AR.PCT-QE010,20ARQE0028,L,1,87750,135000,2,0,67500,1,0,16875,67500,50625
01SCS19E170142,AR.ESB-RK008,20ARRK0241,ALL,1,87750,135000,2,0,40500,1,0,23625,94500,70875
01SCS19E170142,AR.TUC-SD013,20ARSD0472,XL,1,94250,145000,2,0,29000,1,0,29000,116000,87000
01SCS19E170143,AR.TUC-SE009,20ARSE0397,M,1,204750,315000,2,0,63000,1,0,63000,252000,189000
01SCS19E170144,AR.HLW-SC001,20ARSC0118,M,1,126750,195000,2,0,58500,1,0,34125,136500,102375
01SCS19E170144,AR.PCT-QE016,20ARQE0783,M,1,78000,120000,2,0,60000,1,0,15000,60000,45000
01SCS19E170144,AR.PUB-RI001,20ARRI0096,S,1,97500,150000,2,0,30000,1,0,30000,120000,90000
01SCS19E170144,AR.STY-SE008,20ARSE0126,ALL,1,55250,85000,2,0,17000,1,0,17000,68000,51000
01SCS19E170145,BSC.AR-SC0029,00ARSC0200,M,1,125000,315000,2,0,94500,1,0,44100,220500,176400
01SCS19E170146,AR.CPT-SB001,20ARSB0085,XL,1,204750,315000,2,0,63000,1,0,63000,252000,189000
01SCS19E170146,AR.MYA-SD004,20ARSD0258,34,1,207350,319000,2,0,159500,1,0,39875,159500,119625
01SCS19E170147,BSC.AR-QJ0014,00ARQJ0113,M,1,100000,310000,2,0,150000,1,0,32000,160000,128000
01SCS19E170147,BSC.AR-RI0038,00ARRI0215,M,1,262500,375000,2,0,112500,1,0,52500,262500,210000
01SCS19E170148,AR.TUC-SC004,20ARSC0056,28,1,204750,315000,2,0,63000,1,0,63000,252000,189000
01SCS19E170149,AR.TUC-SE008,20ARSE0392,M,1,204750,315000,2,0,63000,1,0,63000,252000,189000
01SCS19E170150,AR.MKV-QA010,20ARQA0047,32,1,97500,150000,2,0,75000,1,0,18750,75000,56250
01SCS19E170151,ESH.AR-RF0007,00ARRF0045,XL,1,150000,395000,2,0,220000,1,0,35000,175000,140000
01SCS19E170152,AR.CPT-SD005,20ARSD0432,ALL,1,94250,145000,2,0,29000,1,0,29000,116000,87000
01SCS19E170153,BSC.AR-RL0018,00ARRL0109,S,1,125000,315000,2,0,94500,1,0,44100,220500,176400
01SCS19E170154,AR.MPR-SE003,20ARSE0146,M,1,97500,150000,2,0,45000,1,0,26250,105000,78750
01SCS19E170154,ESH.AR-RI0007,00ARRI0096,L,1,94500,135000,2,0,40500,1,0,18900,94500,75600
01SCS19E170155,AR.MER-RJ003,20ARRJ0537,ALL,1,120250,185000,2,0,55500,1,0,32375,129500,97125
01SCS19E170155,AR.PUB-SE018,20ARSE0071,L,1,159250,245000,2,0,49000,1,0,49000,196000,147000
01SCS19E170156,AR.SMD-SE003,20ARSE0441,M,1,87750,135000,2,0,27000,1,0,27000,108000,81000
01SCS19E170157,AR.CPT-RK011,20ARRK0033,ALL,1,48750,75000,2,0,15000,1,0,15000,60000,45000
01SCS19E170157,AR.TUC-RK020,20ARRK0116,ALL,1,42250,65000,2,0,13000,1,0,13000,52000,39000
01SCS19E170158,AR.TUC-SD006,20ARSD0162,L,1,94250,145000,2,0,29000,1,0,29000,116000,87000
01SCS19E170158,BSC.AR-SD0046,00ARSD0246,XL,1,44500,159000,2,0,47700,1,0,22260,111300,89040
01SCS19E170159,AR.STY-SA003,20ARSA0062,ALL,1,61750,95000,2,0,19000,1,0,19000,76000,57000
01SCS19E170160,ESH.AR-RE0014,00ARRE0094,M,1,105000,330000,2,0,155000,1,0,35000,175000,140000
01SCS19E170161,BSC.AR-SA0002,00ARSA0007,L,1,120000,315000,2,0,94500,1,0,44100,220500,176400
01SCS19E170162,AR.PUB-SD019,20ARSD0188,ALL,1,97500,150000,2,0,30000,1,0,30000,120000,90000
01SCS19E170163,AR.STY-RJ002,20ARRJ0051,ALL,1,55250,85000,2,0,17000,1,0,17000,68000,51000
01SCS19E170163,BSC.AR-SB0007,00ARSB0076,L,1,44500,135000,2,0,40500,1,0,18900,94500,75600
01SCS19E170163,DKS.AR-RE0008,00ARRE0155,32,1,590750,695000,2,0,69500,1,0,93825,625500,531675
01SCS19E170163,DKS.AR-SE0001,00ARSE0131,32,1,417272,696000,2,0,69600,1,0,93960,626400,532440
01SCS19E170164,ESH.AR-SD0039,00ARSD0347,S,1,122500,350000,2,0,105000,1,0,49000,245000,196000
01SCS19E170165,ESH.AR-RI0015,00ARRI0143,NON,1,98000,140000,2,0,42000,1,0,19600,98000,78400
01SCS19E170166,ESH.AR-SA0017,00ARSA0116,S,1,122500,350000,2,0,105000,1,0,49000,245000,196000
01SCS19E170167,AR.ESB-SD015,20ARSD0335,L,1,91000,140000,2,0,28000,1,0,28000,112000,84000
01SCS19E170167,AR.TUC-SB022,20ARSB0486,ALL,1,87750,135000,2,0,27000,1,0,27000,108000,81000
01SCS19E170168,BSC.AR-SD0016,00ARSD0118,S,1,122000,375000,2,0,112500,1,0,52500,262500,210000
01SCS19E170169,AR.ESB-SE006,20ARSE0258,S,1,94250,145000,2,0,29000,1,0,29000,116000,87000
01SCS19E170170,AR.ASH-SD004,20ARSD0393,S,1,243750,375000,2,0,112500,1,0,65625,262500,196875
01SCS19E170171,AR.REC-RA005,20ARRA0253,XL,1,107250,165000,2,0,49500,1,0,28875,115500,86625
01SCS19E170172,AR.SMD-SD011,20ARSD0316,32,1,211250,325000,2,0,65000,1,0,65000,260000,195000
01SCS19E170173,ESH.AR-RK0006,00ARRK0026,M,1,43000,135000,2,0,40500,1,0,18900,94500,75600
01SCS19E170173,ESH.AR-SD0018,00ARSD0137,M,1,125000,315000,2,0,94500,1,0,44100,220500,176400
01SCS19E170174,BSC.AR-RL0018,00ARRL0109,S,1,125000,315000,2,0,94500,1,0,44100,220500,176400
01SCS19E170174,ESH.AR-SD0041,00ARSD0371,M,1,125000,315000,2,0,94500,1,0,44100,220500,176400
01SCS19E170175,AR.PUB-SB032,20ARSB0462,L,1,204750,315000,2,0,63000,1,0,63000,252000,189000
01SCS19E170175,AR.TUC-SB015,20ARSB0209,L,1,87750,135000,2,0,27000,1,0,27000,108000,81000
01SCS19E170176,AR.YD-RL013,20ARRL0030,M,1,195000,300000,2,0,90000,1,0,52500,210000,157500
01SCS19E170177,BSC.AR-RK0002,00ARRK0054,M,1,43000,135000,2,0,40500,1,0,18900,94500,75600
01SCS19E170178,ESH.AR-SD0018,00ARSD0138,L,1,125000,315000,2,0,94500,1,0,44100,220500,176400
01SCS19E170179,AR.PUB-SA003,20ARSA0234,XL,1,97500,150000,2,0,30000,1,0,30000,120000,90000
01SCS19E170179,BSC.AR-RJ0017,00ARRJ0106,XL,1,43000,135000,2,0,40500,1,0,18900,94500,75600
01SCS19E170180,AR.STY-SE004,20ARSE0122,ALL,1,55250,85000,2,0,17000,1,0,17000,68000,51000
01SCS19E170181,AR.MKV-SC020,20ARSC0226,M,1,107250,165000,2,0,33000,1,0,33000,132000,99000
01SCS19E170182,AR.VRS-SE001,20ARSE0316,30,1,298350,459000,2,0,137700,1,0,80325,321300,240975
01SCS19E170183,AR.TUC-SB003,20ARSB0031,ALL,1,61750,95000,2,0,19000,1,0,19000,76000,57000
01SCS19E170184,AR.TUC-SB015,20ARSB0208,M,1,87750,135000,2,0,27000,1,0,27000,108000,81000
01SCS19E170184,AR.TUC-SE011,20ARSE0405,L,1,94250,145000,2,0,29000,1,0,29000,116000,87000
01SCS19E170184,ESH.AR-SD0005,00ARSD0051,L,1,44000,135000,2,0,40500,1,0,18900,94500,75600
01SCS19E170185,ESH.AR-PL0015,00ARPL0126,M,1,110000,325000,2,0,165000,1,0,32000,160000,128000
01SCS19E170186,AR.ESB-RE036,20ARRE0795,M,1,65000,100000,2,0,50000,1,0,12500,50000,37500
01SCS19E170186,ESH.AR-RD0003,00ARRD0027,32,1,110000,350000,2,0,175000,1,0,35000,175000,140000
01SCS19E170187,AR.TUC-SC004,20ARSC0057,30,1,204750,315000,2,0,63000,1,0,63000,252000,189000
01SCS19E170188,AR.TUC-SE012,20ARSE0407,S,1,94250,145000,2,0,29000,1,0,29000,116000,87000
01SCS19E170188,ESH.AR-SD0008,00ARSD0061,S,1,44500,135000,2,0,40500,1,0,18900,94500,75600
01SCS19E170189,BSC.AR-RH0024,00ARRH0155,S,1,245000,350000,2,0,105000,1,0,49000,245000,196000
01SCS19E170190,ESH.AR-SD0035,00ARSD0333,NON,1,50000,150000,2,0,45000,1,0,21000,105000,84000
01SCS19E170191,ESH.AR-SB0019,00ARSB0114,NON,1,41000,120000,2,0,36000,1,0,16800,84000,67200
01SCS19E170192,AR.TUC-SC004,20ARSC0059,34,1,204750,315000,2,0,63000,1,0,63000,252000,189000
01SCS19E170193,ESH.AR-SD0038,00ARSD0343,S,1,122500,350000,2,0,105000,1,0,49000,245000,196000
01SCS19E170194,AR.STY-SE009,20ARSE0127,ALL,1,55250,85000,2,0,17000,1,0,17000,68000,51000
01SCS19E170194,ESH.AR-SD0002,00ARSD0040,XL,1,44500,135000,2,0,40500,1,0,18900,94500,75600
01SCS19E170195,BSC.AR-SC0039,00ARSC0255,L,1,190000,475000,2,0,142500,1,0,66500,332500,266000
01SCS19E170196,AR.TUC-SE014,20ARSE0416,M,1,94250,145000,2,0,29000,1,0,29000,116000,87000
01SCS19E170197,AR.CPT-SC013,20ARSC0483,S,1,94250,145000,2,0,29000,1,0,29000,116000,87000
01SCS19E170198,BSC.AR-RL0018,00ARRL0109,S,1,125000,315000,2,0,94500,1,0,44100,220500,176400
01SCS19E170199,AR.VRS-SE004,20ARSE0322,L,1,96850,149000,2,0,44700,1,0,26075,104300,78225
01SCS19E170199,ESH.AR-RE0004,00ARRE0014,M,1,42000,135000,2,0,67500,1,0,13500,67500,54000
01SCS19E170199,ESH.AR-RE0008,00ARRE0031,L,1,42000,135000,2,0,67500,1,0,13500,67500,54000
01SCS19E170200,BSC.AR-SB0009,00ARSB0082,S,1,44500,135000,2,0,40500,1,0,18900,94500,75600
01SCS19E170201,ESH.AR-QD0016,00ARQD0149,S,1,110000,325000,2,0,165000,1,0,32000,160000,128000
01SCS19E170202,BSC.AR-SD0061,00ARSD0336,NON,1,45000,150000,2,0,45000,1,0,21000,105000,84000
01SCS19E170202,ESH.AR-RC0005,00ARRC0067,L,1,95000,310000,2,0,150000,1,0,32000,160000,128000
01SCS19E170203,AR.TUC-SE011,20ARSE0404,M,1,94250,145000,2,0,29000,1,0,29000,116000,87000
01SCS19E170204,ESH.AR-SD0040,00ARSD0368,L,1,122500,350000,2,0,105000,1,0,49000,245000,196000
01SCS19E170205,ESH.AR-SC0032,00ARSC0281,M,1,44500,135000,2,0,40500,1,0,18900,94500,75600
01SCS19E170206,AR.PUB-SB014,20ARSB0055,XL,1,159250,245000,2,0,49000,1,0,49000,196000,147000
01SCS19E170207,BSC.AR-SD0064,00ARSD0339,S,1,125000,315000,2,0,94500,1,0,44100,220500,176400
01SCS19E170208,AR.MPR-SE005,20ARSE0153,S,1,97500,150000,2,0,45000,1,0,26250,105000,78750
01SCS19E170208,ESH.AR-SE0001,00ARSE0001,S,1,44000,135000,2,0,40500,1,0,18900,94500,75600
01SCS19E170209,AR.SMD-SD011,20ARSD0316,32,1,211250,325000,2,0,65000,1,0,65000,260000,195000
01SCS19E170209,BSC.AR-RK0008,00ARRK0079,L,1,52000,155000,2,0,46500,1,0,21700,108500,86800
01SCS19E170210,AR.SMD-SD010,20ARSD0311,30,1,211250,325000,2,0,65000,1,0,65000,260000,195000
01SCS19E170210,ESH.AR-SD0018,00ARSD0137,M,1,125000,315000,2,0,94500,1,0,44100,220500,176400
01SCS19E170211,ESH.AR-SC0021,00ARSC0157,S,1,44000,135000,2,0,40500,1,0,18900,94500,75600
01SCS19E180001,AR.PUB-RL003,20ARRL0118,XL,1,97500,150000,2,0,30000,1,0,30000,120000,90000
01SCS19E180001,BSC.AR-RL0025,00ARRL0169,XL,1,94500,135000,2,0,40500,1,0,18900,94500,75600
01SCS19E180002,AR.PUB-SB033,20ARSB0464,ALL,1,97500,150000,2,0,30000,1,0,30000,120000,90000
01SCS19E180002,BSC.AR-SD0062,00ARSD0337,NON,1,45000,150000,2,0,45000,1,0,21000,105000,84000
01SCS19E180002,ESH.AR-RE0002,00ARRE0006,M,1,42000,135000,2,0,67500,1,0,13500,67500,54000
01SCS19E180002,ESH.AR-RE0008,00ARRE0030,M,1,42000,135000,2,0,67500,1,0,13500,67500,54000
01SCS19E180002,ESH.AR-SD0021,00ARSD0164,S,1,125000,315000,2,0,94500,1,0,44100,220500,176400
01SCS19E180003,AR.KNR-RK007,20ARRK0275,L,1,152750,235000,2,0,70500,1,0,41125,164500,123375
01SCS19E180003,AR.TUC-SB002,20ARSB0029,L,1,204750,315000,2,0,63000,1,0,63000,252000,189000
01SCS19E180003,BSC.AR-QG0018,00ARQG0152,L,1,135000,395000,2,0,220000,1,0,35000,175000,140000
01SCS19E180004,AR.ESB-SC005,20ARSC0427,M,1,94250,145000,2,0,29000,1,0,29000,116000,87000
01SCS19E180004,AR.PCT-SE002,20ARSE0338,M,1,87750,135000,2,0,27000,1,0,27000,108000,81000
01SCS19E180004,AR.TUC-SB013,20ARSB0199,S,1,94250,145000,2,0,29000,1,0,29000,116000,87000
01SCS19E180005,AR.MPR-SB010,20ARSB0270,S,1,97500,150000,2,0,45000,1,0,26250,105000,78750
01SCS19E180005,AR.VRS-SE004,20ARSE0321,M,1,96850,149000,2,0,44700,1,0,26075,104300,78225
01SCS19E180006,AR.CPT-SD003,20ARSD0139,ALL,1,94250,145000,2,0,29000,1,0,29000,116000,87000
01SCS19E180007,BSC.AR-SC0010,00ARSC0056,S,1,125000,315000,2,0,94500,1,0,44100,220500,176400
01SCS19E180008,BSC.AR-RH0018,00ARRH0079,M,1,120000,315000,2,0,94500,1,0,44100,220500,176400
01SCS19E180009,ESH.AR-RE0004,00ARRE0015,L,1,42000,135000,2,0,67500,1,0,13500,67500,54000
01SCS19E180009,ESH.AR-RE0007,00ARRE0027,L,1,42000,135000,2,0,67500,1,0,13500,67500,54000
01SCS19E180010,AR.TUC-SE018,20ARSE0430,ALL,1,87750,135000,2,0,27000,1,0,27000,108000,81000
01SCS19E180011,BSC.AR-RI0026,00ARRI0135,NON,1,98000,140000,2,0,42000,1,0,19600,98000,78400
01SCS19E180011,BSC.AR-SA0014,00ARSA0040,NON,1,47500,140000,2,0,42000,1,0,19600,98000,78400
01SCS19E180012,AR.MKV-RE035,20ARRE1403,L,1,165750,255000,2,0,51000,1,0,51000,204000,153000
01SCS19E180012,ARN.AR-SB0002,00ARSB0087,NON,1,149400,249000,2,0,49800,1,0,59760,199200,139440
01SCS19E180012,BSC.AR-SD0014,00ARSD0111,M,1,122000,375000,2,0,112500,1,0,52500,262500,210000
01SCS19E180012,BSC.AR-SD0032,00ARSD0183,S,1,44500,159000,2,0,47700,1,0,22260,111300,89040
01SCS19E180013,AR.STY-SE009,20ARSE0127,ALL,1,55250,85000,2,0,17000,1,0,17000,68000,51000
01SCS19E180013,ESH.AR-SC0013,00ARSC0105,M,1,44500,135000,2,0,40500,1,0,18900,94500,75600
01SCS19E180014,AR.ESB-SE004,20ARSE0250,S,1,94250,145000,2,0,29000,1,0,29000,116000,87000
01SCS19E180014,AR.TUC-SD016,20ARSD0483,L,1,94250,145000,2,0,29000,1,0,29000,116000,87000
01SCS19E180015,AR.MPR-SE032,20ARSE0300,M,1,230750,355000,2,0,71000,1,0,71000,284000,213000
01SCS19E180015,AR.TUC-SA031,20ARSA0258,M,1,87750,135000,2,0,27000,1,0,27000,108000,81000
01SCS19E180016,AR.SMD-SD007,20ARSD0300,S,1,211250,325000,2,0,65000,1,0,65000,260000,195000
01SCS19E180016,BSC.AR-SC0029,00ARSC0199,S,1,125000,315000,2,0,94500,1,0,44100,220500,176400
01SCS19E180017,BSC.AR-SD0014,00ARSD0112,L,1,122000,375000,2,0,112500,1,0,52500,262500,210000
01SCS19E180018,ESH.AR-SC0007,00ARSC0063,XL,1,125000,350000,2,0,105000,1,0,49000,245000,196000
01SCS19E180019,AR.STY-SA003,20ARSA0062,ALL,1,61750,95000,2,0,19000,1,0,19000,76000,57000
01SCS19E180020,AR.TUC-SB015,20ARSB0207,S,1,87750,135000,2,0,27000,1,0,27000,108000,81000
01SCS19E180020,AR.TUC-SE006,20ARSE0383,S,1,204750,315000,2,0,63000,1,0,63000,252000,189000
01SCS19E180021,ESH.AR-RG0003,00ARRG0007,M,1,90000,255000,2,0,76500,1,0,35700,178500,142800
01SCS19E180022,ESH.AR-RE0004,00ARRE0014,M,1,42000,135000,2,0,67500,1,0,13500,67500,54000
01SCS19E180022,ESH.AR-RE0007,00ARRE0027,L,1,42000,135000,2,0,67500,1,0,13500,67500,54000
01SCS19E180023,AR.ASH-SD001,20ARSD0380,S,1,91000,140000,2,0,42000,1,0,24500,98000,73500
01SCS19E180024,AR.CPT-SE004,20ARSE0367,XL,1,204750,315000,2,0,63000,1,0,63000,252000,189000
01SCS19E180025,ESH.AR-SD0011,00ARSD0073,S,1,125000,315000,2,0,94500,1,0,44100,220500,176400
01SCS19E180026,ESH.AR-SE0001,00ARSE0002,M,1,44000,135000,2,0,40500,1,0,18900,94500,75600
01SCS19E180027,AR.STY-SC001,20ARSC0200,ALL,1,77350,119000,2,0,23800,1,0,23800,95200,71400
01SCS19E180028,AR.CPT-RL014,20ARRL0311,ALL,1,94250,145000,2,0,29000,1,0,29000,116000,87000
01SCS19E180028,AR.PUB-RI010,20ARRI0149,ALL,1,97500,150000,2,0,30000,1,0,30000,120000,90000
01SCS19E180028,AR.PUB-RI023,20ARRI0305,XL,1,113750,175000,2,0,35000,1,0,35000,140000,105000
01SCS19E180028,AR.PUB-RJ016,20ARRJ0236,XL,1,97500,150000,2,0,30000,1,0,30000,120000,90000
01SCS19E180028,AR.PUB-RJ038,20ARRJ0504,XL,1,97500,150000,2,0,30000,1,0,30000,120000,90000
01SCS19E180028,AR.PUB-SB026,20ARSB0138,L,1,97500,150000,2,0,30000,1,0,30000,120000,90000
01SCS19E180028,AR.PUB-SE026,20ARSE0102,XL,1,204750,315000,2,0,63000,1,0,63000,252000,189000
01SCS19E180028,AR.STY-SE007,20ARSE0125,ALL,1,55250,85000,2,0,17000,1,0,17000,68000,51000
01SCS19E180028,AR.TUC-RI012,20ARRI0372,L,1,87750,135000,2,0,27000,1,0,27000,108000,81000
01SCS19E180028,AR.TUC-RK029,20ARRK0138,XL,1,94250,145000,2,0,29000,1,0,29000,116000,87000
01SCS19E180028,AR.TUC-SB018,20ARSB0479,L,1,87750,135000,2,0,27000,1,0,27000,108000,81000
01SCS19E180028,AR.TUC-SD014,20ARSD0476,XL,1,94250,145000,2,0,29000,1,0,29000,116000,87000
01SCS19E180028,AR.TUC-SD016,20ARSD0483,L,1,94250,145000,2,0,29000,1,0,29000,116000,87000
01SCS19E180028,AR.TUC-SD023,20ARSD0512,XL,1,204750,315000,2,0,63000,1,0,63000,252000,189000
01SCS19E180028,ESH.AR-SE0001,00ARSE0004,XL,1,44000,135000,2,0,40500,1,0,18900,94500,75600
01SCS19E180029,AR.PUB-RL019,20ARRL0193,M,1,97500,150000,2,0,30000,1,0,30000,120000,90000
01SCS19E180030,AR.ESB-SC016,20ARSC0456,S,1,91000,140000,2,0,28000,1,0,28000,112000,84000
01SCS19E180030,AR.PUB-SA003,20ARSA0233,L,1,97500,150000,2,0,30000,1,0,30000,120000,90000
01SCS19E180030,AR.TRF-RJ004,20ARRJ0069,L,1,97500,150000,2,0,45000,1,0,26250,105000,78750
01SCS19E180030,BSC.AR-RH0008,00ARRH0050,M,1,110000,350000,2,0,105000,1,0,49000,245000,196000
01SCS19E180030,BSC.AR-SC0029,00ARSC0199,S,1,125000,315000,2,0,94500,1,0,44100,220500,176400
01SCS19E180030,BSC.AR-SD0022,00ARSD0128,S,1,44000,159000,2,0,47700,1,0,22260,111300,89040
01SCS19E180030,BSC.AR-SD0022,00ARSD0130,L,1,44000,159000,2,0,47700,1,0,22260,111300,89040
01SCS19E180030,ESH.AR-RK0002,00ARRK0008,XL,1,120000,315000,2,0,94500,1,0,44100,220500,176400
01SCS19E180030,ESH.AR-SA0013,00ARSA0099,L,1,44000,135000,2,0,40500,1,0,18900,94500,75600
01SCS19E180030,ESH.AR-SC0017,00ARSC0141,M,1,44000,135000,2,0,40500,1,0,18900,94500,75600
01SCS19E180030,ESH.AR-SD0026,00ARSD0267,M,1,44500,135000,2,0,40500,1,0,18900,94500,75600
01SCS19E180031,ESH.AR-SD0008,00ARSD0062,M,1,44500,135000,2,0,40500,1,0,18900,94500,75600
01SCS19E180031,ESH.AR-SD0008,00ARSD0063,L,1,44500,135000,2,0,40500,1,0,18900,94500,75600
01SCS19E180032,BSC.AR-RI0015,00ARRI0055,M,1,43000,135000,2,0,40500,1,0,18900,94500,75600
01SCS19E180033,ESH.AR-SB0023,00ARSB0135,NON,1,52800,185000,2,0,55500,1,0,25900,129500,103600
01SCS19E180033,ESH.AR-SE0001,00ARSE0003,L,1,44000,135000,2,0,40500,1,0,18900,94500,75600
01SCS19E180034,AR.CPT-QL011,20ARQL0166,S,1,204750,315000,2,0,63000,1,0,63000,252000,189000
01SCS19E180035,ESH.AR-SD0024,00ARSD0260,L,1,44500,135000,2,0,40500,1,0,18900,94500,75600
01SCS19E180035,ESH.AR-SD0026,00ARSD0268,L,1,44500,135000,2,0,40500,1,0,18900,94500,75600
01SCS19E180036,ESH.AR-RG0005,00ARRG0102,L,1,94500,135000,2,0,40500,1,0,18900,94500,75600
01SCS19E180036,ESH.AR-SC0017,00ARSC0141,M,1,44000,135000,2,0,40500,1,0,18900,94500,75600
01SCS19E180036,ESH.AR-SD0004,00ARSD0047,L,1,44500,135000,2,0,40500,1,0,18900,94500,75600
01SCS19E180037,AR.SMD-RL003,20ARRL0267,ALL,1,22750,35000,2,0,7000,1,0,7000,28000,21000
01SCS19E180037,ESH.AR-SD0004,00ARSD0045,S,1,44500,135000,2,0,40500,1,0,18900,94500,75600
01SCS19E180038,ESH.AR-RE0004,00ARRE0014,M,1,42000,135000,2,0,67500,1,0,13500,67500,54000
01SCS19E180038,ESH.AR-RE0019,00ARRE0207,XL,1,43000,150000,2,0,82500,1,0,13500,67500,54000
01SCS19E180038,ESH.AR-SD0008,00ARSD0063,L,1,44500,135000,2,0,40500,1,0,18900,94500,75600
01SCS19E180039,AR.TUC-SB015,20ARSB0208,M,1,87750,135000,2,0,27000,1,0,27000,108000,81000
01SCS19E180039,ESH.AR-SD0021,00ARSD0166,L,1,125000,315000,2,0,94500,1,0,44100,220500,176400
01SCS19E180040,AR.ESB-SB001,20ARSB0021,M,1,204750,315000,2,0,63000,1,0,63000,252000,189000
01SCS19E180041,AR.MPR-SE005,20ARSE0153,S,1,97500,150000,2,0,45000,1,0,26250,105000,78750
01SCS19E180042,DKS.AR-SE0005,00ARSE0143,30,1,417272,696000,2,0,69600,1,0,93960,626400,532440
01SCS19E180043,ESH.AR-SD0039,00ARSD0347,S,1,122500,350000,2,0,105000,1,0,49000,245000,196000
01SCS19E180044,AR.CPT-RL002,20ARRL0077,XL,1,94250,145000,2,0,29000,1,0,29000,116000,87000
01SCS19E180044,AR.PUB-SD038,20ARSD0354,ALL,1,97500,150000,2,0,30000,1,0,30000,120000,90000
01SCS19E180044,ESH.AR-SD0014,00ARSD0086,32,1,145000,375000,2,0,112500,1,0,52500,262500,210000
01SCS19E180045,BSC.AR-RC0034,00ARRC0234,S,1,120000,360000,2,0,185000,1,0,35000,175000,140000
01SCS19E180046,AR.SMD-SD008,20ARSD0304,S,1,211250,325000,2,0,65000,1,0,65000,260000,195000
01SCS19E180047,ESH.AR-RA0014,00ARRA0071,ALL,1,55000,140000,2,0,90000,1,0,10000,50000,40000
01SCS19E180048,BSC.AR-SA0008,00ARSA0034,NON,1,47500,140000,2,0,42000,1,0,19600,98000,78400
01SCS19E180049,BSC.AR-RI0018,00ARRI0067,M,1,94500,135000,2,0,40500,1,0,18900,94500,75600
01SCS19E180050,AR.SMD-SD010,20ARSD0312,32,1,211250,325000,2,0,65000,1,0,65000,260000,195000
01SCS19E180051,BSC.AR-SC0029,00ARSC0199,S,1,125000,315000,2,0,94500,1,0,44100,220500,176400
01SCS19E180052,BSC.AR-SD0016,00ARSD0118,S,1,122000,375000,2,0,112500,1,0,52500,262500,210000
01SCS19E180052,ESH.AR-SB0034,00ARSB0216,S,1,125000,315000,2,0,94500,1,0,44100,220500,176400
01SCS19E180053,BSC.AR-RJ0013,00ARRJ0089,L,1,94500,135000,2,0,40500,1,0,18900,94500,75600
01SCS19E180054,BE.RAK-SA001,00BESA0004,M,1,259350,399000,2,0,79800,1,0,79800,319200,239400
01SCS19E180055,AR.CPT-SD010,20ARSD0449,S,1,94250,145000,2,0,29000,1,0,29000,116000,87000
01SCS19E180055,AR.MPR-SE003,20ARSE0145,S,1,97500,150000,2,0,45000,1,0,26250,105000,78750
01SCS19E180055,AR.PUB-RJ030,20ARRJ0384,S,1,97500,150000,2,0,30000,1,0,30000,120000,90000
01SCS19E180056,AR.MPR-SE035,20ARSE0311,ALL,1,136500,210000,2,0,42000,1,0,42000,168000,126000
01SCS19E180057,ESH.AR-SE0001,00ARSE0003,L,1,44000,135000,2,0,40500,1,0,18900,94500,75600
01SCS19E180058,AR.CPT-SE004,20ARSE0364,S,1,204750,315000,2,0,63000,1,0,63000,252000,189000
01SCS19E180058,AR.ESB-QE013,20ARQE0411,L,1,97500,150000,2,0,75000,1,0,18750,75000,56250
01SCS19E180058,AR.ESB-SE012,20ARSE0282,S,1,198250,305000,2,0,61000,1,0,61000,244000,183000
01SCS19E180058,AR.MKV-PL009,20ARSD0413,XL,1,91000,140000,2,0,70000,1,0,17500,70000,52500
01SCS19E180058,AR.MKV-SC021,20ARSC0229,S,1,107250,165000,2,0,33000,1,0,33000,132000,99000
01SCS19E180058,AR.PUB-QA018,20ARQA0523,ALL,1,97500,150000,2,0,30000,1,0,30000,120000,90000
01SCS19E180058,AR.PUB-SD018,20ARSD0187,ALL,1,97500,150000,2,0,30000,1,0,30000,120000,90000
01SCS19E180058,BSC.AR-QE0012,00ARQE0096,L,1,125000,375000,2,0,200000,1,0,35000,175000,140000
01SCS19E180058,BSC.AR-SC0013,00ARSC0092,S,1,44000,135000,2,0,40500,1,0,18900,94500,75600
01SCS19E180058,ESH.AR-PL0035,00ARPL0234,ALL,1,39800,140000,2,0,90000,1,0,10000,50000,40000
01SCS19E180058,ESH.AR-RC0005,00ARRC0066,M,1,95000,310000,2,0,150000,1,0,32000,160000,128000
01SCS19E180058,ESH.AR-SD0001,00ARSD0029,S,1,44500,135000,2,0,40500,1,0,18900,94500,75600
01SCS19E180059,BSC.AR-SB0011,00ARSB0096,S,1,44500,135000,2,0,40500,1,0,18900,94500,75600
01SCS19E180059,ESH.AR-SD0021,00ARSD0164,S,1,125000,315000,2,0,94500,1,0,44100,220500,176400
01SCS19E180060,AR.STY-SE005,20ARSE0123,ALL,1,55250,85000,2,0,17000,1,0,17000,68000,51000
01SCS19E180060,BSC.AR-SC0049,00ARSC0308,S,1,44500,159000,2,0,47700,1,0,22260,111300,89040
01SCS19E180061,AR.CPT-SC012,20ARSC0479,S,1,204750,315000,2,0,63000,1,0,63000,252000,189000
01SCS19E180061,AR.ESB-SA001,20ARSA0204,M,2,87750,135000,2,0,27000,1,0,27000,216000,162000
01SCS19E180062,DKS.AR-SE0002,00ARSE0136,34,1,417272,696000,2,0,69600,1,0,93960,626400,532440
01SCS19E180063,ESH.AR-QD0016,00ARQD0150,M,1,110000,325000,2,0,165000,1,0,32000,160000,128000
01SCS19E180064,BSC.AR-QB0014,00ARQB0101,ALL,1,45000,150000,2,0,100000,1,0,10000,50000,40000
01SCS19E180064,ESH.AR-QD0016,00ARQD0149,S,1,110000,325000,2,0,165000,1,0,32000,160000,128000
01SCS19E180064,ESH.AR-QE0005,00ARQE0024,ALL,1,39800,140000,2,0,90000,1,0,10000,50000,40000
01SCS19E180065,AR.VCS-RI005,20ARRI0287,M,1,243750,375000,2,0,112500,1,0,65625,262500,196875
01SCS19E180066,AR.PUB-SE021,20ARSE0081,L,1,159250,245000,2,0,49000,1,0,49000,196000,147000
01SCS19E180066,ESH.AR-RL0011,00ARRL0122,M,1,100000,265000,2,0,79500,1,0,37100,185500,148400
01SCS19E180067,AR.PUB-SE029,20ARSE0112,M,1,224250,345000,2,0,69000,1,0,69000,276000,207000
01SCS19E180068,AR.PUB-SB034,20ARSB0465,ALL,1,81250,125000,2,0,25000,1,0,25000,100000,75000
01SCS19E180068,ESH.AR-SC0036,00ARSC0301,NON,1,55000,140000,2,0,42000,1,0,19600,98000,78400
01SCS19E180068,ESH.AR-SE0001,00ARSE0002,M,1,44000,135000,2,0,40500,1,0,18900,94500,75600
01SCS19E180068,THR.AR-RK0003,00ARRK0167,L,1,332000,415000,2,0,41500,1,0,56025,373500,317475
01SCS19E180069,AR.STY-SA003,20ARSA0062,ALL,1,61750,95000,2,0,19000,1,0,19000,76000,57000
01SCS19E180069,AR.STY-SE006,20ARSE0124,ALL,1,55250,85000,2,0,17000,1,0,17000,68000,51000
01SCS19E180070,AR.ESB-SE011,20ARSE0278,S,1,227500,350000,2,0,70000,1,0,70000,280000,210000
01SCS19E180071,BSC.AR-SD0063,00ARSD0338,NON,1,60000,180000,2,0,54000,1,0,25200,126000,100800
01SCS19E180072,AR.HMR-SB031,20ARSB0441,30,1,96850,149000,2,0,29800,1,0,29800,119200,89400
01SCS19E180072,AR.TUC-SA007,20ARSA0025,ALL,1,81250,125000,2,0,25000,1,0,25000,100000,75000
01SCS19E180073,AR.ESB-SE010,20ARSE0275,M,1,227500,350000,2,0,70000,1,0,70000,280000,210000
01SCS19E180074,DKS.AR-SE0002,00ARSE0137,36,1,417272,696000,2,0,69600,1,0,93960,626400,532440
01SCS19E180075,AR.MPR-SE012,20ARSE0181,S,1,97500,150000,2,0,45000,1,0,26250,105000,78750
01SCS19E180075,AR.TUC-SA028,20ARSA0163,ALL,1,100750,155000,2,0,31000,1,0,31000,124000,93000
01SCS19E180076,AR.SMD-RI006,20ARRL0063,S,1,87750,135000,2,0,40500,1,0,23625,94500,70875
01SCS19E180076,ESH.AR-SB0021,00ARSB0120,M,1,44500,135000,2,0,40500,1,0,18900,94500,75600
01SCS19E180077,AR.CPT-RE009,20ARRE0701,S,1,204750,315000,2,0,63000,1,0,63000,252000,189000
01SCS19E180077,AR.PUB-RL026,20ARRL0429,M,1,97500,150000,2,0,30000,1,0,30000,120000,90000
01SCS19E180077,AR.STY-SE008,20ARSE0126,ALL,1,55250,85000,2,0,17000,1,0,17000,68000,51000
01SCS19E180077,AR.TUC-SD014,20ARSD0474,M,1,94250,145000,2,0,29000,1,0,29000,116000,87000
01SCS19E180077,ESH.AR-QH0026,00ARQH0137,ALL,1,39700,140000,2,0,90000,1,0,10000,50000,40000
01SCS19E180077,ESH.AR-SC0010,00ARSC0080,S,1,44500,135000,2,0,40500,1,0,18900,94500,75600
01SCS19E180078,BSC.AR-SC0010,00ARSC0058,L,1,125000,315000,2,0,94500,1,0,44100,220500,176400
01SCS19E180079,BSC.AR-SD0026,00ARSD0153,M,1,44500,159000,2,0,47700,1,0,22260,111300,89040
01SCS19E180080,AR.MPR-SE006,20ARSE0157,S,1,97500,150000,2,0,45000,1,0,26250,105000,78750
01SCS19E180080,AR.REC-SD003,20ARSD0010,M,1,120250,185000,2,0,55500,1,0,32375,129500,97125
01SCS19E180080,AR.TUC-RK020,20ARRK0116,ALL,1,42250,65000,2,0,13000,1,0,13000,52000,39000
01SCS19E180081,AR.STY-SC002,20ARSC0201,ALL,1,77350,119000,2,0,23800,1,0,23800,95200,71400
01SCS19E180082,AR.SMD-RI007,20ARRI0330,M,1,87750,135000,2,0,40500,1,0,23625,94500,70875
01SCS19E180082,ESH.AR-SC0004,00ARSC0021,S,1,44500,135000,2,0,40500,1,0,18900,94500,75600
01SCS19E180083,AR.PUB-SE006,20ARSE0024,XL,1,97500,150000,2,0,30000,1,0,30000,120000,90000
01SCS19E180084,AR.HMR-SD007,20ARSD0544,S,1,243750,375000,2,0,75000,1,0,75000,300000,225000
01SCS19E180085,BSC.AR-RL0019,00ARRL0113,S,1,125000,315000,2,0,94500,1,0,44100,220500,176400
01SCS19E180086,AR.ESB-SD005,20ARSD0113,M,1,91000,140000,2,0,28000,1,0,28000,112000,84000
01SCS19E180086,ESH.AR-SD0022,00ARSD0168,NON,1,43000,120000,2,0,36000,1,0,16800,84000,67200
01SCS19E180087,BSC.AR-SC0019,00ARSC0128,S,1,44500,159000,2,0,47700,1,0,22260,111300,89040
01SCS19E180088,AR.STY-SE006,20ARSE0124,ALL,1,55250,85000,2,0,17000,1,0,17000,68000,51000
01SCS19E180088,BSC.AR-SC0011,00ARSC0064,S,1,44000,159000,2,0,47700,1,0,22260,111300,89040
01SCS19E180088,BSC.AR-SD0012,00ARSD0105,NON,1,18000,75000,2,0,22500,1,0,10500,52500,42000
01SCS19E180088,ESH.AR-SC0034,00ARSC0292,S,1,125000,315000,2,0,94500,1,0,44100,220500,176400
01SCS19E180088,ESH.AR-SE0001,00ARSE0002,M,1,44000,135000,2,0,40500,1,0,18900,94500,75600
01SCS19E180089,DKS.AR-SE0006,00ARSE0147,30,1,417272,696000,2,0,69600,1,0,93960,626400,532440
01SCS19E180090,DKS.AR-SE0003,00ARSE0139,36,1,417272,696000,2,0,69600,1,0,93960,626400,532440
01SCS19E180091,BSC.AR-SC0050,00ARSC0313,M,1,44000,159000,2,0,47700,1,0,22260,111300,89040
01SCS19E180092,BSC.AR-SC0029,00ARSC0199,S,1,125000,315000,2,0,94500,1,0,44100,220500,176400
01SCS19E180092,BSC.AR-SD0030,00ARSD0174,S,1,44500,159000,2,0,47700,1,0,22260,111300,89040
01SCS19E180093,ESH.AR-SA0010,00ARSA0091,NON,1,53000,155000,2,0,46500,1,0,21700,108500,86800
01SCS19E180094,AR.TUC-SB012,20ARSB0195,S,1,204750,315000,2,0,63000,1,0,63000,252000,189000
01SCS19E180095,AR.PCT-RJ005,20ARRJ0286,ALL,1,178750,275000,2,0,55000,1,0,55000,220000,165000
01SCS19E180096,AR.PUB-SB002,20ARSB0006,ALL,1,97500,150000,2,0,30000,1,0,30000,120000,90000
01SCS19E180097,AR.MDS-RL004,20ARRL0366,S,1,117000,180000,2,0,36000,1,0,36000,144000,108000
01SCS19E180097,AR.TUC-RI012,20ARRI0371,M,1,87750,135000,2,0,27000,1,0,27000,108000,81000
01SCS19E180097,AR.YD-SD004,20ARSD0270,S,1,91000,140000,2,0,42000,1,0,24500,98000,73500
01SCS19E180098,AR.ESB-RB014,20ARRB0372,ALL,1,91000,140000,2,0,70000,1,0,17500,70000,52500
01SCS19E180098,ESH.AR-SD0009,00ARSD0065,S,1,44500,135000,2,0,40500,1,0,18900,94500,75600
01SCS19E180099,BE.RAK-SA022,00BESA0087,M,1,91000,140000,2,0,28000,1,0,28000,112000,84000
01SCS19E180099,BSC.AR-SC0010,00ARSC0056,S,1,125000,315000,2,0,94500,1,0,44100,220500,176400
01SCS19E180100,AR.FHL-RJ004,20ARRJ0431,XL,1,211250,325000,2,0,65000,1,0,65000,260000,195000
01SCS19E180101,AR.MPR-SE003,20ARSE0146,M,1,97500,150000,2,0,45000,1,0,26250,105000,78750
01SCS19E180101,ESH.AR-SC0012,00ARSC0089,M,1,44000,135000,2,0,40500,1,0,18900,94500,75600
01SCS19E180102,AR.CPT-SE002,20ARSE0358,L,1,94250,145000,2,0,29000,1,0,29000,116000,87000
01SCS19E180103,DKS.AR-SE0006,00ARSE0148,32,1,417272,696000,2,0,69600,1,0,93960,626400,532440
01SCS19E180104,AR.PUB-RE036,20ARRE0538,ALL,1,97500,150000,2,0,30000,1,0,30000,120000,90000
01SCS19E180104,AR.SMD-SD017,20ARSD0579,ALL,1,97500,150000,2,0,30000,1,0,30000,120000,90000
01SCS19E180104,AR.TUC-SD026,20ARSD0521,ALL,1,35750,55000,2,0,11000,1,0,11000,44000,33000
01SCS19E180104,AR.TUC-SD027,20ARSD0522,ALL,1,35750,55000,2,0,11000,1,0,11000,44000,33000
01SCS19E180104,ESH.AR-SD0018,00ARSD0137,M,1,125000,315000,2,0,94500,1,0,44100,220500,176400
01SCS19E180104,THR.AR-RG0011,00ARRG0072,L,1,1150000,1150000,2,0,115000,1,0,155250,1035000,879750
01SCS19E180105,AR.PUB-SE032,20ARSE0325,S,1,204750,315000,2,0,63000,1,0,63000,252000,189000
01SCS19E180106,ESH.AR-RB0021,00ARRB0132,M,1,95000,310000,2,0,150000,1,0,32000,160000,128000
01SCS19E180107,AR.CPT-RK011,20ARRK0033,ALL,1,48750,75000,2,0,15000,1,0,15000,60000,45000
01SCS19E180108,AR.SMD-SD018,20ARSD0580,ALL,1,97500,150000,2,0,30000,1,0,30000,120000,90000
01SCS19E180109,BSC.AR-SA0001,00ARSA0002,M,1,120000,315000,2,0,94500,1,0,44100,220500,176400
01SCS19E180110,AR.ESB-SE012,20ARSE0282,S,1,198250,305000,2,0,61000,1,0,61000,244000,183000
01SCS19E180111,BSC.AR-SC0029,00ARSC0199,S,1,125000,315000,2,0,94500,1,0,44100,220500,176400
01SCS19E180112,BSC.AR-SC0050,00ARSC0313,M,1,44000,159000,2,0,47700,1,0,22260,111300,89040
01SCS19E180113,BSC.AR-SC0009,00ARSC0052,S,1,125000,315000,2,0,94500,1,0,44100,220500,176400
01SCS19E180114,AR.MPR-SE012,20ARSE0182,M,1,97500,150000,2,0,45000,1,0,26250,105000,78750
01SCS19E180115,AR.PUB-SB029,20ARSB0450,L,1,97500,150000,2,0,30000,1,0,30000,120000,90000
01SCS19E180115,AR.PUB-SD034,20ARSD0342,L,1,97500,150000,2,0,30000,1,0,30000,120000,90000
01SCS19E180116,AR.TUC-SD014,20ARSD0474,M,1,94250,145000,2,0,29000,1,0,29000,116000,87000
01SCS19E180116,BE.RAK-SA022,00BESA0086,S,1,91000,140000,2,0,28000,1,0,28000,112000,84000
01SCS19E180117,AR.MKV-SE011,20ARSE0520,30,1,227500,350000,2,0,70000,1,0,70000,280000,210000
01SCS19E180117,AR.TUC-SA006,20ARSA0023,L,1,87750,135000,2,0,27000,1,0,27000,108000,81000
01SCS19E180117,BSC.AR-SD0026,00ARSD0153,M,1,44500,159000,2,0,47700,1,0,22260,111300,89040
01SCS19E180118,AR.PUB-RJ039,20ARRJ0508,XL,1,97500,150000,2,0,30000,1,0,30000,120000,90000
01SCS19E180118,AR.PUB-RL016,20ARRL0163,ALL,1,97500,150000,2,0,30000,1,0,30000,120000,90000
01SCS19E180119,ESH.AR-RH0006,00ARRH0058,NON,1,45000,150000,2,0,45000,1,0,21000,105000,84000
01SCS19E180120,AR.MKV-SE005,20ARSE0489,28,1,165750,255000,2,0,51000,1,0,51000,204000,153000
01SCS19E180120,BSC.AR-RL0018,00ARRL0110,M,1,125000,315000,2,0,94500,1,0,44100,220500,176400
01SCS19E180120,ESH.AR-RH0016,00ARRH0092,M,1,43000,135000,2,0,40500,1,0,18900,94500,75600
01SCS19E180121,BSC.AR-SD0022,00ARSD0128,S,1,44000,159000,2,0,47700,1,0,22260,111300,89040
01SCS19E180121,ESH.AR-SC0017,00ARSC0141,M,1,44000,135000,2,0,40500,1,0,18900,94500,75600
01SCS19E180122,BSC.AR-QG0008,00ARQG0094,ALL,1,80000,225000,2,0,125000,1,0,20000,100000,80000
01SCS19E180122,ESH.AR-SD0038,00ARSD0346,XL,1,122500,350000,2,0,105000,1,0,49000,245000,196000
01SCS19E180123,AR.ESB-SE012,20ARSE0283,M,1,198250,305000,2,0,61000,1,0,61000,244000,183000
01SCS19E180124,AR.TUC-SD007,20ARSD0164,S,1,185250,285000,2,0,57000,1,0,57000,228000,171000
01SCS19E180125,AR.MPR-SE032,20ARSE0301,L,1,230750,355000,2,0,71000,1,0,71000,284000,213000
01SCS19E180125,AR.MPR-SE033,20ARSE0305,L,1,230750,355000,2,0,71000,1,0,71000,284000,213000
01SCS19E180125,AR.TUC-SA004,20ARSA0015,L,1,87750,135000,2,0,27000,1,0,27000,108000,81000
01SCS19E180125,AR.TUC-SE012,20ARSE0409,L,1,94250,145000,2,0,29000,1,0,29000,116000,87000
01SCS19E180126,AR.REC-SD004,20ARSD0015,L,1,107250,165000,2,0,49500,1,0,28875,115500,86625
01SCS19E180127,AR.REC-SD009,20ARSD0034,M,1,178750,275000,2,0,82500,1,0,48125,192500,144375
01SCS19E180127,BSC.AR-SD0055,00ARSD0288,NON,1,50000,150000,2,0,45000,1,0,21000,105000,84000
01SCS19E180128,AR.ESB-SA001,20ARSA0204,M,1,87750,135000,2,0,27000,1,0,27000,108000,81000
01SCS19E180129,ESH.AR-SB0031,00ARSB0206,L,1,44500,135000,2,0,40500,1,0,18900,94500,75600
01SCS19E180130,ESH.AR-SD0026,00ARSD0266,S,1,44500,135000,2,0,40500,1,0,18900,94500,75600
01SCS19E180131,BSC.AR-SB0008,00ARSB0079,M,1,44500,135000,2,0,40500,1,0,18900,94500,75600
01SCS19E180132,AR.ESB-SB004,20ARSB0104,S,1,91000,140000,2,0,28000,1,0,28000,112000,84000
01SCS19E180132,AR.PUB-SE006,20ARSE0021,S,1,97500,150000,2,0,30000,1,0,30000,120000,90000
01SCS19E180132,AR.TUC-SA034,20ARSA0266,ALL,1,87750,135000,2,0,27000,1,0,27000,108000,81000
01SCS19E180133,ESH.AR-SA0012,00ARSA0094,M,1,44000,135000,2,0,40500,1,0,18900,94500,75600
01SCS19E180134,AR.CPT-RL019,20ARRL0386,M,1,94250,145000,2,0,29000,1,0,29000,116000,87000
01SCS19E180135,AR.ASH-RJ001,20ARRJ0118,30,1,273000,420000,2,0,210000,1,0,52500,210000,157500
01SCS19E180136,AR.ESB-SA004,20ARSA0215,S,1,204750,315000,2,0,63000,1,0,63000,252000,189000
01SCS19E180137,DKS.AR-SE0011,00ARSE0170,28,1,417272,696000,2,0,69600,1,0,93960,626400,532440
01SCS19E180138,ESH.AR-SB0032,00ARSB0209,M,1,125000,315000,2,0,94500,1,0,44100,220500,176400
01SCS19E180139,BSC.AR-SC0050,00ARSC0313,M,1,44000,159000,2,0,47700,1,0,22260,111300,89040
01SCS19E180139,BSC.AR-SD0030,00ARSD0175,M,1,44500,159000,2,0,47700,1,0,22260,111300,89040
01SCS19E180140,AR.TUC-SE009,20ARSE0397,M,1,204750,315000,2,0,63000,1,0,63000,252000,189000
01SCS19E180141,AR.HMR-SB019,20ARSB0389,36,1,204750,315000,2,0,63000,1,0,63000,252000,189000
01SCS19E180141,DKS.AR-SE0010,00ARSE0168,34,1,417272,696000,2,0,69600,1,0,93960,626400,532440
01SCS19E180142,BSC.AR-RL0018,00ARRL0110,M,1,125000,315000,2,0,94500,1,0,44100,220500,176400
01SCS19E180143,AR.KNR-RK008,20ARRK0277,S,1,152750,235000,2,0,70500,1,0,41125,164500,123375
01SCS19E180144,AR.TUC-SE011,20ARSE0405,L,1,94250,145000,2,0,29000,1,0,29000,116000,87000
01SCS19E180144,AR.TUC-SE012,20ARSE0409,L,1,94250,145000,2,0,29000,1,0,29000,116000,87000
01SCS19E180145,AR.SMD-RD002,20ARRD0131,L,1,87750,135000,2,0,40500,1,0,23625,94500,70875
01SCS19E180145,ESH.AR-SC0033,00ARSC0286,L,1,44000,135000,2,0,40500,1,0,18900,94500,75600
01SCS19E180146,BSC.AR-SD0051,00ARSD0257,XL,1,44000,159000,2,0,47700,1,0,22260,111300,89040
01SCS19E180146,ESH.AR-SC0011,00ARSC0086,L,1,44000,135000,2,0,40500,1,0,18900,94500,75600
01SCS19E180147,AR.PUB-SE032,20ARSE0326,M,1,204750,315000,2,0,63000,1,0,63000,252000,189000
01SCS19E180148,AR.PUB-SD018,20ARSD0187,ALL,1,97500,150000,2,0,30000,1,0,30000,120000,90000
01SCS19E180149,AR.PUB-SD033,20ARSD0244,L,1,204750,315000,2,0,63000,1,0,63000,252000,189000
01SCS19E180150,AR.CPT-RL014,20ARRL0311,ALL,1,94250,145000,2,0,29000,1,0,29000,116000,87000
01SCS19E180151,AR.TUC-SE011,20ARSE0403,S,1,94250,145000,2,0,29000,1,0,29000,116000,87000
01SCS19E180151,AR.VRS-SC001,20ARSC0162,S,1,96850,149000,2,0,44700,1,0,26075,104300,78225
01SCS19E180152,BE.RAK-SC035,00BESC0148,M,1,91000,140000,2,0,28000,1,0,28000,112000,84000
01SCS19E180153,AR.MKV-SE002,20ARSE0477,34,1,214500,330000,2,0,66000,1,0,66000,264000,198000
01SCS19E180153,AR.MKV-SE004,20ARSE0487,34,1,214500,330000,2,0,66000,1,0,66000,264000,198000
01SCS19E180153,AR.PUB-RL004,20ARRL0121,L,1,97500,150000,2,0,30000,1,0,30000,120000,90000
01SCS19E180153,AR.VRS-SC009,20ARSC0194,L,1,96850,149000,2,0,44700,1,0,26075,104300,78225
01SCS19E180153,BSC.AR-SB0009,00ARSB0084,L,1,44500,135000,2,0,40500,1,0,18900,94500,75600
01SCS19E180154,ESH.AR-SC0017,00ARSC0141,M,1,44000,135000,2,0,40500,1,0,18900,94500,75600
01SCS19E180155,AR.TUC-SE009,20ARSE0398,L,1,204750,315000,2,0,63000,1,0,63000,252000,189000
01SCS19E180156,AR.YD-RL008,20ARRL0024,ALL,1,87750,135000,2,0,67500,1,0,16875,67500,50625
01SCS19E180156,ESH.AR-RA0015,00ARRA0072,ALL,1,38000,140000,2,0,90000,1,0,10000,50000,40000
01SCS19E180157,AR.KNR-RL001,20ARRL0412,S,1,152750,235000,2,0,70500,1,0,41125,164500,123375
01SCS19E180158,ESH.AR-RJ0001,00ARRJ0012,M,1,44500,135000,2,0,40500,1,0,18900,94500,75600
01SCS19E180158,ESH.AR-SB0005,00ARSB0016,M,1,44000,135000,2,0,40500,1,0,18900,94500,75600
01SCS19E180158,ESH.AR-SC0011,00ARSC0085,M,1,44000,135000,2,0,40500,1,0,18900,94500,75600
01SCS19E180159,ESH.AR-SD0036,00ARSD0334,NON,1,50000,150000,2,0,45000,1,0,21000,105000,84000
01SCS19E180160,ESH.AR-RG0005,00ARRG0101,M,1,94500,135000,2,0,40500,1,0,18900,94500,75600
01SCS19E180160,ESH.AR-RJ0008,00ARRJ0040,M,1,44500,135000,2,0,40500,1,0,18900,94500,75600
01SCS19E180160,ESH.AR-SD0002,00ARSD0038,M,1,44500,135000,2,0,40500,1,0,18900,94500,75600
01SCS19E180161,BSC.AR-SC0049,00ARSC0308,S,1,44500,159000,2,0,47700,1,0,22260,111300,89040
01SCS19E180162,ESH.AR-RE0004,00ARRE0014,M,1,42000,135000,2,0,67500,1,0,13500,67500,54000
01SCS19E180162,ESH.AR-RE0008,00ARRE0031,L,1,42000,135000,2,0,67500,1,0,13500,67500,54000
01SCS19E180163,AR.TUC-SC004,20ARSC0057,30,1,204750,315000,2,0,63000,1,0,63000,252000,189000
01SCS19E180164,AR.SMD-RH004,20ARRH0417,L,1,87750,135000,2,0,40500,1,0,23625,94500,70875
01SCS19E180165,AR.MPR-SB003,20ARSB0243,M,1,230750,355000,2,0,71000,1,0,71000,284000,213000
01SCS19E180166,ESH.AR-SD0021,00ARSD0164,S,1,125000,315000,2,0,94500,1,0,44100,220500,176400
01SCS19E180167,AR.SMD-RH009,20ARRH0760,L,1,87750,135000,2,0,40500,1,0,23625,94500,70875
01SCS19E180168,AR.MKV-SE004,20ARSE0488,36,1,214500,330000,2,0,66000,1,0,66000,264000,198000
01SCS19E180169,AR.TUC-SD001,20ARSD0143,XL,1,204750,315000,2,0,63000,1,0,63000,252000,189000
01SCS19E180170,AR.FHL-RJ005,20ARRJ0434,L,1,211250,325000,2,0,65000,1,0,65000,260000,195000
01SCS19E180171,AR.MKV-SE002,20ARSE0475,30,1,214500,330000,2,0,66000,1,0,66000,264000,198000
01SCS19E180172,AR.VRS-SE003,20ARSE0320,30,1,298350,459000,2,0,137700,1,0,80325,321300,240975
01SCS19E180173,AR.MER-SB003,20ARSB0219,M,1,97500,150000,2,0,45000,1,0,26250,105000,78750
01SCS19E180173,BSC.AR-RI0018,00ARRI0067,M,1,94500,135000,2,0,40500,1,0,18900,94500,75600
01SCS19E180173,BSC.AR-SD0022,00ARSD0129,M,1,44000,159000,2,0,47700,1,0,22260,111300,89040
01SCS19E180174,AR.FHL-SC003,20ARSC0337,XL,1,91000,140000,2,0,28000,1,0,28000,112000,84000
01SCS19E180175,BSC.AR-RK0020,00ARRK0127,L,1,94500,135000,2,0,40500,1,0,18900,94500,75600
01SCS19E180175,ESH.AR-SD0008,00ARSD0063,L,1,44500,135000,2,0,40500,1,0,18900,94500,75600
01SCS19E180176,ESH.AR-SA0015,00ARSA0109,S,1,122500,350000,2,0,105000,1,0,49000,245000,196000
01SCS19E180177,ESH.AR-SC0023,00ARSC0165,S,1,125000,315000,2,0,94500,1,0,44100,220500,176400
01SCS19E180178,BSC.AR-SD0063,00ARSD0338,NON,1,60000,180000,2,0,54000,1,0,25200,126000,100800
01SCS19E180179,AR.SMD-RI001,20ARRI0220,M,1,87750,135000,2,0,40500,1,0,23625,94500,70875
01SCS19E180179,ESH.AR-RD0008,00ARRD0055,NON,1,80500,115000,2,0,34500,1,0,16100,80500,64400
01SCS19E180179,ESH.AR-RL0018,00ARRL0148,34,1,122500,175000,2,0,52500,1,0,24500,122500,98000
01SCS19E180179,ESH.AR-SB0008,00ARSB0033,34,1,90400,275000,2,0,82500,1,0,38500,192500,154000
01SCS19E180179,ESH.AR-SC0010,00ARSC0081,M,1,44500,135000,2,0,40500,1,0,18900,94500,75600
01SCS19E180180,ESH.AR-SB0028,00ARSB0173,L,1,44000,135000,2,0,40500,1,0,18900,94500,75600
01SCS19E180180,ESH.AR-SB0033,00ARSB0213,M,1,44500,135000,2,0,40500,1,0,18900,94500,75600
01SCS19E180180,ESH.AR-SC0014,00ARSC0111,XL,1,44500,135000,2,0,40500,1,0,18900,94500,75600
01SCS19E180180,ESH.AR-SC0017,00ARSC0142,L,1,44000,135000,2,0,40500,1,0,18900,94500,75600
01SCS19E180181,AR.PUB-SE003,20ARSE0010,M,1,97500,150000,2,0,30000,1,0,30000,120000,90000
01SCS19E180182,BSC.AR-SA0018,00ARSA0061,L,1,44000,135000,2,0,40500,1,0,18900,94500,75600
01SCS19E180183,AR.TUC-SE017,20ARSE0427,M,1,146250,225000,2,0,45000,1,0,45000,180000,135000
01SCS19E180183,ESH.AR-QH0026,00ARQH0137,ALL,1,39700,140000,2,0,90000,1,0,10000,50000,40000
01SCS19E180184,ESH.AR-SD0016,00ARSD0094,S,1,106400,350000,2,0,105000,1,0,49000,245000,196000
01SCS19E180185,AR.ESB-SE012,20ARSE0284,L,1,198250,305000,2,0,61000,1,0,61000,244000,183000
01SCS19E180186,BSC.AR-RK0018,00ARRK0118,M,1,43000,135000,2,0,40500,1,0,18900,94500,75600
01SCS19E180186,BSC.AR-SD0039,00ARSD0212,M,1,125000,315000,2,0,94500,1,0,44100,220500,176400
01SCS19E180187,ESH.AR-SD0018,00ARSD0138,L,1,125000,315000,2,0,94500,1,0,44100,220500,176400
01SCS19E180188,AR.MPR-SE032,20ARSE0301,L,1,230750,355000,2,0,71000,1,0,71000,284000,213000
01SCS19E180189,BE.RAK-RX233,00BERX0689,XL,1,185250,285000,2,0,57000,1,0,57000,228000,171000
01SCS19E180190,AR.MPR-SE016,20ARSE0199,L,1,243750,375000,2,0,75000,1,0,75000,300000,225000
01SCS19E180191,AR.ASH-RK004,20ARRK0516,M,1,195000,300000,2,0,90000,1,0,52500,210000,157500
01SCS19E180192,AR.TUC-SA031,20ARSA0257,S,1,87750,135000,2,0,27000,1,0,27000,108000,81000
01SCS19E180192,AR.YD-RL001,20ARRL0017,ALL,1,91000,140000,2,0,70000,1,0,17500,70000,52500
01SCS19E180193,BSC.AR-SD0041,00ARSD0226,XL,1,44500,159000,2,0,47700,1,0,22260,111300,89040
01SCS19E180194,AR.MKV-SC004,20ARSC0080,L,1,253500,390000,2,0,78000,1,0,78000,312000,234000
01SCS19E180195,AR.CPT-SC003,20ARSC0248,28,1,227500,350000,2,0,70000,1,0,70000,280000,210000
01SCS19E180195,AR.PUB-SD016,20ARSD0132,XL,1,97500,150000,2,0,30000,1,0,30000,120000,90000
01SCS19E180196,AR.MPR-SE031,20ARSE0295,S,1,230750,355000,2,0,71000,1,0,71000,284000,213000
01SCS19E180196,ESH.AR-RK0014,00ARRK0187,S,1,112500,350000,2,0,105000,1,0,49000,245000,196000
01SCS19E180197,AR.PUB-SE032,20ARSE0326,M,1,204750,315000,2,0,63000,1,0,63000,252000,189000
01SCS19E180198,AR.SMD-SA002,20ARSA0226,XL,1,87750,135000,2,0,27000,1,0,27000,108000,81000
01SCS19E180199,ESH.AR-SA0012,00ARSA0095,L,1,44000,135000,2,0,40500,1,0,18900,94500,75600
01SCS19E180199,ESH.AR-SD0005,00ARSD0051,L,1,44000,135000,2,0,40500,1,0,18900,94500,75600
01SCS19E180200,ESH.AR-SD0011,00ARSD0074,M,1,125000,315000,2,0,94500,1,0,44100,220500,176400
01SCS19E180201,AR.ESB-SC018,20ARSC0465,M,1,91000,140000,2,0,28000,1,0,28000,112000,84000
01SCS19E180201,BSC.AR-RL0018,00ARRL0110,M,1,125000,315000,2,0,94500,1,0,44100,220500,176400
01SCS19E180202,AR.TUC-SE009,20ARSE0396,S,1,204750,315000,2,0,63000,1,0,63000,252000,189000
01SCS19E180203,BSC.AR-SC0021,00ARSC0148,NON,1,73000,220000,2,0,66000,1,0,30800,154000,123200
01SCS19E180204,AR.MKV-SC007,20ARSC0090,S,1,91000,140000,2,0,28000,1,0,28000,112000,84000
01SCS19E180204,BSC.AR-RJ0018,00ARRJ0109,L,1,94500,135000,2,0,40500,1,0,18900,94500,75600
01SCS19E180205,AR.GTW-SB001,20ARSB0149,M,1,94250,145000,2,0,43500,1,0,25375,101500,76125
01SCS19E180205,AR.PUB-SB029,20ARSB0450,L,1,97500,150000,2,0,30000,1,0,30000,120000,90000
01SCS19E180206,AR.CPT-RK007,20ARRK0024,M,1,204750,315000,2,0,63000,1,0,63000,252000,189000
01SCS19E180207,BSC.AR-RJ0016,00ARRJ0100,M,1,43000,135000,2,0,40500,1,0,18900,94500,75600
01SCS19E180207,BSC.AR-SC0050,00ARSC0313,M,1,44000,159000,2,0,47700,1,0,22260,111300,89040
01SCS19E180207,BSC.AR-SD0007,00ARSD0027,L,1,44500,159000,2,0,47700,1,0,22260,111300,89040
01SCS19E180208,AR.ESB-SD015,20ARSD0334,M,1,91000,140000,2,0,28000,1,0,28000,112000,84000
01SCS19E180208,BE.RAK-SB034,00BESB0102,XL,1,91000,140000,2,0,28000,1,0,28000,112000,84000
01SCS19E180209,AR.STY-SE008,20ARSE0126,ALL,1,55250,85000,2,0,17000,1,0,17000,68000,51000
01SCS19E180210,BSC.AR-SA0002,00ARSA0008,XL,1,220500,315000,2,0,94500,1,0,44100,220500,176400
01SCS19E180211,AR.TUC-SE012,20ARSE0408,M,1,94250,145000,2,0,29000,1,0,29000,116000,87000
01SCS19E180212,AR.TUC-RL007,20ARRL0323,M,1,204750,315000,2,0,63000,1,0,63000,252000,189000
01SCS19E180213,BSC.AR-RI0030,00ARRI0139,NON,1,98000,140000,2,0,42000,1,0,19600,98000,78400
01SCS19E180214,AR.PUB-RL006,20ARRL0129,L,1,97500,150000,2,0,30000,1,0,30000,120000,90000
01SCS19E180214,AR.REC-SD011,20ARSD0043,L,1,107250,165000,2,0,49500,1,0,28875,115500,86625
01SCS19E180214,AR.VLD-RK019,20ARRK0355,L,1,91000,140000,2,0,42000,1,0,24500,98000,73500
01SCS19E180215,ESH.AR-RE0004,00ARRE0015,L,1,42000,135000,2,0,67500,1,0,13500,67500,54000
01SCS19E180215,ESH.AR-RE0008,00ARRE0031,L,1,42000,135000,2,0,67500,1,0,13500,67500,54000
01SCS19E180216,BSC.AR-SD0054,00ARSD0287,NON,1,50000,150000,2,0,45000,1,0,21000,105000,84000
01SCS19E180217,ESH.AR-RJ0007,00ARRJ0036,M,1,44500,135000,2,0,40500,1,0,18900,94500,75600
01SCS19E180218,AR.BPH-SD006,20ARSD0375,S,1,259350,399000,2,0,199500,1,0,49875,199500,149625
01SCS19E180219,BSC.AR-SC0004,00ARSC0032,L,1,125000,315000,2,0,94500,1,0,44100,220500,176400
01SCS19E180220,AR.PUB-SC015,20ARSC0363,XL,1,97500,150000,2,0,30000,1,0,30000,120000,90000
01SCS19E180220,AR.PUB-SD016,20ARSD0130,M,1,97500,150000,2,0,30000,1,0,30000,120000,90000
01SCS19E180221,AR.PUB-SD032,20ARSD0239,M,1,204750,315000,2,0,63000,1,0,63000,252000,189000
01SCS19E180221,AR.PUB-SE024,20ARSE0091,S,1,159250,245000,2,0,49000,1,0,49000,196000,147000
01SCS19E180222,BSC.AR-RK0012,00ARRK0094,M,1,43000,135000,2,0,40500,1,0,18900,94500,75600
01SCS19E180223,BSC.AR-SD0018,00ARSD0123,NON,1,45000,150000,2,0,45000,1,0,21000,105000,84000
01SCS19E180223,ESH.AR-SC0017,00ARSC0141,M,1,44000,135000,2,0,40500,1,0,18900,94500,75600
01SCS19E180224,AR.ASH-RE009,20ARRE1374,32,1,273000,420000,2,0,210000,1,0,52500,210000,157500
01SCS19E180225,AR.ESB-SE008,20ARSE0267,M,1,100750,155000,2,0,31000,1,0,31000,124000,93000
01SCS19E180226,BSC.AR-SD0007,00ARSD0025,S,1,44500,159000,2,0,47700,1,0,22260,111300,89040
01SCS19E180227,BSC.AR-SC0039,00ARSC0256,XL,1,190000,475000,2,0,142500,1,0,66500,332500,266000
01SCS19E180228,AR.PUB-SD011,20ARSD0121,ALL,1,97500,150000,2,0,30000,1,0,30000,120000,90000
01SCS19E180228,ESH.AR-QH0026,00ARQH0137,ALL,1,39700,140000,2,0,90000,1,0,10000,50000,40000
01SCS19E180229,AR.TUC-SB002,20ARSB0027,S,1,204750,315000,2,0,63000,1,0,63000,252000,189000
01SCS19E180230,ESH.AR-RJ0026,00ARRJ0230,XL,1,220500,315000,2,0,94500,1,0,44100,220500,176400
01SCS19E180231,ESH.AR-SC0034,00ARSC0294,L,1,125000,315000,2,0,94500,1,0,44100,220500,176400
01SCS19E180232,BSC.AR-SD0026,00ARSD0154,L,1,44500,159000,2,0,47700,1,0,22260,111300,89040
01SCS19E180233,AR.ESB-SE001,20ARSE0241,XL,1,204750,315000,2,0,63000,1,0,63000,252000,189000
01SCS19E180234,ESH.AR-RG0003,00ARRG0007,M,1,90000,255000,2,0,76500,1,0,35700,178500,142800
01SCS19E180235,AR.MPR-SE035,20ARSE0311,ALL,1,136500,210000,2,0,42000,1,0,42000,168000,126000
01SCS19E180236,DKS.AR-SE0006,00ARSE0146,28,1,417272,696000,2,0,69600,1,0,93960,626400,532440
01SCS19E180237,ARN.AR-SB0001,00ARSB0086,NON,1,107400,179000,2,0,35800,1,0,42960,143200,100240
01SCS19E180238,AR.HLW-SC011,20ARSC0146,L,1,100750,155000,2,0,46500,1,0,27125,108500,81375
01SCS19E180238,AR.SMD-RH009,20ARRH0759,M,1,87750,135000,2,0,40500,1,0,23625,94500,70875
01SCS19E180239,AR.CPT-QI001,20ARQI0002,ALL,1,94250,145000,2,0,29000,1,0,29000,116000,87000
01SCS19E180239,ESH.AR-SD0011,00ARSD0073,S,1,125000,315000,2,0,94500,1,0,44100,220500,176400
01SCS19E180240,ESH.AR-SB0029,00ARSB0196,S,1,125000,315000,2,0,94500,1,0,44100,220500,176400
01SCS19E180241,ESH.AR-QH0026,00ARQH0137,ALL,1,39700,140000,2,0,90000,1,0,10000,50000,40000
01SCS19E180242,AR.MPR-SE003,20ARSE0146,M,1,97500,150000,2,0,45000,1,0,26250,105000,78750
01SCS19E180243,ESH.AR-SD0001,00ARSD0030,M,1,44500,135000,2,0,40500,1,0,18900,94500,75600
01SCS19E180244,AR.CLK-SA002,20ARSA0051,ALL,1,84500,130000,2,0,26000,1,0,26000,104000,78000
01SCS19E180245,AR.HMR-SB007,20ARSB0362,L,1,83850,129000,2,0,25800,1,0,25800,103200,77400
01SCS19E180246,BSC.AR-QB0014,00ARQB0101,ALL,1,45000,150000,2,0,100000,1,0,10000,50000,40000
01SCS19E180247,ESH.AR-SC0009,00ARSC0078,L,1,44500,135000,2,0,40500,1,0,18900,94500,75600
01SCS19E180248,BSC.AR-QG0010,00ARQG0099,ALL,1,80000,240000,2,0,140000,1,0,20000,100000,80000
01SCS19E180249,BSC.AR-RI0015,00ARRI0054,S,1,43000,135000,2,0,40500,1,0,18900,94500,75600
01SCS19E180249,BSC.AR-RI0015,00ARRI0055,M,1,43000,135000,2,0,40500,1,0,18900,94500,75600
01SCS19E180249,ESH.AR-QI0003,00ARQI0036,ALL,1,40000,140000,2,0,90000,1,0,10000,50000,40000
01SCS19E180250,BE.RAK-RX355,00BERX1306,L,1,91000,140000,2,0,28000,1,0,28000,112000,84000
01SCS19E180251,AR.SMD-SD010,20ARSD0311,30,1,211250,325000,2,0,65000,1,0,65000,260000,195000
01SCS19E180252,AR.SMD-SD011,20ARSD0316,32,1,211250,325000,2,0,65000,1,0,65000,260000,195000
01SCS19E180253,AR.CPT-RI007,20ARRI0066,L,1,94250,145000,2,0,29000,1,0,29000,116000,87000
01SCS19E180253,AR.SMD-RH004,20ARRH0417,L,1,87750,135000,2,0,40500,1,0,23625,94500,70875
01SCS19E180253,AR.SMD-RH009,20ARRH0759,M,1,87750,135000,2,0,40500,1,0,23625,94500,70875
01SCS19E180253,AR.STY-SE002,20ARSE0120,ALL,1,55250,85000,2,0,17000,1,0,17000,68000,51000
01SCS19E180254,AR.VLD-RK012,20ARRK0331,ALL,1,97500,150000,2,0,45000,1,0,26250,105000,78750
01SCS19E180254,ESH.AR-SC0004,00ARSC0024,XL,1,44500,135000,2,0,40500,1,0,18900,94500,75600
01SCS19E180255,ESH.AR-SC0021,00ARSC0157,S,1,44000,135000,2,0,40500,1,0,18900,94500,75600
01SCS19E180256,AR.PUB-RL029,20ARRL0437,ALL,1,97500,150000,2,0,30000,1,0,30000,120000,90000
01SCS19E180257,ESH.AR-RC0002,00ARRC0007,L,1,85000,240000,2,0,115000,1,0,25000,125000,100000
01SCS19E180258,ESH.AR-SD0004,00ARSD0046,M,1,44500,135000,2,0,40500,1,0,18900,94500,75600
01SCS19E180259,BSC.AR-RI0015,00ARRI0055,M,1,43000,135000,2,0,40500,1,0,18900,94500,75600
01SCS19E180259,ESH.AR-SB0033,00ARSB0212,S,1,44500,135000,2,0,40500,1,0,18900,94500,75600
01SCS19E180260,ESH.AR-SD0019,00ARSD0140,S,1,125000,315000,2,0,94500,1,0,44100,220500,176400
01SCS19E180261,ESH.AR-RC0002,00ARRC0008,XL,1,85000,240000,2,0,115000,1,0,25000,125000,100000
01SCS19E180262,AR.SMD-RH009,20ARRH0760,L,1,87750,135000,2,0,40500,1,0,23625,94500,70875
01SCS19E180263,AR.STY-SE003,20ARSE0121,ALL,1,55250,85000,2,0,17000,1,0,17000,68000,51000
01SCS19E180263,THR.AR-RG0004,00ARRG0043,M,1,415000,415000,2,0,41500,1,0,56025,373500,317475
01SCS19E180264,BSC.AR-SC0010,00ARSC0056,S,1,125000,315000,2,0,94500,1,0,44100,220500,176400
01SCS19E180265,AR.STY-SE006,20ARSE0124,ALL,1,55250,85000,2,0,17000,1,0,17000,68000,51000
01SCS19E180265,AR.STY-SE008,20ARSE0126,ALL,1,55250,85000,2,0,17000,1,0,17000,68000,51000
01SCS19E180266,ESH.AR-RC0002,00ARRC0007,L,1,85000,240000,2,0,115000,1,0,25000,125000,100000
01SCS19E180267,AR.CPT-QL011,20ARQL0167,M,1,204750,315000,2,0,63000,1,0,63000,252000,189000
01SCS19E180267,AR.STY-SE006,20ARSE0124,ALL,1,55250,85000,2,0,17000,1,0,17000,68000,51000
01SCS19E180267,AR.TUC-RL015,20ARRL0339,ALL,1,87750,135000,2,0,27000,1,0,27000,108000,81000
01SCS19E180268,AR.VCS-RL002,20ARRL0299,XL,1,97500,150000,2,0,45000,1,0,26250,105000,78750
01SCS19E180269,AR.ESB-SE011,20ARSE0279,M,1,227500,350000,2,0,70000,1,0,70000,280000,210000
01SCS19E180269,AR.SMD-RI006,20ARRI0328,L,1,87750,135000,2,0,40500,1,0,23625,94500,70875
01SCS19E180270,AR.SMD-SD015,20ARSD0577,ALL,1,97500,150000,2,0,30000,1,0,30000,120000,90000
01SCS19E180270,BSC.AR-SC0046,00ARSC0298,NON,1,45000,150000,2,0,45000,1,0,21000,105000,84000
01SCS19E180270,ESH.AR-SB0012,00ARSB0056,32,1,90,285000,2,0,85500,1,0,39900,199500,159600
01SCS19E180271,ESH.AR-SC0015,00ARSC0121,M,1,44000,135000,2,0,40500,1,0,18900,94500,75600
01SCS19E190001,BSC.AR-RI0015,00ARRI0055,M,1,43000,135000,2,0,40500,1,0,18900,94500,75600
01SCS19E190001,BSC.AR-SA0002,00ARSA0007,L,1,120000,315000,2,0,94500,1,0,44100,220500,176400
01SCS19E190002,ESH.AR-SC0028,00ARSC0266,M,1,44500,135000,2,0,40500,1,0,18900,94500,75600
01SCS19E190003,ESH.AR-RH0020,00ARRH0108,M,1,94500,135000,2,0,40500,1,0,18900,94500,75600
01SCS19E190004,BSC.AR-SD0013,00ARSD0106,S,1,44500,159000,2,0,47700,1,0,22260,111300,89040
01SCS19E190005,BSC.AR-RI0035,00ARRI0210,L,1,220500,315000,2,0,94500,1,0,44100,220500,176400
01SCS19E190006,AR.TUC-SA035,20ARSA0267,ALL,1,87750,135000,2,0,27000,1,0,27000,108000,81000
01SCS19E190007,ESH.AR-SB0033,00ARSB0212,S,1,44500,135000,2,0,40500,1,0,18900,94500,75600
01SCS19E190008,AR.HLW-SA020,20ARSA0126,30,1,243750,375000,2,0,112500,1,0,65625,262500,196875
01SCS19E190008,AR.MKV-SE002,20ARSE0474,28,1,214500,330000,2,0,66000,1,0,66000,264000,198000
01SCS19E190008,BSC.AR-RH0017,00ARRH0074,S,1,120000,315000,2,0,94500,1,0,44100,220500,176400
01SCS19E190008,BSC.AR-SD0006,00ARSD0021,S,1,44000,159000,2,0,47700,1,0,22260,111300,89040
01SCS19E190008,ESH.AR-SA0004,00ARSA0056,M,1,44500,135000,2,0,40500,1,0,18900,94500,75600
01SCS19E190008,ESH.AR-SC0013,00ARSC0104,S,1,44500,135000,2,0,40500,1,0,18900,94500,75600
01SCS19E190008,ESH.AR-SC0028,00ARSC0265,S,1,44500,135000,2,0,40500,1,0,18900,94500,75600
01SCS19E190009,BSC.AR-SA0008,00ARSA0034,NON,1,47500,140000,2,0,42000,1,0,19600,98000,78400
01SCS19E190010,ESH.AR-PL0032,00ARPL0231,ALL,1,39800,140000,2,0,90000,1,0,10000,50000,40000
01SCS19E190011,BSC.AR-RL0026,00ARRL0172,L,1,94500,135000,2,0,40500,1,0,18900,94500,75600
01SCS19E190011,ESH.AR-RD0003,00ARRD0027,32,1,110000,350000,2,0,175000,1,0,35000,175000,140000
01SCS19E190011,ESH.AR-SB0021,00ARSB0121,L,1,44500,135000,2,0,40500,1,0,18900,94500,75600
01SCS19E190012,BSC.AR-SD0054,00ARSD0287,NON,1,50000,150000,2,0,45000,1,0,21000,105000,84000
01SCS19E190013,BSC.AR-RK0023,00ARRK0214,XL,1,120000,315000,2,0,94500,1,0,44100,220500,176400
01SCS19E190014,ESH.AR-SB0014,00ARSB0060,NON,1,45000,140000,2,0,42000,1,0,19600,98000,78400
01SCS19E190014,ESH.AR-SC0037,00ARSC0302,NON,1,40000,140000,2,0,42000,1,0,19600,98000,78400
01SCS19E190015,BSC.AR-RI0015,00ARRI0054,S,1,43000,135000,2,0,40500,1,0,18900,94500,75600
01SCS19E190015,ESH.AR-SD0005,00ARSD0049,S,1,44000,135000,2,0,40500,1,0,18900,94500,75600
01SCS19E190016,BE.RAK-RX208,00BERX0560,M,1,161850,249000,2,0,49800,1,0,49800,199200,149400
01SCS19E190016,BSC.AR-RH0017,00ARRH0075,M,1,120000,315000,2,0,94500,1,0,44100,220500,176400
01SCS19E190016,BSC.AR-SD0019,00ARSD0124,NON,1,45000,150000,2,0,45000,1,0,21000,105000,84000
01SCS19E190017,AR.MPR-SE005,20ARSE0154,M,1,97500,150000,2,0,45000,1,0,26250,105000,78750
01SCS19E190018,ESH.AR-RC0005,00ARRC0066,M,1,95000,310000,2,0,150000,1,0,32000,160000,128000
01SCS19E190019,AR.FHL-SE003,20ARSE0378,ALL,1,78000,120000,2,0,24000,1,0,24000,96000,72000
01SCS19E190019,BSC.AR-SD0001,00ARSD0003,L,1,44000,159000,2,0,47700,1,0,22260,111300,89040
01SCS19E190020,AR.TUC-SE011,20ARSE0404,M,1,94250,145000,2,0,29000,1,0,29000,116000,87000
01SCS19E190021,AR.ESB-SA004,20ARSA0216,M,1,204750,315000,2,0,63000,1,0,63000,252000,189000
01SCS19E190022,AR.MKV-RL005,20ARRL0253,34,1,227500,350000,2,0,70000,1,0,70000,280000,210000
01SCS19E190022,AR.PUB-SC014,20ARSC0358,L,1,97500,150000,2,0,30000,1,0,30000,120000,90000
01SCS19E190022,AR.SMD-SD003,20ARSD0286,L,1,97500,150000,2,0,45000,1,0,26250,105000,78750
01SCS19E190022,BSC.AR-RK0005,00ARRK0066,M,1,108500,155000,2,0,46500,1,0,21700,108500,86800
01SCS19E190023,AR.TUC-SA018,20ARSE0286,S,1,204750,315000,2,0,63000,1,0,63000,252000,189000
01SCS19E190023,ESH.AR-SD0011,00ARSD0074,M,1,125000,315000,2,0,94500,1,0,44100,220500,176400
01SCS19E190024,ESH.AR-SC0034,00ARSC0292,S,1,125000,315000,2,0,94500,1,0,44100,220500,176400
01SCS19E190025,BSC.AR-QG0018,00ARQG0150,S,1,135000,395000,2,0,220000,1,0,35000,175000,140000
01SCS19E190025,ESH.AR-RD0021,00ARRD0193,L,1,42000,135000,2,0,67500,1,0,13500,67500,54000
01SCS19E190025,ESH.AR-RE0019,00ARRE0204,S,1,43000,150000,2,0,82500,1,0,13500,67500,54000
01SCS19E190026,ESH.AR-RJ0004,00ARRJ0023,S,1,43000,135000,2,0,40500,1,0,18900,94500,75600
01SCS19E190026,ESH.AR-SC0016,00ARSC0136,S,1,44000,135000,2,0,40500,1,0,18900,94500,75600
01SCS19E190027,AR.PUB-RJ038,20ARRJ0501,S,1,97500,150000,2,0,30000,1,0,30000,120000,90000
01SCS19E190027,AR.PUB-SB033,20ARSB0464,ALL,1,97500,150000,2,0,30000,1,0,30000,120000,90000
01SCS19E190027,ESH.AR-RJ0002,00ARRJ0015,S,1,44500,135000,2,0,40500,1,0,18900,94500,75600
01SCS19E190028,ESH.AR-PL0032,00ARPL0231,ALL,1,39800,140000,2,0,90000,1,0,10000,50000,40000
01SCS19E190029,BSC.AR-RE0018,00ARRE0118,NON,1,36837,115000,2,0,15000,1,0,20000,100000,80000
01SCS19E190030,BSC.AR-SC0026,00ARSC0187,L,1,106400,350000,2,0,105000,1,0,49000,245000,196000
01SCS19E190031,BSC.AR-PI0019,00ARPI0019,ALL,1,58334,175000,2,0,75000,1,0,20000,100000,80000
01SCS19E190031,BSC.AR-QG0008,00ARQG0094,ALL,1,80000,225000,2,0,125000,1,0,20000,100000,80000
01SCS19E190031,ESH.AR-RJ0023,00ARRJ0218,NON,1,18000,75000,2,0,22500,1,0,10500,52500,42000
01SCS19E190032,AR.MPR-SE015,20ARSE0193,S,1,256750,395000,2,0,79000,1,0,79000,316000,237000
01SCS19E190033,BSC.AR-QG0008,00ARQG0094,ALL,1,80000,225000,2,0,125000,1,0,20000,100000,80000
01SCS19E190034,AR.GTW-RK001,20ARRK0373,ALL,1,103935,159900,2,0,47970,1,0,27982,111930,83948
01SCS19E190034,ESH.AR-SD0041,00ARSD0371,M,1,125000,315000,2,0,94500,1,0,44100,220500,176400
01SCS19E190035,AR.MPR-SE011,20ARSE0178,M,1,97500,150000,2,0,45000,1,0,26250,105000,78750
01SCS19E190035,BSC.AR-QG0010,00ARQG0099,ALL,1,80000,240000,2,0,140000,1,0,20000,100000,80000
01SCS19E190035,BSC.AR-SD0002,00ARSD0006,M,1,44000,159000,2,0,47700,1,0,22260,111300,89040
01SCS19E190036,ESH.AR-SB0033,00ARSB0214,L,1,44500,135000,2,0,40500,1,0,18900,94500,75600
01SCS19E190037,BSC.AR-RI0015,00ARRI0055,M,1,43000,135000,2,0,40500,1,0,18900,94500,75600
01SCS19E190038,BSC.AR-RI0001,00ARRI0002,M,1,315000,450000,2,0,135000,1,0,63000,315000,252000
01SCS19E190039,AR.TUC-SA031,20ARSA0258,M,1,87750,135000,2,0,27000,1,0,27000,108000,81000
01SCS19E190039,BSC.AR-SD0006,00ARSD0023,L,1,44000,159000,2,0,47700,1,0,22260,111300,89040
01SCS19E190039,BSC.AR-SD0040,00ARSD0216,M,1,44500,159000,2,0,47700,1,0,22260,111300,89040
01SCS19E190040,AR.MPR-SE012,20ARSE0182,M,1,97500,150000,2,0,45000,1,0,26250,105000,78750
01SCS19E190041,AR.HLW-SA020,20ARSA0126,30,1,243750,375000,2,0,112500,1,0,65625,262500,196875
01SCS19E190042,BSC.AR-SD0004,00ARSD0013,S,1,44000,159000,2,0,47700,1,0,22260,111300,89040
01SCS19E190042,ESH.AR-SD0001,00ARSD0029,S,1,44500,135000,2,0,40500,1,0,18900,94500,75600
01SCS19E190043,AR.PUB-RJ022,20ARRJ0254,ALL,1,97500,150000,2,0,30000,1,0,30000,120000,90000
01SCS19E190043,BSC.AR-SD0018,00ARSD0123,NON,1,45000,150000,2,0,45000,1,0,21000,105000,84000
01SCS19E190044,AR.MKV-SC002,20ARSC0075,32,1,117000,180000,2,0,36000,1,0,36000,144000,108000
01SCS19E190044,ESH.AR-RJ0005,00ARRJ0027,S,1,94500,135000,2,0,40500,1,0,18900,94500,75600
01SCS19E190044,ESH.AR-SC0011,00ARSC0084,S,1,44000,135000,2,0,40500,1,0,18900,94500,75600
01SCS19E190045,BSC.AR-SC0013,00ARSC0093,M,1,44000,135000,2,0,40500,1,0,18900,94500,75600
01SCS19E190045,ESH.AR-SA0012,00ARSA0094,M,1,44000,135000,2,0,40500,1,0,18900,94500,75600
01SCS19E190046,AR.PUB-SA003,20ARSA0233,L,1,97500,150000,2,0,30000,1,0,30000,120000,90000
01SCS19E190046,AR.PUB-SB030,20ARSB0454,L,1,97500,150000,2,0,30000,1,0,30000,120000,90000
01SCS19E190046,ESH.AR-SB0003,00ARSB0009,L,1,44000,135000,2,0,40500,1,0,18900,94500,75600
01SCS19E190047,AR.ESB-SD010,20ARSD0183,S,1,91000,140000,2,0,28000,1,0,28000,112000,84000
01SCS19E190047,AR.MPR-SE019,20ARSE0203,ALL,1,97500,150000,2,0,45000,1,0,26250,105000,78750
01SCS19E190047,ESH.AR-RC0002,00ARRC0007,L,1,85000,240000,2,0,115000,1,0,25000,125000,100000
01SCS19E190047,ESH.AR-RK0006,00ARRK0026,M,1,43000,135000,2,0,40500,1,0,18900,94500,75600
01SCS19E190048,BSC.AR-SC0017,00ARSC0118,L,1,44500,135000,2,0,40500,1,0,18900,94500,75600
01SCS19E190049,AR.GTW-SC002,20ARSC0026,M,1,97500,150000,2,0,45000,1,0,26250,105000,78750
01SCS19E190050,AR.MKV-RJ002,20ARRJ0146,M,1,91000,140000,2,0,28000,1,0,28000,112000,84000
01SCS19E190050,AR.PUB-SB020,20ARSB0074,S,1,159250,245000,2,0,49000,1,0,49000,196000,147000
01SCS19E190051,ESH.AR-RD0024,00ARRD0229,L,1,145000,435000,2,0,260000,1,0,35000,175000,140000
01SCS19E190052,BSC.AR-RH0017,00ARRH0075,M,1,120000,315000,2,0,94500,1,0,44100,220500,176400
01SCS19E190052,ESH.AR-SA0016,00ARSA0115,NON,1,55000,150000,2,0,45000,1,0,21000,105000,84000
01SCS19E190052,ESH.AR-SC0014,00ARSC0108,S,1,44500,135000,2,0,40500,1,0,18900,94500,75600
01SCS19E190053,AR.ESB-SD015,20ARSD0334,M,1,91000,140000,2,0,28000,1,0,28000,112000,84000
01SCS19E190053,ESH.AR-RJ0001,00ARRJ0012,M,1,44500,135000,2,0,40500,1,0,18900,94500,75600
01SCS19E190054,AR.PUB-SA009,20ARSA0332,XL,1,224250,345000,2,0,69000,1,0,69000,276000,207000
01SCS19E190054,ESH.AR-SA0017,00ARSA0118,L,1,122500,350000,2,0,105000,1,0,49000,245000,196000
01SCS19E190055,AR.ESB-SE008,20ARSE0266,S,1,100750,155000,2,0,31000,1,0,31000,124000,93000
01SCS19E190055,BSC.AR-SD0042,00ARSD0227,S,1,44500,159000,2,0,47700,1,0,22260,111300,89040
01SCS19E190056,DKS.AR-SE0004,00ARSE0140,30,1,417272,696000,2,0,69600,1,0,93960,626400,532440
01SCS19E190057,ESH.AR-SB0015,00ARSB0064,L,1,125000,315000,2,0,94500,1,0,44100,220500,176400
01SCS19E190058,AR.TUC-RI011,20ARRI0367,M,1,87750,135000,2,0,27000,1,0,27000,108000,81000
01SCS19E190059,AR.RDC-RK007,20ARRK0478,M,1,97500,150000,2,0,30000,1,0,30000,120000,90000
01SCS19E190060,BSC.AR-SD0006,00ARSD0022,M,1,44000,159000,2,0,47700,1,0,22260,111300,89040
01SCS19E190060,ESH.AR-SC0021,00ARSC0158,M,1,44000,135000,2,0,40500,1,0,18900,94500,75600
01SCS19E190061,AR.TUC-RI012,20ARRI0372,L,1,87750,135000,2,0,27000,1,0,27000,108000,81000
01SCS19E190061,BSC.AR-RI0031,00ARRI0140,NON,1,43000,140000,2,0,42000,1,0,19600,98000,78400
01SCS19E190061,BSC.AR-SD0042,00ARSD0228,M,1,44500,159000,2,0,47700,1,0,22260,111300,89040
01SCS19E190062,BSC.AR-RL0018,00ARRL0110,M,1,125000,315000,2,0,94500,1,0,44100,220500,176400
01SCS19E190063,AR.PUB-RL028,20ARRL0436,ALL,1,97500,150000,2,0,30000,1,0,30000,120000,90000
01SCS19E190064,AR.ESB-SD013,20ARSD0326,M,1,91000,140000,2,0,28000,1,0,28000,112000,84000
01SCS19E190065,AR.CPT-SC010,20ARSC0472,M,1,204750,315000,2,0,63000,1,0,63000,252000,189000
01SCS19E190066,BSC.AR-QJ0014,00ARQJ0112,S,1,100000,310000,2,0,150000,1,0,32000,160000,128000
01SCS19E190066,BSC.AR-SB0015,00ARSB0128,M,1,125000,315000,2,0,94500,1,0,44100,220500,176400
01SCS19E190066,BSC.AR-SD0022,00ARSD0128,S,1,44000,159000,2,0,47700,1,0,22260,111300,89040
01SCS19E190067,AR.TUC-SE009,20ARSE0396,S,1,204750,315000,2,0,63000,1,0,63000,252000,189000
01SCS19E190068,ESH.AR-SD0010,00ARSD0070,M,1,44500,135000,2,0,40500,1,0,18900,94500,75600
01SCS19E190069,BSC.AR-QI0010,00ARQI0037,ALL,1,46000,140000,2,0,40000,1,0,20000,100000,80000
01SCS19E190069,BSC.AR-SC0050,00ARSC0314,L,1,44000,159000,2,0,47700,1,0,22260,111300,89040
01SCS19E190069,BSC.AR-SD0002,00ARSD0006,M,1,44000,159000,2,0,47700,1,0,22260,111300,89040
01SCS19E190070,BSC.AR-SC0014,00ARSC0096,S,1,44000,159000,2,0,47700,1,0,22260,111300,89040
01SCS19E190071,BSC.AR-RK0008,00ARRK0079,L,1,52000,155000,2,0,46500,1,0,21700,108500,86800
01SCS19E190072,AR.TUC-SA035,20ARSA0267,ALL,1,87750,135000,2,0,27000,1,0,27000,108000,81000
01SCS19E190072,BE.RAK-SC005,00BESC0013,XL,1,247000,380000,2,0,76000,1,0,76000,304000,228000
01SCS19E190073,AR.ESB-SE010,20ARSE0275,M,1,227500,350000,2,0,70000,1,0,70000,280000,210000
01SCS19E190074,BSC.AR-SA0017,00ARSA0052,M,1,125000,315000,2,0,94500,1,0,44100,220500,176400
01SCS19E190075,AR.PUB-SE032,20ARSE0328,XL,1,204750,315000,2,0,63000,1,0,63000,252000,189000
01SCS19E190076,AR.PUB-RL018,20ARRL0169,M,1,191750,295000,2,0,59000,1,0,59000,236000,177000
01SCS19E190077,AR.MKV-SE001,20ARSE0471,32,1,214500,330000,2,0,66000,1,0,66000,264000,198000
01SCS19E190078,BSC.AR-SC0009,00ARSC0052,S,1,125000,315000,2,0,94500,1,0,44100,220500,176400
01SCS19E190079,ESH.AR-SD0021,00ARSD0164,S,1,125000,315000,2,0,94500,1,0,44100,220500,176400
01SCS19E190080,AR.MPR-SB015,20ARSB0290,S,1,273000,420000,2,0,84000,1,0,84000,336000,252000
01SCS19E190081,ESH.AR-SA0014,00ARSA0101,S,1,44000,135000,2,0,40500,1,0,18900,94500,75600
01SCS19E190082,AR.SMD-QE001,20ARQE0001,S,1,87750,135000,2,0,40500,1,0,23625,94500,70875
01SCS19E190082,BE.RAK-SA023,00BESA0091,S,1,91000,140000,2,0,28000,1,0,28000,112000,84000
01SCS19E190083,AR.ESB-RK008,20ARRK0241,ALL,1,87750,135000,2,0,40500,1,0,23625,94500,70875
01SCS19E190084,AR.HLW-SC011,20ARSC0146,L,1,100750,155000,2,0,46500,1,0,27125,108500,81375
01SCS19E190084,BSC.AR-SC0049,00ARSC0308,S,1,44500,159000,2,0,47700,1,0,22260,111300,89040
01SCS19E190084,ESH.AR-SB0031,00ARSB0204,S,1,44500,135000,2,0,40500,1,0,18900,94500,75600
01SCS19E190084,ESH.AR-SC0002,00ARSC0006,M,1,44500,135000,2,0,40500,1,0,18900,94500,75600
01SCS19E190084,ESH.AR-SD0004,00ARSD0047,L,1,44500,135000,2,0,40500,1,0,18900,94500,75600
01SCS19E190085,BSC.AR-SD0027,00ARSD0156,S,1,125000,315000,2,0,94500,1,0,44100,220500,176400
01SCS19E190086,ESH.AR-SD0044,00ARSD0399,M,1,125000,315000,2,0,94500,1,0,44100,220500,176400
01SCS19E190087,BSC.AR-SB0004,00ARSB0049,L,1,44000,135000,2,0,40500,1,0,18900,94500,75600
01SCS19E190087,ESH.AR-RJ0003,00ARRJ0021,L,1,94500,135000,2,0,40500,1,0,18900,94500,75600
01SCS19E190087,ESH.AR-SC0021,00ARSC0159,L,1,44000,135000,2,0,40500,1,0,18900,94500,75600
01SCS19E190088,BSC.AR-RK0008,00ARRK0080,XL,1,108500,155000,2,0,46500,1,0,21700,108500,86800
01SCS19E190089,BSC.AR-SC0048,00ARSC0305,M,1,44500,159000,2,0,47700,1,0,22260,111300,89040
01SCS19E190089,ESH.AR-SD0004,00ARSD0046,M,1,44500,135000,2,0,40500,1,0,18900,94500,75600
01SCS19E190090,BSC.AR-SD0027,00ARSD0159,XL,1,125000,315000,2,0,94500,1,0,44100,220500,176400
01SCS19E190090,ESH.AR-RH0008,00ARRH0060,NON,1,45000,150000,2,0,45000,1,0,21000,105000,84000
01SCS19E190091,BSC.AR-SB0015,00ARSB0129,L,1,125000,315000,2,0,94500,1,0,44100,220500,176400
01SCS19E190092,AR.MKV-RJ004,20ARRJ0156,M,1,91000,140000,2,0,28000,1,0,28000,112000,84000
01SCS19E190093,ESH.AR-RH0019,00ARRH0105,L,1,42000,135000,2,0,40500,1,0,18900,94500,75600
01SCS19E190093,ESH.AR-SD0001,00ARSD0030,M,1,44500,135000,2,0,40500,1,0,18900,94500,75600
01SCS19E190094,AR.CPT-SC008,20ARSC0269,M,1,94250,145000,2,0,29000,1,0,29000,116000,87000
01SCS19E190095,AR.MPR-SE008,20ARSE0165,S,1,97500,150000,2,0,45000,1,0,26250,105000,78750
01SCS19E190096,AR.PUB-SC015,20ARSC0362,L,1,97500,150000,2,0,30000,1,0,30000,120000,90000
01SCS19E190096,ESH.AR-RK0005,00ARRK0023,L,1,94500,135000,2,0,40500,1,0,18900,94500,75600
01SCS19E190096,ESH.AR-SD0005,00ARSD0050,M,1,44000,135000,2,0,40500,1,0,18900,94500,75600
01SCS19E190096,ESH.AR-SD0009,00ARSD0066,M,1,44500,135000,2,0,40500,1,0,18900,94500,75600
01SCS19E190097,AR.SMD-SE004,20ARSE0444,38,1,100750,155000,2,0,31000,1,0,31000,124000,93000
01SCS19E190097,ESH.AR-SB0003,00ARSB0008,M,1,44000,135000,2,0,40500,1,0,18900,94500,75600
01SCS19E190097,ESH.AR-SC0014,00ARSC0109,M,1,44500,135000,2,0,40500,1,0,18900,94500,75600
01SCS19E190098,ESH.AR-SD0035,00ARSD0333,NON,1,50000,150000,2,0,45000,1,0,21000,105000,84000
01SCS19E190099,BSC.AR-SC0029,00ARSC0200,M,1,125000,315000,2,0,94500,1,0,44100,220500,176400
01SCS19E190100,ESH.AR-QE0004,00ARQE0023,ALL,1,39800,140000,2,0,90000,1,0,10000,50000,40000
01SCS19E190100,ESH.AR-RA0014,00ARRA0071,ALL,1,55000,140000,2,0,90000,1,0,10000,50000,40000
01SCS19E190100,ESH.AR-SA0002,00ARSA0041,NON,1,55000,150000,2,0,45000,1,0,21000,105000,84000
01SCS19E190101,AR.GTW-SB001,20ARSB0150,L,1,94250,145000,2,0,43500,1,0,25375,101500,76125
01SCS19E190101,BE.RAK-SC035,00BESC0149,L,1,91000,140000,2,0,28000,1,0,28000,112000,84000
01SCS19E190102,BSC.AR-RL0018,00ARRL0110,M,1,125000,315000,2,0,94500,1,0,44100,220500,176400
01SCS19E190102,BSC.AR-SE0001,00ARSE0058,M,1,44500,159000,2,0,47700,1,0,22260,111300,89040
01SCS19E190103,AR.PUB-RH024,20ARRH0404,ALL,1,61750,95000,2,0,19000,1,0,19000,76000,57000
01SCS19E190104,BSC.AR-RI0032,00ARRI0151,L,1,120000,315000,2,0,94500,1,0,44100,220500,176400
01SCS19E190105,ESH.AR-QD0001,00ARQD0079,L,1,115000,345000,2,0,170000,1,0,35000,175000,140000
01SCS19E190106,ESH.AR-SA0008,00ARSA0085,L,1,113450,350000,2,0,105000,1,0,49000,245000,196000
01SCS19E190106,ESH.AR-SB0028,00ARSB0173,L,1,44000,135000,2,0,40500,1,0,18900,94500,75600
01SCS19E190106,ESH.AR-SD0001,00ARSD0031,L,1,44500,135000,2,0,40500,1,0,18900,94500,75600
01SCS19E190107,AR.SMD-SD012,20ARSD0565,S,1,87750,135000,2,0,27000,1,0,27000,108000,81000
01SCS19E190107,BSC.AR-SC0048,00ARSC0304,S,1,44500,159000,2,0,47700,1,0,22260,111300,89040
01SCS19E190107,ESH.AR-RH0012,00ARRH0084,NON,1,98000,140000,2,0,42000,1,0,19600,98000,78400
01SCS19E190107,ESH.AR-SD0008,00ARSD0061,S,1,44500,135000,2,0,40500,1,0,18900,94500,75600
01SCS19E190108,AR.MPR-SE012,20ARSE0181,S,1,97500,150000,2,0,45000,1,0,26250,105000,78750
01SCS19E190109,AR.TUC-SC004,20ARSC0057,30,1,204750,315000,2,0,63000,1,0,63000,252000,189000
01SCS19E190110,AR.REC-SD018,20ARSD0056,ALL,1,107250,165000,2,0,49500,1,0,28875,115500,86625
01SCS19E190111,AR.PUB-RI018,20ARRI0266,M,1,97500,150000,2,0,30000,1,0,30000,120000,90000
01SCS19E190112,AR.TUC-SB001,20ARSB0025,L,1,204750,315000,2,0,63000,1,0,63000,252000,189000
01SCS19E190113,AR.TUC-SE012,20ARSE0408,M,1,94250,145000,2,0,29000,1,0,29000,116000,87000
01SCS19E190114,BSC.AR-RK0023,00ARRK0214,XL,1,120000,315000,2,0,94500,1,0,44100,220500,176400
01SCS19E190115,AR.SMD-RH003,20ARRH0399,M,1,211250,325000,2,0,97500,1,0,56875,227500,170625
01SCS19E190116,BSC.AR-SC0010,00ARSC0056,S,1,125000,315000,2,0,94500,1,0,44100,220500,176400
01SCS19E190117,BSC.AR-RH0018,00ARRH0079,M,1,120000,315000,2,0,94500,1,0,44100,220500,176400
01SCS19E190117,ESH.AR-SD0011,00ARSD0073,S,1,125000,315000,2,0,94500,1,0,44100,220500,176400
01SCS19E190118,AR.TUC-SA002,20ARSA0007,L,1,204750,315000,2,0,63000,1,0,63000,252000,189000
01SCS19E190119,AR.PUB-RL006,20ARRL0130,XL,1,97500,150000,2,0,30000,1,0,30000,120000,90000
01SCS19E190119,BSC.AR-RJ0014,00ARRJ0092,M,1,43000,135000,2,0,40500,1,0,18900,94500,75600
01SCS19E190119,BSC.AR-SD0053,00ARSD0283,S,1,44000,159000,2,0,47700,1,0,22260,111300,89040
01SCS19E190120,AR.PCT-SE003,20ARSE0341,L,1,87750,135000,2,0,27000,1,0,27000,108000,81000
01SCS19E190121,AR.BPH-RB001,20ARRB0425,S,1,182000,280000,2,0,140000,1,0,35000,140000,105000
01SCS19E190121,AR.ESB-SC015,20ARSC0443,M,1,87750,135000,2,0,27000,1,0,27000,108000,81000
01SCS19E190121,AR.TUC-RK036,20ARRK0160,L,1,94250,145000,2,0,29000,1,0,29000,116000,87000
01SCS19E190121,ESH.AR-SA0013,00ARSA0097,S,1,44000,135000,2,0,40500,1,0,18900,94500,75600
01SCS19E190122,AR.TUC-SB013,20ARSB0202,XL,1,94250,145000,2,0,29000,1,0,29000,116000,87000
01SCS19E190123,ESH.AR-SB0032,00ARSB0210,L,1,125000,315000,2,0,94500,1,0,44100,220500,176400
01SCS19E190124,AR.MPR-SB010,20ARSB0273,XL,1,97500,150000,2,0,45000,1,0,26250,105000,78750
01SCS19E190125,ESH.AR-SB0033,00ARSB0213,M,1,44500,135000,2,0,40500,1,0,18900,94500,75600
01SCS19E190126,BSC.AR-SB0006,00ARSB0070,S,1,44000,135000,2,0,40500,1,0,18900,94500,75600
01SCS19E190126,BSC.AR-SD0050,00ARSD0250,S,1,44000,159000,2,0,47700,1,0,22260,111300,89040
01SCS19E190127,BSC.AR-QG0018,00ARQG0150,S,1,135000,395000,2,0,220000,1,0,35000,175000,140000
01SCS19E190128,AR.PUB-SE003,20ARSE0011,L,1,97500,150000,2,0,30000,1,0,30000,120000,90000
01SCS19E190128,BSC.AR-SA0018,00ARSA0061,L,1,44000,135000,2,0,40500,1,0,18900,94500,75600
01SCS19E190128,BSC.AR-SD0055,00ARSD0288,NON,1,50000,150000,2,0,45000,1,0,21000,105000,84000
01SCS19E190129,AR.CPT-RE013,20ARRE0718,M,1,94250,145000,2,0,29000,1,0,29000,116000,87000
01SCS19E190129,AR.PUB-SA007,20ARSA0322,M,1,97500,150000,2,0,30000,1,0,30000,120000,90000
01SCS19E190130,AR.BPH-RB010,20ARRB0462,M,1,103350,159000,2,0,47700,1,0,27825,111300,83475
01SCS19E190130,AR.TUC-SD012,20ARSD0467,L,1,94250,145000,2,0,29000,1,0,29000,116000,87000
01SCS19E190131,AR.PUB-SE015,20ARSE0057,S,1,159250,245000,2,0,49000,1,0,49000,196000,147000
01SCS19E190132,AR.FHL-SC008,20ARSC0351,ALL,1,110500,170000,2,0,34000,1,0,34000,136000,102000
01SCS19E190133,AR.ESB-RL003,20ARRL0458,L,1,100750,155000,2,0,31000,1,0,31000,124000,93000
01SCS19E190134,BSC.AR-SA0004,00ARSA0019,M,1,125000,315000,2,0,94500,1,0,44100,220500,176400
01SCS19E190135,AR.MKV-SE004,20ARSE0484,28,1,214500,330000,2,0,66000,1,0,66000,264000,198000
01SCS19E190136,AR.PUB-SE006,20ARSE0023,L,1,97500,150000,2,0,30000,1,0,30000,120000,90000
01SCS19E190137,AR.MPR-SE020,20ARSE0204,ALL,1,97500,150000,2,0,45000,1,0,26250,105000,78750
01SCS19E190137,BSC.AR-SC0017,00ARSC0118,L,1,44500,135000,2,0,40500,1,0,18900,94500,75600
01SCS19E190138,AR.ESB-RE015,20ARRE0380,L,1,87750,135000,2,0,67500,1,0,16875,67500,50625
01SCS19E190138,AR.TUC-RC005,20ARRC0074,L,1,87750,135000,2,0,67500,1,0,16875,67500,50625
01SCS19E190139,AR.ESB-SE007,20ARSE0265,XL,1,94250,145000,2,0,29000,1,0,29000,116000,87000
01SCS19E190139,AR.MKV-SA010,20ARSA0316,36,1,214500,330000,2,0,66000,1,0,66000,264000,198000
01SCS19E190139,AR.TUC-SD012,20ARSD0468,XL,1,94250,145000,2,0,29000,1,0,29000,116000,87000
01SCS19E190140,AR.MDS-RL002,20ARRL0359,M,1,117000,180000,2,0,36000,1,0,36000,144000,108000
01SCS19E190140,BSC.AR-RJ0016,00ARRJ0100,M,1,43000,135000,2,0,40500,1,0,18900,94500,75600
01SCS19E190141,AR.TUC-SC006,20ARSC0066,32,1,204750,315000,2,0,63000,1,0,63000,252000,189000
01SCS19E190141,BSC.AR-RI0009,00ARRI0032,L,1,94500,135000,2,0,40500,1,0,18900,94500,75600
01SCS19E190142,AR.CPT-QL007,20ARQL0152,M,1,97500,150000,2,0,30000,1,0,30000,120000,90000
01SCS19E190142,AR.TUC-SB012,20ARSB0196,M,1,204750,315000,2,0,63000,1,0,63000,252000,189000
01SCS19E190142,AR.TUC-SE015,20ARSE0419,S,1,94250,145000,2,0,29000,1,0,29000,116000,87000
01SCS19E190142,AR.TUC-SE016,20ARSE0423,S,1,146250,225000,2,0,45000,1,0,45000,180000,135000
01SCS19E190143,BSC.AR-SC0010,00ARSC0056,S,1,125000,315000,2,0,94500,1,0,44100,220500,176400
01SCS19E190144,AR.MPR-SE035,20ARSE0311,ALL,1,136500,210000,2,0,42000,1,0,42000,168000,126000
01SCS19E190144,ESH.AR-QK0001,00ARQK0003,L,1,90000,310000,2,0,150000,1,0,32000,160000,128000
01SCS19E190145,BSC.AR-SD0061,00ARSD0336,NON,1,45000,150000,2,0,45000,1,0,21000,105000,84000
01SCS19E190146,AR.ESB-SE004,20ARSE0251,M,1,94250,145000,2,0,29000,1,0,29000,116000,87000
01SCS19E190146,AR.TUC-SE012,20ARSE0408,M,1,94250,145000,2,0,29000,1,0,29000,116000,87000
01SCS19E190147,AR.TUC-SD007,20ARSD0165,M,1,185250,285000,2,0,57000,1,0,57000,228000,171000
01SCS19E190147,DKS.AR-SE0005,00ARSE0144,34,1,417272,696000,2,0,69600,1,0,93960,626400,532440
01SCS19E190148,AR.VCS-SC003,20ARSC0381,M,1,97500,150000,2,0,45000,1,0,26250,105000,78750
01SCS19E190148,ESH.AR-RJ0006,00ARRJ0033,L,1,44500,135000,2,0,40500,1,0,18900,94500,75600
01SCS19E190149,ESH.AR-RJ0007,00ARRJ0036,M,1,44500,135000,2,0,40500,1,0,18900,94500,75600
01SCS19E190150,AR.MPR-SE019,20ARSE0203,ALL,1,97500,150000,2,0,45000,1,0,26250,105000,78750
01SCS19E190150,AR.VCS-SC010,20ARSC0411,XL,1,214500,330000,2,0,99000,1,0,57750,231000,173250
01SCS19E190151,AR.PUB-SC017,20ARSC0368,S,1,204750,315000,2,0,63000,1,0,63000,252000,189000
01SCS19E190152,AR.GTW-SB001,20ARSB0151,XL,1,94250,145000,2,0,43500,1,0,25375,101500,76125
01SCS19E190153,AR.MKV-RL005,20ARRL0251,30,1,227500,350000,2,0,70000,1,0,70000,280000,210000
01SCS19E190153,AR.MKV-SE004,20ARSE0486,32,1,214500,330000,2,0,66000,1,0,66000,264000,198000
01SCS19E190153,ESH.AR-QE0005,00ARQE0024,ALL,1,39800,140000,2,0,90000,1,0,10000,50000,40000
01SCS19E190153,ESH.AR-RJ0008,00ARRJ0041,L,1,44500,135000,2,0,40500,1,0,18900,94500,75600
01SCS19E190154,BSC.AR-RJ0018,00ARRJ0108,M,1,94500,135000,2,0,40500,1,0,18900,94500,75600
01SCS19E190155,AR.CPT-RE013,20ARRE0719,L,1,94250,145000,2,0,29000,1,0,29000,116000,87000
01SCS19E190155,AR.GTW-SA002,20ARSA0301,L,1,107250,165000,2,0,49500,1,0,28875,115500,86625
01SCS19E190156,BSC.AR-RJ0018,00ARRJ0107,S,1,94500,135000,2,0,40500,1,0,18900,94500,75600
01SCS19E190157,BSC.AR-SB0007,00ARSB0076,L,1,44500,135000,2,0,40500,1,0,18900,94500,75600
01SCS19E190158,ESH.AR-RJ0013,00ARRJ0176,M,1,94500,135000,2,0,40500,1,0,18900,94500,75600
01SCS19E190159,BSC.AR-SC0009,00ARSC0052,S,1,125000,315000,2,0,94500,1,0,44100,220500,176400
01SCS19E190160,ESH.AR-RD0028,00ARRD0245,L,1,43000,135000,2,0,67500,1,0,13500,67500,54000
01SCS19E190160,ESH.AR-RE0004,00ARRE0015,L,1,42000,135000,2,0,67500,1,0,13500,67500,54000
01SCS19E190161,BSC.AR-RL0020,00ARRL0117,S,1,125000,315000,2,0,94500,1,0,44100,220500,176400
01SCS19E190162,ESH.AR-RK0004,00ARRK0015,L,1,120000,315000,2,0,94500,1,0,44100,220500,176400
01SCS19E190163,AR.MPR-SE034,20ARSE0307,S,1,237250,365000,2,0,73000,1,0,73000,292000,219000
01SCS19E190164,BSC.AR-RJ0002,00ARRJ0005,ALL,1,98000,140000,2,0,42000,1,0,19600,98000,78400
01SCS19E190165,ESH.AR-SC0008,00ARSC0068,S,1,44500,135000,2,0,40500,1,0,18900,94500,75600
01SCS19E190166,AR.CPT-RI009,20ARRI0073,M,1,94251,169000,2,0,33800,1,0,33800,135200,101400
01SCS19E190166,AR.PUB-RI002,20ARRI0101,M,1,97500,150000,2,0,30000,1,0,30000,120000,90000
01SCS19E190167,AR.ESB-RH004,20ARRH0193,ALL,1,91000,140000,2,0,70000,1,0,17500,70000,52500
01SCS19E190167,ESH.AR-SD0004,00ARSD0046,M,1,44500,135000,2,0,40500,1,0,18900,94500,75600
01SCS19E190168,BE.RAK-RK016,00BERK0046,ALL,1,87750,135000,2,0,27000,1,0,27000,108000,81000
01SCS19E190169,AR.TUC-SD001,20ARSD0142,L,1,204750,315000,2,0,63000,1,0,63000,252000,189000
01SCS19E190170,AR.HLW-SA006,20ARSA0093,ALL,1,71500,110000,2,0,22000,1,0,22000,88000,66000
01SCS19E190171,AR.CLK-RH002,20ARRH0737,ALL,1,91000,140000,2,0,28000,1,0,28000,112000,84000
01SCS19E190171,AR.CLK-SA003,20ARSA0052,ALL,1,91000,140000,2,0,28000,1,0,28000,112000,84000
01SCS19E190171,AR.CLK-SA005,20ARSA0054,ALL,1,91000,140000,2,0,28000,1,0,28000,112000,84000
01SCS19E190172,AR.PUB-RL009,20ARRL0139,M,1,159250,245000,2,0,49000,1,0,49000,196000,147000
01SCS19E190173,BSC.AR-SC0012,00ARSC0074,L,1,44000,159000,2,0,47700,1,0,22260,111300,89040
01SCS19E190174,ESH.AR-SC0002,00ARSC0006,M,1,44500,135000,2,0,40500,1,0,18900,94500,75600
01SCS19E190175,ESH.AR-RI0007,00ARRI0096,L,1,94500,135000,2,0,40500,1,0,18900,94500,75600
01SCS19E190176,BSC.AR-SD0041,00ARSD0224,M,1,44500,159000,2,0,47700,1,0,22260,111300,89040
01SCS19E190177,AR.TUC-RI012,20ARRI0371,M,1,87750,135000,2,0,27000,1,0,27000,108000,81000
01SCS19E190177,BSC.AR-QG0018,00ARQG0150,S,1,135000,395000,2,0,220000,1,0,35000,175000,140000
01SCS19E190177,BSC.AR-SD0051,00ARSD0254,S,1,44000,159000,2,0,47700,1,0,22260,111300,89040
01SCS19E190177,ESH.AR-RD0003,00ARRD0027,32,1,110000,350000,2,0,175000,1,0,35000,175000,140000
01SCS19E190177,ESH.AR-RF0014,00ARRF0081,S,1,105000,315000,2,0,190000,1,0,25000,125000,100000
01SCS19E190178,ESH.AR-SC0013,00ARSC0104,S,1,44500,135000,2,0,40500,1,0,18900,94500,75600
01SCS19E190179,DKS.AR-SE0004,00ARSE0141,34,1,417272,696000,2,0,69600,1,0,93960,626400,532440
01SCS19E190180,AR.CPT-SC008,20ARSC0270,L,1,94250,145000,2,0,29000,1,0,29000,116000,87000
01SCS19E190180,AR.MDG-RJ005,20ARRJ0559,ALL,1,126750,195000,2,0,58500,1,0,34125,136500,102375
01SCS19E190180,BSC.AR-SD0017,00ARSD0122,NON,1,45000,150000,2,0,45000,1,0,21000,105000,84000
01SCS19E190180,ESH.AR-RG0005,00ARRG0101,M,1,94500,135000,2,0,40500,1,0,18900,94500,75600
01SCS19E190180,ESH.AR-RH0018,00ARRH0099,S,1,94500,135000,2,0,40500,1,0,18900,94500,75600
01SCS19E190180,ESH.AR-SC0008,00ARSC0068,S,1,44500,135000,2,0,40500,1,0,18900,94500,75600
01SCS19E190181,BSC.AR-RH0006,00ARRH0027,L,1,108500,155000,2,0,46500,1,0,21700,108500,86800
01SCS19E190181,DKS.AR-SE0010,00ARSE0165,28,1,417272,696000,2,0,69600,1,0,93960,626400,532440
01SCS19E190182,AR.ESB-SC018,20ARSC0465,M,1,91000,140000,2,0,28000,1,0,28000,112000,84000
01SCS19E190182,AR.TUC-SE011,20ARSE0404,M,1,94250,145000,2,0,29000,1,0,29000,116000,87000
01SCS19E190183,AR.CHO-RL008,20ARRL0403,ALL,1,585000,900000,2,0,180000,1,0,180000,720000,540000
01SCS19E190183,AR.ESB-SA001,20ARSA0204,M,1,87750,135000,2,0,27000,1,0,27000,108000,81000
01SCS19E190184,ESH.AR-RD0006,00ARRD0053,NON,1,37500,115000,2,0,34500,1,0,16100,80500,64400
01SCS19E190185,AR.TUC-SE009,20ARSE0397,M,1,204750,315000,2,0,63000,1,0,63000,252000,189000
01SCS19E190186,AR.CPT-RI007,20ARRI0067,XL,1,94250,145000,2,0,29000,1,0,29000,116000,87000
01SCS19E190186,AR.STY-SE002,20ARSE0120,ALL,1,55250,85000,2,0,17000,1,0,17000,68000,51000
01SCS19E190186,AR.STY-SE003,20ARSE0121,ALL,1,55250,85000,2,0,17000,1,0,17000,68000,51000
01SCS19E190187,AR.REC-SD007,20ARSD0026,M,1,107250,165000,2,0,49500,1,0,28875,115500,86625
01SCS19E190187,BSC.AR-SC0048,00ARSC0305,M,1,44500,159000,2,0,47700,1,0,22260,111300,89040
01SCS19E190187,BSC.AR-SD0041,00ARSD0224,M,1,44500,159000,2,0,47700,1,0,22260,111300,89040
01SCS19E190187,BSC.AR-SD0050,00ARSD0251,M,1,44000,159000,2,0,47700,1,0,22260,111300,89040
01SCS19E190188,ESH.AR-QI0012,00ARQI0072,ALL,1,37800,140000,2,0,90000,1,0,10000,50000,40000
01SCS19E190189,AR.VLD-SB001,20ARSB0043,XL,1,91000,140000,2,0,42000,1,0,24500,98000,73500
01SCS19E190190,BSC.AR-RH0024,00ARRH0157,L,1,245000,350000,2,0,105000,1,0,49000,245000,196000
01SCS19E190191,AR.PUB-RL028,20ARRL0436,ALL,1,97500,150000,2,0,30000,1,0,30000,120000,90000
01SCS19E190191,AR.SMD-RE003,20ARRE0131,ALL,1,97500,150000,2,0,45000,1,0,26250,105000,78750
01SCS19E190191,AR.STY-SE003,20ARSE0121,ALL,1,55250,85000,2,0,17000,1,0,17000,68000,51000
01SCS19E190191,AR.STY-SE006,20ARSE0124,ALL,1,55250,85000,2,0,17000,1,0,17000,68000,51000
01SCS19E190192,AR.STY-SE006,20ARSE0124,ALL,1,55250,85000,2,0,17000,1,0,17000,68000,51000
01SCS19E190192,AR.TUC-SB016,20ARSB0469,S,1,87750,135000,2,0,27000,1,0,27000,108000,81000
01SCS19E190192,AR.TUC-SD007,20ARSD0164,S,1,185250,285000,2,0,57000,1,0,57000,228000,171000
01SCS19E190193,ESH.AR-SD0014,00ARSD0087,34,1,145000,375000,2,0,112500,1,0,52500,262500,210000
01SCS19E190194,AR.MKV-SE001,20ARSE0469,28,1,214500,330000,2,0,66000,1,0,66000,264000,198000
01SCS19E190194,BSC.AR-RJ0029,00ARRJ0169,L,1,120000,315000,2,0,94500,1,0,44100,220500,176400
01SCS19E190195,BSC.AR-RH0018,00ARRH0079,M,1,120000,315000,2,0,94500,1,0,44100,220500,176400
01SCS19E190196,AR.MKV-RJ025,20ARRJ0219,ALL,1,97500,150000,2,0,30000,1,0,30000,120000,90000
01SCS19E190197,ESH.AR-PK0043,00ARPK0198,S,1,110000,325000,2,0,165000,1,0,32000,160000,128000
01SCS19E190197,ESH.AR-QH0004,00ARQH0004,ALL,1,37800,140000,2,0,90000,1,0,10000,50000,40000
01SCS19E190198,AR.MKV-RJ006,20ARRJ0166,M,1,91000,140000,2,0,28000,1,0,28000,112000,84000
01SCS19E190199,AR.MPR-SE020,20ARSE0204,ALL,1,97500,150000,2,0,45000,1,0,26250,105000,78750
01SCS19E190200,ESH.AR-RE0025,00ARRE0260,30,1,120000,350000,2,0,175000,1,0,35000,175000,140000
01SCS19E190201,AR.CPT-SC003,20ARSC0249,30,1,227500,350000,2,0,70000,1,0,70000,280000,210000
01SCS19E190202,AR.ESB-SE010,20ARSE0275,M,1,227500,350000,2,0,70000,1,0,70000,280000,210000
01SCS19E190203,AR.SLS-SE009,20ARSE0136,L,1,255000,300000,0,0,0,0,0,45000,300000,255000
01SCS19E190204,AR.TUC-SB002,20ARSB0029,L,1,204750,315000,2,0,63000,1,0,63000,252000,189000
01SCS19E190205,BSC.AR-RL0019,00ARRL0114,M,1,125000,315000,2,0,94500,1,0,44100,220500,176400
01SCS19E190205,ESH.AR-RJ0026,00ARRJ0228,M,1,220500,315000,2,0,94500,1,0,44100,220500,176400
01SCS19E190206,BSC.AR-RK0023,00ARRK0213,L,1,120000,315000,2,0,94500,1,0,44100,220500,176400
01SCS19E190207,ESH.AR-SC0005,00ARSC0027,M,1,125000,315000,2,0,94500,1,0,44100,220500,176400
01SCS19E190208,AR.CPT-SC012,20ARSC0481,L,1,204750,315000,2,0,63000,1,0,63000,252000,189000
01SCS19E190209,AR.TUC-SE006,20ARSE0385,L,1,204750,315000,2,0,63000,1,0,63000,252000,189000
01SCS19E190210,ESH.AR-SB0012,00ARSB0056,32,1,90,285000,2,0,85500,1,0,39900,199500,159600
01SCS19E190211,AR.SMD-RL001,20ARRL0265,ALL,1,22750,35000,2,0,7000,1,0,7000,28000,21000
01SCS19E190211,AR.STY-RK005,20ARRK0527,ALL,1,61750,95000,2,0,19000,1,0,19000,76000,57000
01SCS19E190212,AR.CPT-SC002,20ARSC0245,30,1,227500,350000,2,0,70000,1,0,70000,280000,210000
01SCS19E190212,ESH.AR-SC0029,00ARSC0269,NON,1,90000,250000,2,0,75000,1,0,35000,175000,140000
01SCS19E190213,BSC.AR-RJ0031,00ARRJ0202,M,1,220500,315000,2,0,94500,1,0,44100,220500,176400
01SCS19E190214,AR.MPR-SE011,20ARSE0177,S,1,97500,150000,2,0,45000,1,0,26250,105000,78750
01SCS19E190214,AR.SMD-RH004,20ARRH0416,M,1,87750,135000,2,0,40500,1,0,23625,94500,70875
01SCS19E190214,AR.SMD-RJ001,20ARRJ0457,L,1,87750,135000,2,0,27000,1,0,27000,108000,81000
01SCS19E190214,BSC.AR-SC0012,00ARSC0074,L,1,44000,159000,2,0,47700,1,0,22260,111300,89040
01SCS19E190214,ESH.AR-RJ0004,00ARRJ0024,M,1,43000,135000,2,0,40500,1,0,18900,94500,75600
01SCS19E190215,AR.TUC-SB015,20ARSB0210,XL,1,87750,135000,2,0,27000,1,0,27000,108000,81000
01SCS19E190216,BSC.AR-SD0005,00ARSD0017,S,1,44500,159000,2,0,47700,1,0,22260,111300,89040
01SCS19E190216,BSC.AR-SD0045,00ARSD0239,S,1,44500,159000,2,0,47700,1,0,22260,111300,89040
01SCS19E190217,BSC.AR-SA0009,00ARSA0035,NON,1,47500,140000,2,0,42000,1,0,19600,98000,78400
01SCS19E190217,ESH.AR-SD0045,00ARSD0406,L,1,125000,315000,2,0,94500,1,0,44100,220500,176400
01SCS19E190218,AR.MPR-SE005,20ARSE0153,S,1,97500,150000,2,0,45000,1,0,26250,105000,78750
01SCS19E190218,AR.PUB-RE051,20ARRE0594,S,1,204750,315000,2,0,63000,1,0,63000,252000,189000
01SCS19E190219,BSC.AR-SD0052,00ARSD0282,XL,1,44500,159000,2,0,47700,1,0,22260,111300,89040
01SCS19E190219,BSC.AR-SE0001,00ARSE0058,M,1,44500,159000,2,0,47700,1,0,22260,111300,89040
01SCS19E190220,AR.ESB-SB001,20ARSB0022,L,1,204750,315000,2,0,63000,1,0,63000,252000,189000
01SCS19E190220,AR.STY-SB007,20ARSB0494,ALL,1,55250,85000,2,0,17000,1,0,17000,68000,51000
01SCS19E190220,AR.TUC-SD019,20ARSD0494,M,1,94250,145000,2,0,29000,1,0,29000,116000,87000
01SCS19E190221,AR.MPR-SE003,20ARSE0147,L,1,97500,150000,2,0,45000,1,0,26250,105000,78750
01SCS19E190222,ESH.AR-RH0006,00ARRH0058,NON,1,45000,150000,2,0,45000,1,0,21000,105000,84000
01SCS19E190223,AR.MKV-SE007,20ARSE0499,28,1,165750,255000,2,0,51000,1,0,51000,204000,153000
01SCS19E190224,AR.MPR-SE014,20ARSE0189,S,1,237250,365000,2,0,73000,1,0,73000,292000,219000
01SCS19E190225,AR.CPT-RI007,20ARRI0065,M,1,94250,145000,2,0,29000,1,0,29000,116000,87000
01SCS19E190226,AR.SMD-SD010,20ARSD0311,30,1,211250,325000,2,0,65000,1,0,65000,260000,195000
01SCS19E190227,AR.MPR-SE012,20ARSE0182,M,1,97500,150000,2,0,45000,1,0,26250,105000,78750
01SCS19E190227,BSC.AR-SB0008,00ARSB0079,M,1,44500,135000,2,0,40500,1,0,18900,94500,75600
01SCS19E190228,AR.PUB-SB033,20ARSB0464,ALL,1,97500,150000,2,0,30000,1,0,30000,120000,90000
01SCS19E190228,ESH.AR-QD0016,00ARQD0150,M,1,110000,325000,2,0,165000,1,0,32000,160000,128000
01SCS19E190229,ESH.AR-SD0011,00ARSD0075,L,1,125000,315000,2,0,94500,1,0,44100,220500,176400
01SCS19E190230,ESH.AR-RK0005,00ARRK0023,L,1,94500,135000,2,0,40500,1,0,18900,94500,75600
01SCS19E190231,AR.MPR-SE023,20ARSE0212,L,1,230750,355000,2,0,71000,1,0,71000,284000,213000
01SCS19E190232,ESH.AR-RJ0023,00ARRJ0218,NON,1,18000,75000,2,0,22500,1,0,10500,52500,42000
01SCS19E190232,ESH.AR-SB0007,00ARSB0027,S,1,44000,135000,2,0,40500,1,0,18900,94500,75600
01SCS19E190233,AR.CPT-SC012,20ARSC0480,M,1,204750,315000,2,0,63000,1,0,63000,252000,189000
01SCS19E190234,BSC.AR-RL0018,00ARRL0111,L,1,125000,315000,2,0,94500,1,0,44100,220500,176400
01SCS19E190235,AR.TUC-SD012,20ARSD0467,L,1,94250,145000,2,0,29000,1,0,29000,116000,87000
01SCS19E190236,AR.CPT-RI007,20ARRI0065,M,1,94250,145000,2,0,29000,1,0,29000,116000,87000
01SCS19E190237,BSC.AR-SA0019,00ARSA0063,S,1,44000,135000,2,0,40500,1,0,18900,94500,75600
01SCS19E190238,AR.CPT-SC012,20ARSC0480,M,1,204750,315000,2,0,63000,1,0,63000,252000,189000
01SCS19E190239,BSC.AR-SD0018,00ARSD0123,NON,1,45000,150000,2,0,45000,1,0,21000,105000,84000
01SCS19E190239,BSC.AR-SD0043,00ARSD0234,XL,1,44500,159000,2,0,47700,1,0,22260,111300,89040
01SCS19E190240,BSC.AR-SA0015,00ARSA0045,L,1,44500,135000,2,0,40500,1,0,18900,94500,75600
01SCS19E190241,AR.PUB-RI006,20ARRI0116,XL,1,191750,295000,2,0,59000,1,0,59000,236000,177000
01SCS19E190242,AR.ESB-SA003,20ARSA0211,S,1,204750,315000,2,0,63000,1,0,63000,252000,189000
01SCS19E190243,AR.CPT-SD003,20ARSD0139,ALL,1,94250,145000,2,0,29000,1,0,29000,116000,87000
01SCS19E190244,AR.PUB-SD019,20ARSD0188,ALL,1,97500,150000,2,0,30000,1,0,30000,120000,90000
01SCS19E190245,AR.MKV-SC010,20ARSC0105,XL,1,97500,150000,2,0,30000,1,0,30000,120000,90000
01SCS19E190245,AR.PUB-SC011,20ARSC0299,XL,1,97500,150000,2,0,30000,1,0,30000,120000,90000
01SCS19E190246,BSC.AR-SA0021,00ARSA0105,S,1,44000,135000,2,0,40500,1,0,18900,94500,75600
01SCS19E190247,AR.PUB-SC015,20ARSC0362,L,1,97500,150000,2,0,30000,1,0,30000,120000,90000
01SCS19E190247,AR.TUC-SE015,20ARSE0420,M,1,94250,145000,2,0,29000,1,0,29000,116000,87000
01SCS19E190248,ESH.AR-SC0019,00ARSC0150,M,1,125000,315000,2,0,94500,1,0,44100,220500,176400
01SCS19E190249,AR.SLS-SC016,20ARSC0320,M,1,425000,500000,2,0,50000,1,0,67500,450000,382500
01SCS19E190250,AR.ESB-SB004,20ARSB0105,M,1,91000,140000,2,0,28000,1,0,28000,112000,84000
01SCS19E190251,AR.MPR-SE011,20ARSE0177,S,1,97500,150000,2,0,45000,1,0,26250,105000,78750
01SCS19E190251,BSC.AR-SD0046,00ARSD0243,S,1,44500,159000,2,0,47700,1,0,22260,111300,89040
01SCS19E190252,BSC.AR-RL0018,00ARRL0111,L,1,125000,315000,2,0,94500,1,0,44100,220500,176400
01SCS19E190253,BSC.AR-RF0005,00ARRF0069,S,1,85000,240000,2,0,115000,1,0,25000,125000,100000
01SCS19E190254,ESH.AR-SD0035,00ARSD0333,NON,1,50000,150000,2,0,45000,1,0,21000,105000,84000
01SCS19E190255,AR.ESB-RE040,20ARRE0802,ALL,1,123500,190000,2,0,57000,1,0,33250,133000,99750
01SCS19E190255,ESH.AR-RD0021,00ARRD0193,L,1,42000,135000,2,0,67500,1,0,13500,67500,54000
01SCS19E190255,ESH.AR-RE0008,00ARRE0031,L,1,42000,135000,2,0,67500,1,0,13500,67500,54000
01SCS19E190255,ESH.AR-RK0002,00ARRK0006,M,1,120000,315000,2,0,94500,1,0,44100,220500,176400
01SCS19E190256,AR.MPR-SE033,20ARSE0303,S,1,230750,355000,2,0,71000,1,0,71000,284000,213000
01SCS19E190257,ESH.AR-RK0014,00ARRK0189,L,1,245000,350000,2,0,105000,1,0,49000,245000,196000
01SCS19E190258,ESH.AR-PL0015,00ARPL0126,M,1,110000,325000,2,0,165000,1,0,32000,160000,128000
01SCS19E190259,AR.MPR-SE011,20ARSE0178,M,1,97500,150000,2,0,45000,1,0,26250,105000,78750
01SCS19E190260,ARN.AR-SD0001,00ARSD0220,M,1,44500,150000,0,0,0,0,0,45000,150000,105000
01SCS19E190260,BSC.AR-SC0025,00ARSC0182,M,1,125000,315000,2,0,94500,1,0,44100,220500,176400
01SCS19E190261,BSC.AR-RJ0007,00ARRJ0063,S,1,430000,135000,2,0,40500,1,0,18900,94500,75600
01SCS19E190261,BSC.AR-SD0044,00ARSD0235,S,1,44500,159000,2,0,47700,1,0,22260,111300,89040
01SCS19E190262,AR.PUB-SE031,20ARSE0323,M,1,204750,315000,2,0,63000,1,0,63000,252000,189000
01SCS19E190263,BSC.AR-SD0041,00ARSD0223,S,1,44500,159000,2,0,47700,1,0,22260,111300,89040
01SCS19E190264,BE.RAK-SB042,00BESB0124,M,1,94250,145000,2,0,29000,1,0,29000,116000,87000
01SCS19E190265,AR.SMD-SD016,20ARSD0578,ALL,1,97500,150000,2,0,30000,1,0,30000,120000,90000
01SCS19E190265,BSC.AR-SD0012,00ARSD0105,NON,1,18000,75000,2,0,22500,1,0,10500,52500,42000
01SCS19E190266,AR.MPR-SE024,20ARSE0214,S,1,230750,355000,2,0,71000,1,0,71000,284000,213000
01SCS19E190267,ESH.AR-SC0032,00ARSC0283,XL,1,44500,135000,2,0,40500,1,0,18900,94500,75600
01SCS19E190267,ESH.AR-SD0025,00ARSD0265,XL,1,44000,135000,2,0,40500,1,0,18900,94500,75600
01SCS19E190268,AR.PUB-SE005,20ARSE0019,L,1,97500,150000,2,0,30000,1,0,30000,120000,90000
01SCS19E190269,AR.STY-SE002,20ARSE0120,ALL,1,55250,85000,2,0,17000,1,0,17000,68000,51000
01SCS19E190270,ESH.AR-SC0023,00ARSC0166,M,1,125000,315000,2,0,94500,1,0,44100,220500,176400
01SCS19E190271,AR.TUC-RK015,20ARRK0111,ALL,1,87750,135000,2,0,27000,1,0,27000,108000,81000
01SCS19E190271,BSC.AR-SC0040,00ARSC0259,L,1,52000,155000,2,0,46500,1,0,21700,108500,86800
01SCS19E190272,AR.ASH-RJ004,20ARRJ0261,S,1,91000,140000,2,0,42000,1,0,24500,98000,73500
01SCS19E190272,BSC.AR-SD0012,00ARSD0105,NON,1,18000,75000,2,0,22500,1,0,10500,52500,42000
01SCS19E190273,ESH.AR-SD0015,00ARSD0089,S,1,106400,350000,2,0,105000,1,0,49000,245000,196000
01SCS19E190274,ESH.AR-QE0005,00ARQE0024,ALL,1,39800,140000,2,0,90000,1,0,10000,50000,40000
01SCS19E190274,ESH.AR-RH0008,00ARRH0060,NON,1,45000,150000,2,0,45000,1,0,21000,105000,84000
01SCS19E190275,AR.RDC-RH012,20ARRH0642,M,1,97500,150000,2,0,30000,1,0,30000,120000,90000
01SCS19E190276,AR.YD-RL008,20ARRL0024,ALL,1,87750,135000,2,0,67500,1,0,16875,67500,50625
01SCS19E190276,BSC.AR-SD0046,00ARSD0243,S,1,44500,159000,2,0,47700,1,0,22260,111300,89040
01SCS19E190277,AR.ESB-SE011,20ARSE0280,L,1,227500,350000,2,0,70000,1,0,70000,280000,210000
01SCS19E190278,BE.RAK-SA024,00BESA0097,M,1,104000,160000,2,0,32000,1,0,32000,128000,96000
01SCS19E190278,BSC.AR-RK0007,00ARRK0073,S,1,52000,155000,2,0,46500,1,0,21700,108500,86800
01SCS19E190279,ESH.AR-SD0026,00ARSD0266,S,1,44500,135000,2,0,40500,1,0,18900,94500,75600
01SCS19E190280,AR.BOY-RJ001,20ARRJ0482,L,1,97500,150000,2,0,45000,1,0,26250,105000,78750
01SCS19E190281,BSC.AR-SD0022,00ARSD0130,L,1,44000,159000,2,0,47700,1,0,22260,111300,89040
01SCS19E190282,BSC.AR-RJ0020,00ARRJ0116,M,1,44500,135000,2,0,40500,1,0,18900,94500,75600
01SCS19E190283,AR.CPT-SC010,20ARSC0472,M,1,204750,315000,2,0,63000,1,0,63000,252000,189000
01SCS19E190284,AR.CPT-SD006,20ARSD0435,L,1,200850,309000,2,0,61800,1,0,61800,247200,185400
01SCS19E190284,BSC.AR-SB0007,00ARSB0076,L,1,44500,135000,2,0,40500,1,0,18900,94500,75600
01SCS19E190285,BSC.AR-RL0025,00ARRL0167,M,1,94500,135000,2,0,40500,1,0,18900,94500,75600
01SCS19E190285,BSC.AR-SD0004,00ARSD0014,M,1,44000,159000,2,0,47700,1,0,22260,111300,89040
01SCS19E190285,BSC.AR-SD0027,00ARSD0156,S,1,125000,315000,2,0,94500,1,0,44100,220500,176400
01SCS19E190286,AR.TUC-SE009,20ARSE0397,M,1,204750,315000,2,0,63000,1,0,63000,252000,189000
01SCS19E190287,BSC.AR-SB0020,00ARSB0167,S,1,44000,135000,2,0,40500,1,0,18900,94500,75600
01SCS19E190287,ESH.AR-SD0021,00ARSD0165,M,1,125000,315000,2,0,94500,1,0,44100,220500,176400
01SCS19E190288,ESH.AR-SD0042,00ARSD0374,S,1,125000,315000,2,0,94500,1,0,44100,220500,176400
01SCS19E190289,AR.STY-RK003,20ARRK0525,ALL,1,61750,95000,2,0,19000,1,0,19000,76000,57000
01SCS19E190290,AR.CPT-RL009,20ARRL0102,NON,1,77350,119000,2,0,23800,1,0,23800,95200,71400
01SCS19E190290,AR.HMR-SB029,20ARSB0433,30,1,96850,149000,2,0,29800,1,0,29800,119200,89400
01SCS19E190290,AR.MKV-RG003,20ARRG0089,ALL,1,78000,120000,2,0,24000,1,0,24000,96000,72000
01SCS19E190290,AR.MKV-SE005,20ARSE0489,28,1,165750,255000,2,0,51000,1,0,51000,204000,153000
01SCS19E190291,AR.CPT-SD012,20ARSD0457,S,1,94250,145000,2,0,29000,1,0,29000,116000,87000
01SCS19E190291,AR.TUC-SE012,20ARSE0409,L,1,94250,145000,2,0,29000,1,0,29000,116000,87000
01SCS19E190292,AR.MPR-SE011,20ARSE0178,M,1,97500,150000,2,0,45000,1,0,26250,105000,78750
01SCS19E190293,ESH.AR-SC0010,00ARSC0080,S,1,44500,135000,2,0,40500,1,0,18900,94500,75600
01SCS19E190294,BSC.AR-SA0004,00ARSA0019,M,1,125000,315000,2,0,94500,1,0,44100,220500,176400
01SCS19E190295,AR.MPR-SE021,20ARSE0205,ALL,1,97500,150000,2,0,45000,1,0,26250,105000,78750
01SCS19E190296,AR.MKV-SE005,20ARSE0490,30,1,165750,255000,2,0,51000,1,0,51000,204000,153000
01SCS19E190297,AR.PUB-SE005,20ARSE0020,XL,1,97500,150000,2,0,30000,1,0,30000,120000,90000
01SCS19E190298,ESH.AR-RJ0007,00ARRJ0036,M,1,44500,135000,2,0,40500,1,0,18900,94500,75600
01SCS19E190298,ESH.AR-SB0033,00ARSB0213,M,1,44500,135000,2,0,40500,1,0,18900,94500,75600
01SCS19E190298,ESH.AR-SD0002,00ARSD0038,M,1,44500,135000,2,0,40500,1,0,18900,94500,75600
01SCS19E190299,AR.TUC-SA002,20ARSA0006,M,1,204750,315000,2,0,63000,1,0,63000,252000,189000
01SCS19E190300,AR.TUC-SA004,20ARSA0014,M,1,87750,135000,2,0,27000,1,0,27000,108000,81000
01SCS19E190301,AR.TUC-SE006,20ARSE0383,S,1,204750,315000,2,0,63000,1,0,63000,252000,189000
01SCS19E190302,DKS.AR-SE0007,00ARSE0154,34,1,417272,696000,2,0,69600,1,0,93960,626400,532440
01SCS19E190302,DKS.AR-SE0011,00ARSE0173,34,1,417272,696000,2,0,69600,1,0,93960,626400,532440
01SCS19E190303,AR.MPR-SE034,20ARSE0307,S,1,237250,365000,2,0,73000,1,0,73000,292000,219000
01SCS19E190304,AR.PUB-SE016,20ARSE0062,M,1,159250,245000,2,0,49000,1,0,49000,196000,147000
01SCS19E190305,BSC.AR-SB0004,00ARSB0048,M,1,44000,135000,2,0,40500,1,0,18900,94500,75600
01SCS19E190306,AR.MKV-SD002,20ARSD0224,L,1,97500,150000,2,0,30000,1,0,30000,120000,90000
01SCS19E190306,AR.PUB-RJ030,20ARRJ0385,M,1,97500,150000,2,0,30000,1,0,30000,120000,90000
01SCS19E190306,AR.PUB-SE022,20ARSE0084,M,1,159250,245000,2,0,49000,1,0,49000,196000,147000
01SCS19E190307,ESH.AR-RJ0006,00ARRJ0033,L,1,44500,135000,2,0,40500,1,0,18900,94500,75600
01SCS19E190308,AR.HLW-SC004,20ARSC0127,M,1,195000,300000,2,0,90000,1,0,52500,210000,157500
01SCS19E190309,BSC.AR-SC0013,00ARSC0094,L,1,44000,135000,2,0,40500,1,0,18900,94500,75600
01SCS19E190310,BSC.AR-SD0026,00ARSD0154,L,1,44500,159000,2,0,47700,1,0,22260,111300,89040
01SCS19E190310,ESH.AR-QI0012,00ARQI0072,ALL,1,37800,140000,2,0,90000,1,0,10000,50000,40000
01SCS19E190311,BSC.AR-RA0010,00ARRA0049,M,1,42000,155000,2,0,87500,1,0,13500,67500,54000
01SCS19E190311,BSC.AR-RG0007,00ARRG0097,M,1,52000,155000,2,0,87500,1,0,13500,67500,54000
01SCS19E190312,AR.HLW-SC011,20ARSC0145,M,1,100750,155000,2,0,46500,1,0,27125,108500,81375
01SCS19E190312,AR.MKV-RJ004,20ARRJ0156,M,1,91000,140000,2,0,28000,1,0,28000,112000,84000
01SCS19E190313,AR.MPR-SE006,20ARSE0159,L,1,97500,150000,2,0,45000,1,0,26250,105000,78750
01SCS19E190313,BSC.AR-RI0006,00ARRI0020,L,1,43000,135000,2,0,40500,1,0,18900,94500,75600
01SCS19E190314,AR.FHL-RJ002,20ARRJ0421,M,1,91000,140000,2,0,28000,1,0,28000,112000,84000
01SCS19E190314,AR.PUB-SE007,20ARSE0026,M,1,97500,150000,2,0,30000,1,0,30000,120000,90000
01SCS19E190314,AR.PUB-SE008,20ARSE0031,L,1,97500,150000,2,0,30000,1,0,30000,120000,90000
01SCS19E190315,AR.TUC-SB002,20ARSB0028,M,1,204750,315000,2,0,63000,1,0,63000,252000,189000
01SCS19E190316,ESH.AR-RI0009,00ARRI0104,L,1,94500,135000,2,0,40500,1,0,18900,94500,75600
01SCS19E190317,AR.PUB-SD025,20ARSD0197,S,1,97500,150000,2,0,30000,1,0,30000,120000,90000
01SCS19E190318,BSC.AR-SC0048,00ARSC0305,M,1,44500,159000,2,0,47700,1,0,22260,111300,89040
01SCS19E190319,ESH.AR-SB0033,00ARSB0213,M,1,44500,135000,2,0,40500,1,0,18900,94500,75600
01SCS19E190320,AR.YD-SB003,20ARSB0177,ALL,1,78000,120000,2,0,36000,1,0,21000,84000,63000
01SCS19E190321,AR.CPT-SC012,20ARSC0480,M,1,204750,315000,2,0,63000,1,0,63000,252000,189000
01SCS19E190321,AR.STY-SE005,20ARSE0123,ALL,1,55250,85000,2,0,17000,1,0,17000,68000,51000
01SCS19E200001,BSC.AR-RK0014,00ARRK0104,XL,1,43000,135000,0,0,0,0,0,27000,135000,108000
01SCS19E200002,AR.STY-SE003,20ARSE0121,ALL,1,55250,85000,2,0,17000,1,0,17000,68000,51000
01SCS19E200003,AR.MKV-RL001,20ARRL0237,L,1,204750,315000,0,0,0,0,0,110250,315000,204750
01SCS19E200003,AR.TUC-SD019,20ARSD0495,L,1,94250,145000,0,0,0,0,0,50750,145000,94250
01SCS19E200004,AR.TUC-SE006,20ARSE0384,M,1,204750,315000,2,0,63000,1,0,63000,252000,189000
01SCS19E200005,AR.SLS-SE017,20ARSE0524,L,1,382500,450000,0,0,0,0,0,67500,450000,382500
01SCS19E200006,AR.PUB-RK011,20ARSD0350,L,1,113750,175000,2,0,35000,1,0,35000,140000,105000
01SCS19E200007,ESH.AR-SC0027,00ARSC0262,M,1,125000,315000,0,0,0,0,0,63000,315000,252000
01SCS19E200008,ESH.AR-SC0032,00ARSC0283,XL,1,44500,135000,0,0,0,0,0,27000,135000,108000
01SCS19E200008,ESH.AR-SD0008,00ARSD0062,M,1,44500,135000,0,0,0,0,0,27000,135000,108000
01SCS19E200008,ESH.AR-SD0022,00ARSD0168,NON,1,43000,120000,0,0,0,0,0,24000,120000,96000
01SCS19E200008,ESH.AR-SD0025,00ARSD0263,M,1,44000,135000,0,0,0,0,0,27000,135000,108000
01SCS19E200009,AR.TUC-SD007,20ARSD0165,M,1,185250,285000,2,0,57000,1,0,57000,228000,171000
01SCS19E200010,AR.MPR-SE026,20ARSE0222,S,1,230750,355000,2,0,71000,1,0,71000,284000,213000
01SCS19E200011,AR.PCT-RE011,20ARRE1435,L,1,81250,125000,2,0,62500,1,0,15625,62500,46875
01SCS19E200012,AR.MPR-SE016,20ARSE0198,M,1,243750,375000,2,0,75000,1,0,75000,300000,225000
01SCS19E200013,AR.MPR-SE037,20ARSE0313,ALL,1,130000,200000,2,0,40000,1,0,40000,160000,120000
01SCS19E200014,AR.VRS-SE002,20ARSE0318,ALL,1,70850,109000,2,0,32700,1,0,19075,76300,57225
01SCS19E200015,AR.MPR-SE032,20ARSE0299,S,1,230750,355000,2,0,71000,1,0,71000,284000,213000
01SCS19E200016,AR.PUB-RI022,20ARRI0298,S,1,97500,150000,2,0,30000,1,0,30000,120000,90000
01SCS19E200017,ARN.AR-SB0001,00ARSB0086,NON,1,107400,179000,0,0,0,0,0,53700,179000,125300
01SCS19E200018,ESH.AR-SD0004,00ARSD0046,M,1,44500,135000,0,0,0,0,0,27000,135000,108000
01SCS19E200019,AR.MPR-SE031,20ARSE0295,S,1,230750,355000,2,0,71000,1,0,71000,284000,213000
01SCS19E200019,BSC.AR-RL0025,00ARRL0167,M,1,94500,135000,0,0,0,0,0,27000,135000,108000
01SCS19E200019,ESH.AR-SA0009,00ARSA0089,L,1,122500,350000,0,0,0,0,0,70000,350000,280000
01SCS19E200020,AR.SMD-RI005,20ARRI0326,XL,1,87750,135000,2,0,40500,1,0,23625,94500,70875
01SCS19E200020,BSC.AR-SC0004,00ARSC0033,XL,1,125000,315000,0,0,0,0,0,63000,315000,252000
01SCS19E200020,ESH.AR-SA0018,00ARSA0123,XL,1,44000,135000,0,0,0,0,0,27000,135000,108000
01SCS19E200021,AR.TUC-SD002,20ARSD0144,S,1,204750,315000,2,0,63000,1,0,63000,252000,189000
01SCS19E200022,ESH.AR-SB0031,00ARSB0205,M,1,44500,135000,0,0,0,0,0,27000,135000,108000
01SCS19E200023,BSC.AR-RI0031,00ARRI0140,NON,1,43000,140000,0,0,0,0,0,28000,140000,112000
01SCS19E200023,BSC.AR-SD0054,00ARSD0287,NON,1,50000,150000,0,0,0,0,0,30000,150000,120000
01SCS19E200024,ESH.AR-SC0011,00ARSC0085,M,1,44000,135000,0,0,0,0,0,27000,135000,108000
01SCS19E200025,AR.TUC-SB018,20ARSB0479,L,1,87750,135000,2,0,27000,1,0,27000,108000,81000
01SCS19E200026,AR.TUC-RI013,20ARRI0375,M,1,100750,155000,2,0,31000,1,0,31000,124000,93000
01SCS19E200026,ESH.AR-SC0037,00ARSC0302,NON,1,40000,140000,0,0,0,0,0,28000,140000,112000
01SCS19E200027,AR.CPT-RE009,20ARRE0702,M,1,204750,315000,2,0,63000,1,0,63000,252000,189000
01SCS19E200028,AR.STY-RK007,20ARRK0529,ALL,1,61750,95000,2,0,19000,1,0,19000,76000,57000
01SCS19E200029,AR.FHL-RJ003,20ARRJ0426,L,1,91000,140000,2,0,28000,1,0,28000,112000,84000
01SCS19E200030,AR.TUC-SE007,20ARSE0387,S,1,204750,315000,2,0,63000,1,0,63000,252000,189000
01SCS19E200031,AR.ESB-RL005,20ARRL0255,M,1,71500,110000,2,0,22000,1,0,22000,88000,66000
01SCS19E200032,BSC.AR-RJ0016,00ARRJ0100,M,1,43000,135000,0,0,0,0,0,27000,135000,108000
01SCS19E200032,ESH.AR-SB0007,00ARSB0027,S,1,44000,135000,0,0,0,0,0,27000,135000,108000
01SCS19E200033,AR.TUC-SB016,20ARSB0471,L,1,87750,135000,2,0,27000,1,0,27000,108000,81000
01SCS19E200034,AR.ESB-RK008,20ARRK0241,ALL,1,87750,135000,2,0,40500,1,0,23625,94500,70875
01SCS19E200035,AR.SMD-RE002,20ARRE0130,ALL,1,97500,150000,2,0,45000,1,0,26250,105000,78750
01SCS19E200036,AR.MKV-RL005,20ARRL0250,28,1,227500,350000,0,0,0,0,0,122500,350000,227500
01SCS19E200037,ESH.AR-SD0011,00ARSD0076,XL,1,125000,315000,0,0,0,0,0,63000,315000,252000
01SCS19E200038,AR.ESB-RL010,20ARRL0461,ALL,1,91000,140000,2,0,70000,1,0,17500,70000,52500
01SCS19E200039,AR.TUC-SA004,20ARSA0015,L,1,87750,135000,2,0,27000,1,0,27000,108000,81000
01SCS19E200040,BSC.AR-SC0007,00ARSC0042,S,1,44000,135000,0,0,0,0,0,27000,135000,108000
01SCS19E200041,ESH.AR-SE0004,00ARSE0014,M,1,44500,135000,0,0,0,0,0,27000,135000,108000
01SCS19E200041,ESH.AR-SE0037,00ARSE0329,M,1,44000,135000,0,0,0,0,0,27000,135000,108000
01SCS19E200042,AR.ESB-SE001,20ARSE0239,M,1,204750,315000,2,0,63000,1,0,63000,252000,189000
01SCS19E200043,ESH.AR-SC0016,00ARSC0137,M,1,44000,135000,0,0,0,0,0,27000,135000,108000
01SCS19E200044,AR.MKV-RL001,20ARRL0237,L,1,204750,315000,0,0,0,0,0,110250,315000,204750
01SCS19E200045,ESH.AR-SB0033,00ARSB0214,L,1,44500,135000,0,0,0,0,0,27000,135000,108000
01SCS19E200045,ESH.AR-SD0018,00ARSD0138,L,1,125000,315000,0,0,0,0,0,63000,315000,252000
01SCS19E200046,AR.TUC-SB009,20ARSB0037,ALL,1,97500,150000,2,0,30000,1,0,30000,120000,90000
01SCS19E200047,BSC.AR-SE0031,00ARSE0291,S,1,52000,155000,0,0,0,0,0,31000,155000,124000
01SCS19E200047,ESH.AR-SB0008,00ARSB0031,30,1,90400,275000,0,0,0,0,0,55000,275000,220000
01SCS19E200048,AR.ASH-RJ008,20ARRJ0274,M,1,91000,140000,2,0,42000,1,0,24500,98000,73500
01SCS19E200048,ESH.AR-SA0001,00ARSA0013,28,1,122500,175000,0,0,0,0,0,35000,175000,140000
01SCS19E200048,ESH.AR-SB0030,00ARSB0200,S,1,44000,135000,0,0,0,0,0,27000,135000,108000
01SCS19E200048,ESH.AR-SE0036,00ARSE0324,S,1,44500,135000,0,0,0,0,0,27000,135000,108000
01SCS19E200049,AR.PUB-SD011,20ARSD0121,ALL,1,97500,150000,2,0,30000,1,0,30000,120000,90000
01SCS19E200050,AR.VRS-SC002,20ARSC0167,M,1,96850,149000,2,0,44700,1,0,26075,104300,78225
01SCS19E200051,AR.PUB-SE005,20ARSE0018,M,1,97500,150000,2,0,30000,1,0,30000,120000,90000
01SCS19E200051,ESH.AR-SA0004,00ARSA0056,M,1,44500,135000,0,0,0,0,0,27000,135000,108000
01SCS19E200051,ESH.AR-SB0033,00ARSB0213,M,1,44500,135000,0,0,0,0,0,27000,135000,108000
01SCS19E200052,AR.MPR-SE034,20ARSE0307,S,1,237250,365000,2,0,73000,1,0,73000,292000,219000
01SCS19E200053,AR.PUB-SD035,20ARSD0346,L,1,204750,315000,2,0,63000,1,0,63000,252000,189000
01SCS19E200054,AR.SMD-QE001,20ARQE0002,M,1,87750,135000,2,0,40500,1,0,23625,94500,70875
01SCS19E200054,ESH.AR-SE0036,00ARSE0324,S,1,44500,135000,0,0,0,0,0,27000,135000,108000
01SCS19E200055,AR.STY-SE005,20ARSE0123,ALL,1,55250,85000,2,0,17000,1,0,17000,68000,51000
01SCS19E200056,BSC.AR-SD0004,00ARSD0014,M,1,44000,159000,0,0,0,0,0,31800,159000,127200
01SCS19E200056,BSC.AR-SE0031,00ARSE0292,M,1,52000,155000,0,0,0,0,0,31000,155000,124000
01SCS19E200057,AR.CPT-SC014,20ARSC0487,S,1,94250,145000,2,0,29000,1,0,29000,116000,87000
01SCS19E200057,AR.ESB-SB003,20ARSB0100,S,1,100750,155000,2,0,31000,1,0,31000,124000,93000
01SCS19E200057,AR.TUC-SE014,20ARSE0415,S,1,94250,145000,2,0,29000,1,0,29000,116000,87000
01SCS19E200058,BSC.AR-SD0064,00ARSD0339,S,1,125000,315000,0,0,0,0,0,63000,315000,252000
01SCS19E200059,AR.PCT-RE013,20ARRE1441,L,1,81250,125000,2,0,62500,1,0,15625,62500,46875
01SCS19E200060,AR.CPT-RE009,20ARRE0702,M,1,204750,315000,2,0,63000,1,0,63000,252000,189000
01SCS19E200061,BSC.AR-SA0018,00ARSA0061,L,1,44000,135000,0,0,0,0,0,27000,135000,108000
01SCS19E200062,BSC.AR-SD0058,00ARSD0294,NON,1,50000,150000,0,0,0,0,0,30000,150000,120000
01SCS19E200063,AR.PUB-SE019,20ARSE0075,L,1,159250,245000,2,0,49000,1,0,49000,196000,147000
01SCS19E200064,AR.MKV-SB012,20ARSB0545,L,1,172250,265000,0,0,0,0,0,92750,265000,172250
01SCS19E200065,AR.TUC-SD003,20ARSD0150,L,1,204750,315000,2,0,63000,1,0,63000,252000,189000
01SCS19E200066,ESH.AR-SD0038,00ARSD0344,M,1,122500,350000,0,0,0,0,0,70000,350000,280000
01SCS19E200067,ESH.AR-SB0010,00ARSB0041,L,1,44500,135000,0,0,0,0,0,27000,135000,108000
01SCS19E200068,AR.SMD-SD007,20ARSD0301,M,1,211250,325000,2,0,65000,1,0,65000,260000,195000
01SCS19E200069,AR.CPT-RE009,20ARRE0701,S,1,204750,315000,2,0,63000,1,0,63000,252000,189000
01SCS19E200070,ARN.AR-SB0001,00ARSB0086,NON,1,107400,179000,0,0,0,0,0,53700,179000,125300
01SCS19E200071,AR.MPR-SE005,20ARSE0155,L,1,97500,150000,2,0,45000,1,0,26250,105000,78750
01SCS19E200071,AR.PUB-RH021,20ARRH0289,42,1,146250,225000,2,0,45000,1,0,45000,180000,135000
01SCS19E200072,ESH.AR-SC0005,00ARSC0026,S,1,125000,315000,0,0,0,0,0,63000,315000,252000
01SCS19E200073,BSC.AR-SE0027,00ARSE0275,S,1,52000,155000,0,0,0,0,0,31000,155000,124000
01SCS19E200073,BSC.AR-SE0031,00ARSE0291,S,1,52000,155000,0,0,0,0,0,31000,155000,124000
01SCS19E200074,AR.TUC-SE009,20ARSE0398,L,1,204750,315000,2,0,63000,1,0,63000,252000,189000
01SCS19E200075,BSC.AR-SB0005,00ARSB0061,NON,1,47500,140000,0,0,0,0,0,28000,140000,112000
01SCS19E200076,AR.TUC-SA002,20ARSA0006,M,1,204750,315000,2,0,63000,1,0,63000,252000,189000
01SCS19E200077,AR.TUC-SB007,20ARSB0035,ALL,1,61750,95000,2,0,19000,1,0,19000,76000,57000
01SCS19E200078,BSC.AR-SC0029,00ARSC0200,M,1,125000,315000,0,0,0,0,0,63000,315000,252000
01SCS19E200079,ESH.AR-SB0014,00ARSB0060,NON,1,45000,140000,0,0,0,0,0,28000,140000,112000
01SCS19E200080,BSC.AR-SD0042,00ARSD0228,M,1,44500,159000,0,0,0,0,0,31800,159000,127200
01SCS19E200081,BSC.AR-SC0033,00ARSC0225,M,1,125000,315000,1,0,63000,1,0,50400,252000,201600
01SCS19E200082,AR.BPH-RK009,20ARRK0064,ALL,1,103350,159000,2,0,47700,1,0,27825,111300,83475
01SCS19E200083,BSC.AR-SB0020,00ARSB0168,M,1,44000,135000,0,0,0,0,0,27000,135000,108000
01SCS19E200083,ESH.AR-SD0040,00ARSD0367,M,1,122500,350000,0,0,0,0,0,70000,350000,280000
01SCS19E200084,AR.SMD-RL001,20ARRL0265,ALL,1,22750,35000,2,0,7000,1,0,7000,28000,21000
01SCS19E200084,BSC.AR-SD0011,00ARSD0104,NON,1,18000,75000,0,0,0,0,0,15000,75000,60000
01SCS19E200085,AR.STY-RK007,20ARRK0529,ALL,1,61750,95000,2,0,19000,1,0,19000,76000,57000
01SCS19E200086,AR.SMD-RH003,20ARRH0399,M,1,211250,325000,2,0,97500,1,0,56875,227500,170625
01SCS19E200087,AR.REC-SD014,20ARSD0052,ALL,1,107250,165000,2,0,49500,1,0,28875,115500,86625
01SCS19E200088,AR.TUC-SE007,20ARSE0387,S,1,204750,315000,2,0,63000,1,0,63000,252000,189000
01SCS19E200089,AR.MER-SB003,20ARSB0219,M,1,97500,150000,2,0,45000,1,0,26250,105000,78750
01SCS19E200089,AR.PUB-SE012,20ARSE0046,M,1,97500,150000,2,0,30000,1,0,30000,120000,90000
01SCS19E200090,BSC.AR-RJ0018,00ARRJ0108,M,1,94500,135000,0,0,0,0,0,27000,135000,108000
01SCS19E200090,BSC.AR-SD0037,00ARSD0203,S,1,44500,159000,0,0,0,0,0,31800,159000,127200
01SCS19E200091,AR.PUB-SE005,20ARSE0017,S,1,97500,150000,2,0,30000,1,0,30000,120000,90000
01SCS19E200091,AR.RDC-RK005,20ARRK0469,L,1,97500,150000,2,0,30000,1,0,30000,120000,90000
01SCS19E200092,AR.MKV-SD005,20ARSD0234,S,1,172250,265000,0,0,0,0,0,92750,265000,172250
01SCS19E200093,AR.ESB-SC002,20ARSC0308,S,1,204750,315000,2,0,63000,1,0,63000,252000,189000
01SCS19E200094,ESH.AR-SD0037,00ARSD0335,NON,1,50000,150000,0,0,0,0,0,30000,150000,120000
01SCS19E200095,AR.MKV-SE008,20ARSE0505,30,1,227500,350000,0,0,0,0,0,122500,350000,227500
01SCS19E200096,AR.CPT-RE009,20ARRE0702,M,1,204750,315000,2,0,63000,1,0,63000,252000,189000
01SCS19E200097,AR.CPS-SC004,20ARSC0004,ALL,1,130000,200000,2,0,60000,1,0,35000,140000,105000
01SCS19E200098,BSC.AR-SC0036,00ARSC0241,30,1,135000,375000,0,0,0,0,0,75000,375000,300000
01SCS19E200099,AR.CPT-RC008,20ARRC0613,XL,1,304850,469000,2,0,93800,1,0,93800,375200,281400
01SCS19E200099,AR.MDS-RI001,20ARRI0090,L,1,221000,340000,2,0,68000,1,0,68000,272000,204000
01SCS19E200100,BSC.AR-RL0018,00ARRL0111,L,1,125000,315000,0,0,0,0,0,63000,315000,252000
01SCS19E200101,AR.TUC-SB009,20ARSB0037,ALL,1,97500,150000,2,0,30000,1,0,30000,120000,90000
01SCS19E200102,BSC.AR-SB0007,00ARSB0076,L,1,44500,135000,0,0,0,0,0,27000,135000,108000
01SCS19E200102,BSC.AR-SC0050,00ARSC0314,L,1,44000,159000,0,0,0,0,0,31800,159000,127200
01SCS19E200103,AR.MPR-SE025,20ARSE0218,S,1,230750,355000,2,0,71000,1,0,71000,284000,213000
01SCS19E200104,ESH.AR-SC0005,00ARSC0026,S,1,125000,315000,0,0,0,0,0,63000,315000,252000
01SCS19E200105,AR.MPR-SE027,20ARSE0228,L,1,243750,375000,2,0,75000,1,0,75000,300000,225000
01SCS19E200106,AR.PUB-RL005,20ARRL0123,S,1,97500,150000,2,0,30000,1,0,30000,120000,90000
01SCS19E200106,AR.PUB-RL005,20ARRL0124,M,1,97500,150000,2,0,30000,1,0,30000,120000,90000
01SCS19E200107,BSC.AR-SD0063,00ARSD0338,NON,1,60000,180000,0,0,0,0,0,36000,180000,144000
01SCS19E200108,AR.TUC-SB001,20ARSB0024,M,1,204750,315000,2,0,63000,1,0,63000,252000,189000
01SCS19E200109,BSC.AR-SB0015,00ARSB0128,M,1,125000,315000,0,0,0,0,0,63000,315000,252000
01SCS19E200110,AR.ESB-SA001,20ARSA0206,XL,1,87750,135000,2,0,27000,1,0,27000,108000,81000
01SCS19E200110,BSC.AR-SC0016,00ARSC0115,XL,1,44500,135000,0,0,0,0,0,27000,135000,108000
01SCS19E200111,AR.TUC-SD003,20ARSD0151,XL,1,204750,315000,2,0,63000,1,0,63000,252000,189000
01SCS19E200112,AR.TUC-SA031,20ARSA0259,L,1,87750,135000,2,0,27000,1,0,27000,108000,81000
01SCS19E200112,AR.TUC-SE012,20ARSE0409,L,1,94250,145000,2,0,29000,1,0,29000,116000,87000
01SCS19E200113,AR.MPR-SE024,20ARSE0214,S,1,230750,355000,2,0,71000,1,0,71000,284000,213000
01SCS19E200114,AR.CLK-SA005,20ARSA0054,ALL,1,91000,140000,2,0,28000,1,0,28000,112000,84000
01SCS19E200114,AR.PUB-SE021,20ARSE0081,L,1,159250,245000,2,0,49000,1,0,49000,196000,147000
01SCS19E200115,AR.ASH-RJ008,20ARRJ0275,L,1,91000,140000,2,0,42000,1,0,24500,98000,73500
01SCS19E200115,AR.CPT-SD007,20ARSD0438,M,1,204750,315000,2,0,63000,1,0,63000,252000,189000
01SCS19E200115,AR.ESB-RH002,20ARRH0180,ALL,1,87750,135000,2,0,40500,1,0,23625,94500,70875
01SCS19E200115,AR.PUB-SD034,20ARSD0341,M,1,97500,150000,2,0,30000,1,0,30000,120000,90000
01SCS19E200115,ESH.AR-RK0018,00ARRK0194,NON,1,105000,150000,0,0,0,0,0,30000,150000,120000
01SCS19E200116,AR.CPT-SC012,20ARSC0481,L,1,204750,315000,2,0,63000,1,0,63000,252000,189000
01SCS19E200116,AR.MPR-SE011,20ARSE0179,L,1,97500,150000,2,0,45000,1,0,26250,105000,78750
01SCS19E200117,THR.AR-RK0004,00ARRK0171,L,1,332000,415000,0,0,0,0,0,62250,415000,352750
01SCS19E200118,ESH.AR-RH0018,00ARRH0099,S,1,94500,135000,0,0,0,0,0,27000,135000,108000
01SCS19E200119,AR.PUB-SE003,20ARSE0011,L,1,97500,150000,2,0,30000,1,0,30000,120000,90000
01SCS19E200119,AR.SMD-QD013,20ARQD0192,L,1,84500,130000,2,0,39000,1,0,22750,91000,68250
01SCS19E200120,AR.CPT-SC006,20ARSC0260,S,1,94250,145000,2,0,29000,1,0,29000,116000,87000
01SCS19E200121,BSC.AR-SA0017,00ARSA0054,XL,1,125000,315000,0,0,0,0,0,63000,315000,252000
01SCS19E200122,AR.SLS-SE013,20ARSE0332,M,1,106250,1250000,0,0,0,0,0,187500,1250000,1062500
01SCS19E200123,AR.STY-SE003,20ARSE0121,ALL,1,55250,85000,2,0,17000,1,0,17000,68000,51000
01SCS19E200124,AR.PUB-SE002,20ARSE0006,M,1,97500,150000,2,0,30000,1,0,30000,120000,90000
01SCS19E200124,ESH.AR-RK0016,00ARRK0192,NON,1,105000,150000,0,0,0,0,0,30000,150000,120000
01SCS19E200125,AR.PUB-SB030,20ARSB0454,L,1,97500,150000,2,0,30000,1,0,30000,120000,90000
01SCS19E200125,AR.TUC-SD019,20ARSD0495,L,1,94250,145000,2,0,29000,1,0,29000,116000,87000
01SCS19E200126,DKS.AR-SE0004,00ARSE0140,30,1,417272,696000,0,0,0,0,0,104400,696000,591600
01SCS19E200126,ESH.AR-RJ0008,00ARRJ0039,S,1,44500,135000,0,0,0,0,0,27000,135000,108000
01SCS19E200126,ESH.AR-SA0013,00ARSA0099,L,1,44000,135000,0,0,0,0,0,27000,135000,108000
01SCS19E210001,AR.CPT-SC014,20ARSC0489,L,1,94250,145000,2,0,29000,1,0,29000,116000,87000
01SCS19E210002,AR.MKV-SC003,20ARSC0077,ALL,1,87750,135000,0,0,0,0,0,47250,135000,87750
01SCS19E210002,AR.PUB-SD019,20ARSD0188,ALL,1,97500,150000,2,0,30000,1,0,30000,120000,90000
01SCS19E210003,AR.ESB-SB001,20ARSB0021,M,1,204750,315000,2,0,63000,1,0,63000,252000,189000
01SCS19E210004,BSC.AR-SC0015,00ARSC0102,L,1,44000,159000,0,0,0,0,0,31800,159000,127200
01SCS19E210004,ESH.AR-SD0007,00ARSD0059,L,1,44500,135000,0,0,0,0,0,27000,135000,108000
01SCS19E210005,ESH.AR-SD0010,00ARSD0069,S,1,44500,135000,0,0,0,0,0,27000,135000,108000
01SCS19E210005,ESH.AR-SE0009,00ARSE0033,S,1,44500,135000,0,0,0,0,0,27000,135000,108000
01SCS19E210006,ESH.AR-SC0038,00ARSC0303,NON,1,45000,140000,0,0,0,0,0,28000,140000,112000
01SCS19E210007,ESH.AR-SE0010,00ARSE0038,M,1,44000,135000,0,0,0,0,0,27000,135000,108000
01SCS19E210008,BSC.AR-SA0017,00ARSA0051,S,1,125000,315000,0,0,0,0,0,63000,315000,252000
01SCS19E210008,ESH.AR-SD0009,00ARSD0066,M,1,44500,135000,0,0,0,0,0,27000,135000,108000
01SCS19E210009,ESH.AR-SB0008,00ARSB0031,30,1,90400,275000,0,0,0,0,0,55000,275000,220000
01SCS19E210009,ESH.AR-SC0028,00ARSC0265,S,1,44500,135000,0,0,0,0,0,27000,135000,108000
01SCS19E210009,ESH.AR-SD0011,00ARSD0073,S,1,125000,315000,0,0,0,0,0,63000,315000,252000
01SCS19E210009,ESH.AR-SE0006,00ARSE0021,S,1,44000,135000,0,0,0,0,0,27000,135000,108000
01SCS19E210010,AR.PUB-RE051,20ARRE0595,M,1,204750,315000,2,0,63000,1,0,63000,252000,189000
01SCS19E210010,AR.PUB-SC013,20ARSC0353,M,1,97500,150000,2,0,30000,1,0,30000,120000,90000
01SCS19E210010,BSC.AR-SC0013,00ARSC0093,M,1,44000,135000,0,0,0,0,0,27000,135000,108000
01SCS19E210011,ESH.AR-SE0031,00ARSE0271,S,1,125000,315000,0,0,0,0,0,63000,315000,252000
01SCS19E210012,THR.AR-RK0006,00ARRK0177,L,1,824000,1030000,0,0,0,0,0,154500,1030000,875500
01SCS19E210013,AR.ESB-SC018,20ARSC0465,M,1,91000,140000,2,0,28000,1,0,28000,112000,84000
01SCS19E210013,AR.MDS-RL002,20ARRL0359,M,1,117000,180000,2,0,36000,1,0,36000,144000,108000
01SCS19E210014,AR.PUB-SD025,20ARSD0198,M,1,97500,150000,2,0,30000,1,0,30000,120000,90000
01SCS19E210015,AR.ESB-RE016,20ARRE0382,M,1,94250,145000,2,0,72500,1,0,18125,72500,54375
01SCS19E210015,AR.ESB-SE011,20ARSE0279,M,1,227500,350000,2,0,70000,1,0,70000,280000,210000
01SCS19E210015,BSC.AR-SE0007,00ARSE0082,M,1,44500,159000,0,0,0,0,0,31800,159000,127200
01SCS19E210016,AR.CPT-SC011,20ARSC0476,M,1,204750,315000,2,0,63000,1,0,63000,252000,189000
01SCS19E210017,BSC.AR-RK0007,00ARRK0074,M,1,52000,155000,0,0,0,0,0,31000,155000,124000
01SCS19E210017,ESH.AR-SD0025,00ARSD0263,M,1,44000,135000,0,0,0,0,0,27000,135000,108000
01SCS19E210018,BE.RAK-SA023,00BESA0093,L,1,91000,140000,2,0,28000,1,0,28000,112000,84000
01SCS19E210018,BSC.AR-RK0019,00ARRK0121,S,1,43000,135000,0,0,0,0,0,27000,135000,108000
01SCS19E210018,ESH.AR-SA0018,00ARSA0120,S,1,44000,135000,0,0,0,0,0,27000,135000,108000
01SCS19E210019,BSC.AR-SD0052,00ARSD0279,S,1,44500,159000,0,0,0,0,0,31800,159000,127200
01SCS19E210019,ESH.AR-SE0033,00ARSE0303,S,1,52000,155000,0,0,0,0,0,31000,155000,124000
01SCS19E210020,AR.VRS-QK012,20ARQK0345,M,1,96850,149000,2,0,44700,1,0,26075,104300,78225
01SCS19E210021,BE.RAK-SB012,00BESB0059,XL,1,201500,310000,2,0,62000,1,0,62000,248000,186000
01SCS19E210022,ESH.AR-SA0014,00ARSA0101,S,1,44000,135000,0,0,0,0,0,27000,135000,108000
01SCS19E210023,AR.MPR-SE016,20ARSE0198,M,1,243750,375000,2,0,75000,1,0,75000,300000,225000
01SCS19E210024,AR.CPT-SC014,20ARSC0488,M,1,94250,145000,2,0,29000,1,0,29000,116000,87000
01SCS19E210025,AR.CPT-RC008,20ARRC0613,XL,1,304850,469000,2,0,93800,1,0,93800,375200,281400
01SCS19E210025,BSC.AR-SE0033,00ARSE0319,36,1,125400,365000,0,0,0,0,0,73000,365000,292000
01SCS19E210026,BSC.AR-SC0009,00ARSC0054,L,1,125000,315000,0,0,0,0,0,63000,315000,252000
01SCS19E210027,BSC.AR-SC0029,00ARSC0200,M,1,125000,315000,0,0,0,0,0,63000,315000,252000
01SCS19E210028,ESH.AR-SC0019,00ARSC0150,M,1,125000,315000,0,0,0,0,0,63000,315000,252000
01SCS19E210028,ESH.AR-SE0037,00ARSE0329,M,1,44000,135000,0,0,0,0,0,27000,135000,108000
01SCS19E210029,AR.TUC-SB001,20ARSE0395,S,1,204750,315000,2,0,63000,1,0,63000,252000,189000
01SCS19E210030,AR.HLW-SE001,20ARSE0526,ALL,1,71500,110000,0,0,0,0,0,38500,110000,71500
01SCS19E210031,BE.RAK-SA006,00BESA0025,XL,1,204750,315000,2,0,63000,1,0,63000,252000,189000
01SCS19E210032,AR.MPR-SE011,20ARSE0178,M,1,97500,150000,2,0,45000,1,0,26250,105000,78750
01SCS19E210033,ESH.AR-SE0038,00ARSE0332,S,1,44500,135000,0,0,0,0,0,27000,135000,108000
01SCS19E210034,AR.CPT-SC003,20ARSC0248,28,1,227500,350000,2,0,70000,1,0,70000,280000,210000
01SCS19E210034,AR.STY-SA003,20ARSA0062,ALL,1,61750,95000,2,0,19000,1,0,19000,76000,57000
01SCS19E210035,AR.TUC-SD022,20ARSD0507,L,1,94250,145000,2,0,29000,1,0,29000,116000,87000
01SCS19E210036,ESH.AR-SE0007,00ARSE0025,S,1,44500,135000,0,0,0,0,0,27000,135000,108000
01SCS19E210037,DKS.AR-SE0009,00ARSE0163,34,1,417272,696000,0,0,0,0,0,104400,696000,591600
01SCS19E210038,AR.SMD-SD012,20ARSD0566,M,1,87750,135000,2,0,27000,1,0,27000,108000,81000
01SCS19E210038,AR.TUC-SE017,20ARSE0427,M,1,146250,225000,2,0,45000,1,0,45000,180000,135000
01SCS19E210039,AR.TUC-SD015,20ARSD0478,M,1,145000,145000,2,0,29000,1,0,29000,116000,87000
01SCS19E210040,AR.YD-RL008,20ARRL0024,ALL,1,87750,135000,2,0,67500,1,0,16875,67500,50625
01SCS19E210041,AR.TUC-SE016,20ARSE0424,M,1,146250,225000,2,0,45000,1,0,45000,180000,135000
01SCS19E210042,AR.HLW-SE001,20ARSE0526,ALL,1,71500,110000,0,0,0,0,0,38500,110000,71500
01SCS19E210042,AR.MKV-SB010,20ARSB0537,L,1,97500,150000,2,0,30000,1,0,30000,120000,90000
01SCS19E210042,AR.REC-SD020,20ARSD0059,30,1,208000,320000,2,0,96000,1,0,56000,224000,168000
01SCS19E210043,BSC.AR-RJ0020,00ARRJ0115,S,1,44500,135000,0,0,0,0,0,27000,135000,108000
01SCS19E210043,BSC.AR-SE0031,00ARSE0291,S,1,52000,155000,0,0,0,0,0,31000,155000,124000
01SCS19E210044,AR.TUC-SB001,20ARSB0024,M,1,204750,315000,2,0,63000,1,0,63000,252000,189000
01SCS19E210045,AR.CPT-SC009,20ARSC0273,M,1,94250,145000,2,0,29000,1,0,29000,116000,87000
01SCS19E210046,AR.TUC-SD002,20ARSD0146,L,1,204750,315000,2,0,63000,1,0,63000,252000,189000
01SCS19E210047,AR.SLS-SE003,20ARSE0130,43,1,850000,1000000,0,0,0,0,0,150000,1000000,850000
01SCS19E210048,ESH.AR-SA0012,00ARSA0095,L,1,44000,135000,0,0,0,0,0,27000,135000,108000
01SCS19E210049,AR.PCT-SE002,20ARSE0339,L,1,87750,135000,2,0,27000,1,0,27000,108000,81000
01SCS19E210049,AR.TUC-SE012,20ARSE0409,L,1,94250,145000,2,0,29000,1,0,29000,116000,87000
01SCS19E210050,AR.MKV-RJ006,20ARRJ0165,S,1,91000,140000,2,0,28000,1,0,28000,112000,84000
01SCS19E210050,ESH.AR-SE0038,00ARSE0334,L,1,44500,135000,0,0,0,0,0,27000,135000,108000
01SCS19E210051,AR.MPR-SE032,20ARSE0299,S,1,230750,355000,2,0,71000,1,0,71000,284000,213000
01SCS19E210052,AR.SMD-RL001,20ARRL0265,ALL,1,22750,35000,2,0,7000,1,0,7000,28000,21000
01SCS19E210053,ESH.AR-SE0011,00ARSE0042,M,1,44500,135000,0,0,0,0,0,27000,135000,108000
01SCS19E210054,AR.GTW-SA003,20ARSA0306,XL,1,94250,145000,2,0,43500,1,0,25375,101500,76125
01SCS19E210054,AR.MKV-RJ004,20ARRJ0158,XL,1,91000,140000,2,0,28000,1,0,28000,112000,84000
01SCS19E210054,ESH.AR-SD0032,00ARSD0306,XL,1,44500,135000,0,0,0,0,0,27000,135000,108000
01SCS19E210055,AR.PUB-SD038,20ARSD0354,ALL,1,97500,150000,2,0,30000,1,0,30000,120000,90000
01SCS19E210056,BSC.AR-SC0013,00ARSC0093,M,1,44000,135000,0,0,0,0,0,27000,135000,108000
01SCS19E210057,ESH.AR-SE0005,00ARSE0018,M,1,44500,135000,0,0,0,0,0,27000,135000,108000
01SCS19E210058,BSC.AR-SE0035,00ARSE0336,28,1,125000,365000,0,0,0,0,0,73000,365000,292000
01SCS19E210058,BSC.AR-SE0036,00ARSE0341,28,1,125000,365000,0,0,0,0,0,73000,365000,292000
01SCS19E210059,BE.RAK-RX194,00BERX0487,42,1,130000,200000,2,0,40000,1,0,40000,160000,120000
01SCS19E210060,AR.STY-SE007,20ARSE0125,ALL,1,55250,85000,2,0,17000,1,0,17000,68000,51000
01SCS19E210061,AR.STY-SE009,20ARSE0127,ALL,1,55250,85000,2,0,17000,1,0,17000,68000,51000
01SCS19E210062,DKS.AR-SE0008,00ARSE0158,34,1,41727,696000,0,0,0,0,0,104400,696000,591600
01SCS19E210063,BSC.AR-SE0002,00ARSE0061,S,1,44000,159000,0,0,0,0,0,31800,159000,127200
01SCS19E210064,AR.VRS-QK012,20ARQK0346,L,1,96850,149000,2,0,44700,1,0,26075,104300,78225
01SCS19E210064,ESH.AR-SC0003,00ARSC0011,L,1,125000,350000,0,0,0,0,0,70000,350000,280000
01SCS19E210065,AR.MKV-QH011,20ARQH0216,ALL,1,175500,270000,2,0,135000,1,0,33750,135000,101250
01SCS19E210066,AR.SMD-SD017,20ARSD0579,ALL,1,97500,150000,2,0,30000,1,0,30000,120000,90000
01SCS19E210066,AR.STY-SE016,20ARSE0582,ALL,1,55250,85000,0,0,0,0,0,29750,85000,55250
01SCS19E210067,BSC.AR-SE0003,00ARSE0065,S,1,44000,159000,0,0,0,0,0,31800,159000,127200
01SCS19E210068,AR.CPT-SE003,20ARSE0360,S,1,94250,145000,2,0,29000,1,0,29000,116000,87000
01SCS19E210068,AR.MKV-SC014,20ARSC0209,M,1,204750,315000,2,0,63000,1,0,63000,252000,189000
01SCS19E210068,BSC.AR-SC0050,00ARSC0314,L,1,44000,159000,0,0,0,0,0,31800,159000,127200
01SCS19E210069,ESH.AR-SB0015,00ARSB0063,M,1,125000,315000,0,0,0,0,0,63000,315000,252000
01SCS19E210070,BSC.AR-SD0058,00ARSD0294,NON,1,50000,150000,0,0,0,0,0,30000,150000,120000
01SCS19E210071,ESH.AR-SE0005,00ARSE0017,S,1,44500,135000,0,0,0,0,0,27000,135000,108000
01SCS19E210072,BSC.AR-RH0017,00ARRH0076,L,1,120000,315000,0,0,0,0,0,63000,315000,252000
01SCS19E210073,AR.BPH-SD006,20ARSD0375,S,1,259350,399000,2,0,199500,1,0,49875,199500,149625
01SCS19E210073,AR.PUB-SD019,20ARSD0188,ALL,1,97500,150000,2,0,30000,1,0,30000,120000,90000
01SCS19E210073,BSC.AR-SD0026,00ARSD0153,M,1,44500,159000,0,0,0,0,0,31800,159000,127200
01SCS19E210074,AR.ESB-QJ014,20ARQJ0095,ALL,1,91000,140000,2,0,70000,1,0,17500,70000,52500
01SCS19E210075,AR.REC-SD007,20ARSD0027,L,1,107250,165000,2,0,49500,1,0,28875,115500,86625
01SCS19E210076,AR.PCT-RL002,20ARRL0186,M,1,217750,335000,2,0,167500,1,0,41875,167500,125625
01SCS19E210077,AR.PUB-RK012,20ARRK0454,ALL,1,97500,150000,2,0,30000,1,0,30000,120000,90000
01SCS19E210078,AR.VRS-SC010,20ARSC0197,M,1,96850,149000,2,0,44700,1,0,26075,104300,78225
01SCS19E210079,BSC.AR-RL0028,00ARRL0180,L,1,94500,135000,0,0,0,0,0,27000,135000,108000
01SCS19E210079,ESH.AR-SD0038,00ARSD0346,XL,1,122500,350000,0,0,0,0,0,70000,350000,280000
01SCS19E210080,AR.ESB-SC017,20ARSC0460,S,1,91000,140000,2,0,28000,1,0,28000,112000,84000
01SCS19E210080,ESH.AR-SE0017,00ARSE0114,M,1,44000,135000,0,0,0,0,0,27000,135000,108000
01SCS19E210081,ESH.AR-SB0032,00ARSB0208,S,1,125000,315000,0,0,0,0,0,63000,315000,252000
01SCS19E210082,AR.ASH-SD004,20ARSD0394,M,1,243750,375000,2,0,112500,1,0,65625,262500,196875
01SCS19E210082,AR.MKV-SE019,20ARSE0606,M,1,97500,150000,0,0,0,0,0,52500,150000,97500
01SCS19E210083,BSC.AR-RH0018,00ARRH0081,XL,1,120000,315000,0,0,0,0,0,63000,315000,252000
01SCS19E210084,AR.TUC-RL015,20ARRL0339,ALL,1,87750,135000,2,0,27000,1,0,27000,108000,81000
01SCS19E210085,AR.TUC-SB014,20ARSB0205,L,1,94250,145000,2,0,29000,1,0,29000,116000,87000
01SCS19E210086,AR.BPH-RH007,20ARRH0354,L,1,214500,330000,2,0,165000,1,0,41250,165000,123750
01SCS19E210087,BSC.AR-RH0024,00ARRH0156,M,1,245000,350000,0,0,0,0,0,70000,350000,280000
01SCS19E210088,AR.TUC-SE006,20ARSE0384,M,1,204750,315000,2,0,63000,1,0,63000,252000,189000
01SCS19E210089,ESH.AR-SD0001,00ARSD0029,S,1,44500,135000,0,0,0,0,0,27000,135000,108000
01SCS19E210089,ESH.AR-SE0017,00ARSE0113,S,1,44000,135000,0,0,0,0,0,27000,135000,108000
01SCS19E210090,AR.HLW-SA017,20ARSA0116,M,1,100750,155000,2,0,46500,1,0,27125,108500,81375
01SCS19E210090,AR.HLW-SE003,20ARSE0529,M,1,100750,155000,0,0,0,0,0,54250,155000,100750
01SCS19E210090,AR.TUC-SD019,20ARSD0495,L,1,94250,145000,2,0,29000,1,0,29000,116000,87000
01SCS19E210090,ESH.AR-RK0020,00ARRK0202,XL,1,192500,275000,0,0,0,0,0,55000,275000,220000
01SCS19E210091,AR.YD-RL009,20ARRL0025,ALL,1,55250,85000,2,0,25500,1,0,14875,59500,44625
01SCS19E210092,AR.PUB-SD019,20ARSD0188,ALL,1,97500,150000,2,0,30000,1,0,30000,120000,90000
01SCS19E210092,AR.STY-SE008,20ARSE0126,ALL,1,55250,85000,2,0,17000,1,0,17000,68000,51000
01SCS19E210093,AR.MPR-SB003,20ARSB0245,XL,1,230750,355000,2,0,71000,1,0,71000,284000,213000
01SCS19E210094,AR.TUC-SE009,20ARSE0431,XL,1,204750,315000,2,0,63000,1,0,63000,252000,189000
01SCS19E210094,AR.VRS-QJ008,20ARSE0314,XL,1,96850,149000,2,0,44700,1,0,26075,104300,78225
01SCS19E210095,AR.SMD-SA002,20ARSA0226,XL,1,87750,135000,2,0,27000,1,0,27000,108000,81000
01SCS19E210096,BSC.AR-RI0019,00ARRI0107,M,1,94500,135000,0,0,0,0,0,27000,135000,108000
01SCS19E210097,AR.MPR-SE031,20ARSE0296,M,1,230750,355000,2,0,71000,1,0,71000,284000,213000
01SCS19E210098,AR.CLK-SA003,20ARSA0052,ALL,1,91000,140000,2,0,28000,1,0,28000,112000,84000
01SCS19E210099,ESH.AR-SA0012,00ARSA0093,S,1,44000,135000,0,0,0,0,0,27000,135000,108000
01SCS19E210100,AR.ASH-RJ011,20ARRJ0491,L,1,91000,140000,2,0,42000,1,0,24500,98000,73500
01SCS19E210101,AR.BPH-RH035,20ARRH0817,S,1,220350,339000,2,0,169500,1,0,42375,169500,127125
01SCS19E210101,AR.MKV-SE019,20ARSE0605,S,1,97500,150000,0,0,0,0,0,52500,150000,97500
01SCS19E210102,BSC.AR-RK0020,00ARRK0127,L,1,94500,135000,0,0,0,0,0,27000,135000,108000
01SCS19E210102,ESH.AR-RD0007,00ARRD0054,NON,1,80500,115000,0,0,0,0,0,23000,115000,92000
01SCS19E210103,BSC.AR-SD0012,00ARSD0105,NON,1,18000,75000,0,0,0,0,0,15000,75000,60000
01SCS19E210103,ESH.AR-SC0007,00ARSC0061,M,1,125000,350000,0,0,0,0,0,70000,350000,280000
01SCS19E210104,AR.ESB-SE011,20ARSE0279,M,1,227500,350000,2,0,70000,1,0,70000,280000,210000
01SCS19E210105,AR.MPR-SE008,20ARSE0167,L,1,97500,150000,2,0,45000,1,0,26250,105000,78750
01SCS19E210106,BSC.AR-SE0036,00ARSE0342,30,1,125000,365000,0,0,0,0,0,73000,365000,292000
01SCS19E210107,AR.CPT-SB001,20ARSB0082,S,1,204750,315000,2,0,63000,1,0,63000,252000,189000
01SCS19E210107,AR.MKV-SE021,20ARSE0612,M,1,97500,150000,0,0,0,0,0,52500,150000,97500
01SCS19E210108,AR.MKV-SE003,20ARSE0479,28,1,224250,345000,2,0,69000,1,0,69000,276000,207000
01SCS19E210109,AR.TUC-RI011,20ARRI0368,L,1,87750,135000,2,0,27000,1,0,27000,108000,81000
01SCS19E210109,BE.RAK-SB014,00BESB0068,L,1,91000,140000,2,0,28000,1,0,28000,112000,84000
01SCS19E210110,AR.PUB-SE016,20ARSE0063,L,1,159250,245000,2,0,49000,1,0,49000,196000,147000
01SCS19E210110,AR.RDC-RL002,20ARRL0445,ALL,1,81250,125000,2,0,37500,1,0,21875,87500,65625
01SCS19E210111,ESH.AR-SC0010,00ARSC0081,M,1,44500,135000,0,0,0,0,0,27000,135000,108000
01SCS19E210111,ESH.AR-SC0013,00ARSC0105,M,1,44500,135000,0,0,0,0,0,27000,135000,108000
01SCS19E210112,AR.ESB-SE003,20ARSE0248,L,1,204750,315000,2,0,63000,1,0,63000,252000,189000
01SCS19E210112,AR.TUC-SC004,20ARSC0058,32,1,204750,315000,2,0,63000,1,0,63000,252000,189000
01SCS19E210113,BSC.AR-SD0058,00ARSD0294,NON,1,50000,150000,0,0,0,0,0,30000,150000,120000
01SCS19E210114,AR.ESB-RE049,20ARRE0813,ALL,1,91000,140000,2,0,70000,1,0,17500,70000,52500
01SCS19E210115,AR.MKV-SB009,20ARSB0534,XL,1,97500,150000,2,0,30000,1,0,30000,120000,90000
01SCS19E210115,BE.RAK-SB041,00BESB0121,XL,1,94250,145000,2,0,29000,1,0,29000,116000,87000
01SCS19E210116,AR.ESB-SD002,20ARSD0101,M,1,74750,115000,2,0,23000,1,0,23000,92000,69000
01SCS19E210117,AR.MKV-QK003,20ARQK0070,ALL,1,175500,270000,2,0,135000,1,0,33750,135000,101250
01SCS19E210117,AR.PUB-RL022,20ARRL0201,ALL,1,97500,150000,2,0,30000,1,0,30000,120000,90000
01SCS19E210117,AR.SMD-RL003,20ARRL0267,ALL,1,22750,35000,2,0,7000,1,0,7000,28000,21000
01SCS19E210118,AR.TUC-SB001,20ARSB0024,M,1,204750,315000,2,0,63000,1,0,63000,252000,189000
01SCS19E210119,BSC.AR-SC0029,00ARSC0201,L,1,125000,315000,0,0,0,0,0,63000,315000,252000
01SCS19E210120,AR.MPR-SE007,20ARSE0161,S,1,97500,150000,2,0,45000,1,0,26250,105000,78750
01SCS19E210121,AR.STY-SE008,20ARSE0126,ALL,1,55250,85000,2,0,17000,1,0,17000,68000,51000
01SCS19E210122,AR.STY-SE008,20ARSE0126,ALL,1,55250,85000,2,0,17000,1,0,17000,68000,51000
01SCS19E210123,AR.MPR-SE011,20ARSE0179,L,1,97500,150000,2,0,45000,1,0,26250,105000,78750
01SCS19E210124,AR.MPR-SE037,20ARSE0313,ALL,1,130000,200000,2,0,40000,1,0,40000,160000,120000
01SCS19E210124,ESH.AR-SE0009,00ARSE0034,M,1,44500,135000,0,0,0,0,0,27000,135000,108000
01SCS19E210125,AR.MPR-SB002,20ARSB0238,S,1,243750,375000,2,0,75000,1,0,75000,300000,225000
01SCS19E210125,ESH.AR-SE0017,00ARSE0113,S,1,44000,135000,0,0,0,0,0,27000,135000,108000
01SCS19E210126,AR.CLK-SA005,20ARSA0054,ALL,1,91000,140000,2,0,28000,1,0,28000,112000,84000
01SCS19E210127,AR.MPR-SE012,20ARSE0181,S,1,97500,150000,2,0,45000,1,0,26250,105000,78750
01SCS19E210127,AR.TUC-SE009,20ARSE0397,M,1,204750,315000,2,0,63000,1,0,63000,252000,189000
01SCS19E210128,AR.STY-SE010,20ARSE0576,ALL,1,61750,95000,0,0,0,0,0,33250,95000,61750
01SCS19E210128,BSC.AR-SC0009,00ARSC0054,L,1,125000,315000,0,0,0,0,0,63000,315000,252000
01SCS19E210128,BSC.AR-SC0013,00ARSC0094,L,1,44000,135000,0,0,0,0,0,27000,135000,108000
01SCS19E210129,AR.MPR-SE020,20ARSE0204,ALL,1,97500,150000,2,0,45000,1,0,26250,105000,78750
01SCS19E210129,ESH.AR-SE0005,00ARSE0019,L,1,44500,135000,0,0,0,0,0,27000,135000,108000
01SCS19E210130,AR.ESB-SE002,20ARSE0242,S,1,204750,315000,2,0,63000,1,0,63000,252000,189000
01SCS19E210130,AR.TUC-SE017,20ARSE0428,L,1,146250,225000,2,0,45000,1,0,45000,180000,135000
01SCS19E210131,AR.TUC-SA004,20ARSA0015,L,1,87750,135000,2,0,27000,1,0,27000,108000,81000
01SCS19E210131,AR.VRS-QK012,20ARSE0315,XL,1,96850,149000,2,0,44700,1,0,26075,104300,78225
01SCS19E210132,AR.TUC-SA002,20ARSA0006,M,1,204750,315000,2,0,63000,1,0,63000,252000,189000
01SCS19E210133,AR.STY-RK003,20ARRK0525,ALL,1,61750,95000,2,0,19000,1,0,19000,76000,57000
01SCS19E210134,AR.PUB-RK012,20ARRK0454,ALL,1,97500,150000,2,0,30000,1,0,30000,120000,90000
01SCS19E210135,AR.TUC-SD023,20ARSD0511,L,1,204750,315000,2,0,63000,1,0,63000,252000,189000
01SCS19E210136,AR.CPT-RE009,20ARRE0702,M,1,204750,315000,2,0,63000,1,0,63000,252000,189000
01SCS19E210137,AR.TUC-SA002,20ARSA0005,S,1,204750,315000,2,0,63000,1,0,63000,252000,189000
01SCS19E210138,ESH.AR-SD0012,00ARSD0079,34,1,145000,375000,0,0,0,0,0,75000,375000,300000
01SCS19E210139,AR.ESB-SD002,20ARSD0100,S,1,74750,115000,2,0,23000,1,0,23000,92000,69000
01SCS19E210140,AR.SMD-SB001,20ARSB0192,M,1,211250,325000,2,0,65000,1,0,65000,260000,195000
01SCS19E210141,AR.PUB-SE004,20ARSE0013,S,1,97500,150000,2,0,30000,1,0,30000,120000,90000
01SCS19E210141,ESH.AR-SE0036,00ARSE0324,S,1,44500,135000,0,0,0,0,0,27000,135000,108000
01SCS19E210142,AR.PUB-SC004,20ARSC0114,ALL,1,48750,75000,2,0,15000,1,0,15000,60000,45000
01SCS19E210142,BSC.AR-SC0045,00ARSC0297,NON,1,45000,150000,0,0,0,0,0,30000,150000,120000
01SCS19E210143,ESH.AR-SD0009,00ARSD0066,M,1,44500,135000,0,0,0,0,0,27000,135000,108000
01SCS19E210144,AR.MPR-SE032,20ARSE0301,L,1,230750,355000,2,0,71000,1,0,71000,284000,213000
01SCS19E210145,AR.ESB-SE008,20ARSE0267,M,1,100750,155000,2,0,31000,1,0,31000,124000,93000
01SCS19E210145,AR.MDG-RJ001,20ARRJ0547,M,1,94250,145000,2,0,43500,1,0,25375,101500,76125
01SCS19E210146,AR.PUB-RL004,20ARRL0120,M,1,97500,150000,2,0,30000,1,0,30000,120000,90000
01SCS19E210147,THR.AR-RK0007,00ARRK0181,L,1,332000,415000,0,0,0,0,0,62250,415000,352750
01SCS19E210148,AR.MKV-SE001,20ARSE0469,28,1,214500,330000,2,0,66000,1,0,66000,264000,198000
01SCS19E210149,BSC.AR-SD0047,00ARSD0247,NON,1,68000,220000,0,0,0,0,0,44000,220000,176000
01SCS19E210150,ESH.AR-SC0002,00ARSC0006,M,1,44500,135000,0,0,0,0,0,27000,135000,108000
01SCS19E210150,ESH.AR-SC0009,00ARSC0076,S,1,44500,135000,0,0,0,0,0,27000,135000,108000
01SCS19E210151,AR.SMD-RH004,20ARRH0416,M,1,87750,135000,2,0,40500,1,0,23625,94500,70875
01SCS19E210152,AR.STY-SE010,20ARSE0576,ALL,1,61750,95000,2,0,19000,1,0,19000,76000,57000
01SCS19E210153,AR.ESB-RH013,20ARRH0482,M,1,87750,135000,2,0,67500,1,0,16875,67500,50625
01SCS19E210154,ESH.AR-SE0005,00ARSE0018,M,1,44500,135000,0,0,0,0,0,27000,135000,108000
01SCS19E210155,BSC.AR-SD0004,00ARSD0014,M,1,44000,159000,0,0,0,0,0,31800,159000,127200
01SCS19E210156,ESH.AR-SD0011,00ARSD0073,S,1,125000,315000,0,0,0,0,0,63000,315000,252000
01SCS19E210157,AR.MER-SB006,20ARSB0230,S,1,97500,150000,2,0,45000,1,0,26250,105000,78750
01SCS19E210158,ESH.AR-SD0027,00ARSD0271,M,1,44000,135000,0,0,0,0,0,27000,135000,108000
01SCS19E210159,BSC.AR-SE0007,00ARSE0082,M,1,44500,159000,0,0,0,0,0,31800,159000,127200
01SCS19E210159,ESH.AR-SE0005,00ARSE0018,M,1,44500,135000,0,0,0,0,0,27000,135000,108000
01SCS19E210160,AR.CPT-SE001,20ARSE0352,S,1,94250,145000,2,0,29000,1,0,29000,116000,87000
01SCS19E210160,BSC.AR-SD0046,00ARSD0243,S,1,44500,159000,0,0,0,0,0,31800,159000,127200
01SCS19E210161,AR.CPT-RE008,20ARRE0700,XL,1,317850,489000,2,0,97800,1,0,97800,391200,293400
01SCS19E220001,ESH.AR-SD0003,00ARSD0043,L,1,44000,135000,0,0,0,0,0,27000,135000,108000
01SCS19E220001,THR.AR-RK0003,00ARRK0167,L,1,332000,415000,0,0,0,0,0,62250,415000,352750
01SCS19E220002,ESH.AR-SE0027,00ARSE0256,M,1,44500,135000,0,0,0,0,0,27000,135000,108000
01SCS19E220003,ESH.AR-SC0034,00ARSC0292,S,1,125000,315000,0,0,0,0,0,63000,315000,252000
01SCS19E220004,BSC.AR-SB0010,00ARSB0093,M,1,125000,315000,0,0,0,0,0,63000,315000,252000
01SCS19E220004,BSC.AR-SB0017,00ARSB0136,S,1,44000,135000,0,0,0,0,0,27000,135000,108000
01SCS19E220004,BSC.AR-SC0009,00ARSC0052,S,1,125000,315000,0,0,0,0,0,63000,315000,252000
01SCS19E220004,BSC.AR-SD0006,00ARSD0021,S,1,44000,159000,0,0,0,0,0,31800,159000,127200
01SCS19E220004,BSC.AR-SE0031,00ARSE0291,S,1,52000,155000,0,0,0,0,0,31000,155000,124000
01SCS19E220005,ESH.AR-SD0028,00ARSD0274,S,1,44500,135000,0,0,0,0,0,27000,135000,108000
01SCS19E220006,AR.PUB-SD011,20ARSD0121,ALL,1,97500,150000,2,0,30000,1,0,30000,120000,90000
01SCS19E220007,AR.CPT-SC014,20ARSC0489,L,1,94250,145000,2,0,29000,1,0,29000,116000,87000
01SCS19E220008,AR.TUC-SD018,20ARSD0491,L,1,94250,145000,2,0,29000,1,0,29000,116000,87000
01SCS19E220009,AR.ESB-SB004,20ARSB0105,M,1,91000,140000,2,0,28000,1,0,28000,112000,84000
01SCS19E220009,AR.MPR-SE010,20ARSE0174,M,1,97500,150000,2,0,45000,1,0,26250,105000,78750
01SCS19E220010,AR.MKV-SE016,20ARSE0595,S,1,22750,350000,2,0,70000,1,0,70000,280000,210000
01SCS19E220011,ESH.AR-SE0037,00ARSE0329,M,1,44000,135000,0,0,0,0,0,27000,135000,108000
01SCS19E220012,AR.PUB-SE034,20ARSE0632,M,1,191750,295000,2,0,59000,1,0,59000,236000,177000
01SCS19E220013,BSC.AR-RJ0012,00ARRJ0085,L,1,44500,135000,0,0,0,0,0,27000,135000,108000
01SCS19E220013,ESH.AR-RH0018,00ARRH0099,S,1,94500,135000,0,0,0,0,0,27000,135000,108000
01SCS19E220014,AR.TUC-SE015,20ARSE0422,XL,1,94250,145000,2,0,29000,1,0,29000,116000,87000
01SCS19E220015,AR.MPR-SE010,20ARSE0173,S,1,97500,150000,2,0,45000,1,0,26250,105000,78750
01SCS19E220015,ESH.AR-SD0005,00ARSD0049,S,1,44000,135000,0,0,0,0,0,27000,135000,108000
01SCS19E220016,AR.CPT-SE004,20ARSE0365,M,1,204750,315000,2,0,63000,1,0,63000,252000,189000
01SCS19E220017,BSC.AR-SD0063,00ARSD0338,NON,1,60000,180000,0,0,0,0,0,36000,180000,144000
01SCS19E220018,AR.MKV-SC005,20ARSC0082,S,1,253500,390000,2,0,78000,1,0,78000,312000,234000
01SCS19E220019,AR.ESB-QJ014,20ARQJ0095,ALL,1,91000,140000,2,0,70000,1,0,17500,70000,52500
01SCS19E220020,AR.MPR-SE010,20ARSE0173,S,1,97500,150000,2,0,45000,1,0,26250,105000,78750
01SCS19E220020,BSC.AR-SE0005,00ARSE0073,S,1,44000,159000,0,0,0,0,0,31800,159000,127200
01SCS19E220021,AR.ESB-SE008,20ARSE0267,M,1,100750,155000,2,0,31000,1,0,31000,124000,93000
01SCS19E220021,AR.MPR-SE008,20ARSE0166,M,1,97500,150000,2,0,45000,1,0,26250,105000,78750
01SCS19E220021,AR.SMD-SA001,20ARSA0220,M,1,87750,135000,2,0,27000,1,0,27000,108000,81000
01SCS19E220021,AR.STY-SE007,20ARSE0125,ALL,1,55250,85000,2,0,17000,1,0,17000,68000,51000
01SCS19E220021,BSC.AR-SA0001,00ARSA0002,M,1,120000,315000,0,0,0,0,0,63000,315000,252000
01SCS19E220022,AR.FHL-SC001,20ARSC0326,S,1,91000,140000,2,0,28000,1,0,28000,112000,84000
01SCS19E220022,AR.PUB-SE021,20ARSE0079,S,1,159250,245000,2,0,49000,1,0,49000,196000,147000
01SCS19E220023,BSC.AR-SC0044,00ARSC0296,NON,1,45000,150000,0,0,0,0,0,30000,150000,120000
01SCS19E220024,AR.TUC-SB001,20ARSB0024,M,1,204750,315000,2,0,63000,1,0,63000,252000,189000
01SCS19E220025,ESH.AR-SE0006,00ARSE0022,M,1,44000,135000,0,0,0,0,0,27000,135000,108000
01SCS19E220026,AR.MKV-SE004,20ARSE0486,32,1,214500,330000,2,0,66000,1,0,66000,264000,198000
01SCS19E220027,AR.CPT-SE006,20ARSE0372,S,1,204750,315000,2,0,63000,1,0,63000,252000,189000
01SCS19E220027,AR.SMD-SD005,20ARSD0293,M,1,87750,135000,2,0,27000,1,0,27000,108000,81000
01SCS19E220027,AR.STY-SA002,20ARSA0061,ALL,1,61750,95000,2,0,19000,1,0,19000,76000,57000
01SCS19E220027,AR.TUC-SE010,20ARSE0400,M,1,94250,145000,2,0,29000,1,0,29000,116000,87000
01SCS19E220028,BSC.AR-SC0035,00ARSC0233,M,1,125000,315000,0,0,0,0,0,63000,315000,252000
01SCS19E220029,AR.TUC-SE015,20ARSE0420,M,1,94250,145000,2,0,29000,1,0,29000,116000,87000
01SCS19E220030,AR.TUC-SE024,20ARSE0656,30,1,204750,315000,2,0,63000,1,0,63000,252000,189000
01SCS19E220030,BSC.AR-SE0033,00ARSE0316,30,1,125400,365000,0,0,0,0,0,73000,365000,292000
01SCS19E220030,ESH.AR-RH0018,00ARRH0100,M,1,94500,135000,0,0,0,0,0,27000,135000,108000
01SCS19E220031,AR.CLB-RI001,20ARRI0159,ALL,1,191750,295000,2,0,59000,1,0,59000,236000,177000
01SCS19E220031,AR.STY-SE008,20ARSE0126,ALL,1,55250,85000,2,0,17000,1,0,17000,68000,51000
01SCS19E220031,AR.TUC-SA031,20ARSA0257,S,1,87750,135000,2,0,27000,1,0,27000,108000,81000
01SCS19E220032,BSC.AR-SC0021,00ARSC0148,NON,1,73000,220000,0,0,0,0,0,44000,220000,176000
01SCS19E220032,ESH.AR-SC0010,00ARSC0081,M,1,44500,135000,0,0,0,0,0,27000,135000,108000
01SCS19E220033,ESH.AR-SB0032,00ARSB0208,S,1,125000,315000,0,0,0,0,0,63000,315000,252000
01SCS19E220034,AR.PUB-SD033,20ARSD0242,S,1,204750,315000,2,0,63000,1,0,63000,252000,189000
01SCS19E220035,BSC.AR-SD0008,00ARSD0033,S,1,44500,159000,0,0,0,0,0,31800,159000,127200
01SCS19E220035,BSC.AR-SD0015,00ARSD0114,S,1,122000,375000,0,0,0,0,0,75000,375000,300000
01SCS19E220035,ESH.AR-SE0025,00ARSE0247,S,1,44500,135000,0,0,0,0,0,27000,135000,108000
01SCS19E220036,ESH.AR-SA0014,00ARSA0101,S,1,44000,135000,0,0,0,0,0,27000,135000,108000
01SCS19E220036,ESH.AR-SD0005,00ARSD0049,S,1,44000,135000,0,0,0,0,0,27000,135000,108000
01SCS19E220037,AR.HLW-SE001,20ARSE0526,ALL,1,71500,110000,0,0,0,0,0,38500,110000,71500
01SCS19E220037,AR.PUB-SE021,20ARSE0080,M,1,159250,245000,2,0,49000,1,0,49000,196000,147000
01SCS19E220038,AR.MKV-SE003,20ARSE0479,28,1,224250,345000,2,0,69000,1,0,69000,276000,207000
01SCS19E220039,ESH.AR-SD0009,00ARSD0066,M,1,44500,135000,0,0,0,0,0,27000,135000,108000
01SCS19E220040,BSC.AR-SB0015,00ARSB0127,S,1,125000,315000,0,0,0,0,0,63000,315000,252000
01SCS19E220040,ESH.AR-SD0026,00ARSD0266,S,1,44500,135000,0,0,0,0,0,27000,135000,108000
01SCS19E220041,BSC.AR-SE0007,00ARSE0081,S,1,44500,159000,0,0,0,0,0,31800,159000,127200
01SCS19E220041,ESH.AR-SE0037,00ARSE0328,S,1,44000,135000,0,0,0,0,0,27000,135000,108000
01SCS19E220042,AR.MKV-SE004,20ARSE0484,28,1,214500,330000,2,0,66000,1,0,66000,264000,198000
01SCS19E220042,AR.MKV-SE025,20ARSE0624,28,1,214500,330000,2,0,66000,1,0,66000,264000,198000
01SCS19E220042,AR.STY-SE004,20ARSE0122,ALL,1,55250,85000,2,0,17000,1,0,17000,68000,51000
01SCS19E220042,AR.STY-SE007,20ARSE0125,ALL,1,55250,85000,2,0,17000,1,0,17000,68000,51000
01SCS19E220043,AR.GTW-SA002,20ARSA0302,XL,1,107250,165000,2,0,49500,1,0,28875,115500,86625
01SCS19E220043,AR.HLW-SC007,20ARSC0137,L,1,120250,185000,2,0,55500,1,0,32375,129500,97125
01SCS19E220043,AR.MPR-SE013,20ARSE0187,L,1,110500,170000,2,0,51000,1,0,29750,119000,89250
01SCS19E220044,AR.TUC-SA018,20ARSA0046,M,1,204750,315000,2,0,63000,1,0,63000,252000,189000
01SCS19E220045,AR.TUC-RH016,20ARRH0688,ALL,1,87750,135000,2,0,27000,1,0,27000,108000,81000
01SCS19E220046,AR.STY-SE004,20ARSE0122,ALL,1,55250,85000,2,0,17000,1,0,17000,68000,51000
01SCS19E220046,BSC.AR-RL0018,00ARRL0110,M,1,125000,315000,0,0,0,0,0,63000,315000,252000
01SCS19E220047,AR.TUC-RH004,20ARRH0666,L,1,204750,315000,2,0,63000,1,0,63000,252000,189000
01SCS19E220048,BSC.AR-SD0045,00ARSD0239,S,1,44500,159000,0,0,0,0,0,31800,159000,127200
01SCS19E220049,AR.STY-SA003,20ARSA0062,ALL,1,61750,95000,2,0,19000,1,0,19000,76000,57000
01SCS19E220050,AR.TUC-SB016,20ARSB0472,XL,1,87750,135000,2,0,27000,1,0,27000,108000,81000
01SCS19E220050,ESH.AR-SB0033,00ARSB0214,L,1,44500,135000,0,0,0,0,0,27000,135000,108000
01SCS19E220051,AR.PUB-RL028,20ARRL0436,ALL,1,97500,150000,2,0,30000,1,0,30000,120000,90000
01SCS19E220052,AR.SMD-RI005,20ARRI0325,L,1,87750,135000,2,0,40500,1,0,23625,94500,70875
01SCS19E220052,AR.SMD-RI007,20ARRI0331,L,1,87750,135000,2,0,40500,1,0,23625,94500,70875
01SCS19E220053,AR.CPT-SC010,20ARSC0472,M,1,204750,315000,2,0,63000,1,0,63000,252000,189000
01SCS19E220054,AR.ASH-RK005,20ARRK0522,XL,1,227500,350000,2,0,105000,1,0,61250,245000,183750
01SCS19E220054,AR.TUC-SE020,20ARSE0639,S,1,204750,315000,2,0,63000,1,0,63000,252000,189000
01SCS19E220054,ESH.AR-RK0005,00ARRK0021,S,1,94500,135000,0,0,0,0,0,27000,135000,108000
01SCS19E220055,AR.SMD-SD018,20ARSD0580,ALL,1,97500,150000,2,0,30000,1,0,30000,120000,90000
01SCS19E220055,ESH.AR-SB0022,00ARSB0124,M,1,44000,135000,0,0,0,0,0,27000,135000,108000
01SCS19E220056,ESH.AR-SD0005,00ARSD0052,XL,1,44000,135000,0,0,0,0,0,27000,135000,108000
01SCS19E220056,ESH.AR-SD0010,00ARSD0072,XL,1,44500,135000,0,0,0,0,0,27000,135000,108000
01SCS19E220057,ESH.AR-SD0021,00ARSD0165,M,1,125000,315000,0,0,0,0,0,63000,315000,252000
01SCS19E220058,AR.HLW-SE013,20ARSE0558,S,1,100750,155000,0,0,0,0,0,54250,155000,100750
01SCS19E220058,AR.MKV-SC010,20ARSC0104,L,1,97500,150000,2,0,30000,1,0,30000,120000,90000
01SCS19E220058,BSC.AR-SD0008,00ARSD0033,S,1,44500,159000,0,0,0,0,0,31800,159000,127200
01SCS19E220059,BSC.AR-SD0063,00ARSD0338,NON,1,60000,180000,0,0,0,0,0,36000,180000,144000
01SCS19E220060,AR.TUC-SE006,20ARSE0384,M,1,204750,315000,2,0,63000,1,0,63000,252000,189000
01SCS19E220061,AR.SMD-RI006,20ARRI0328,L,1,87750,135000,2,0,40500,1,0,23625,94500,70875
01SCS19E220062,AR.TUC-SA028,20ARSA0163,ALL,1,100750,155000,2,0,31000,1,0,31000,124000,93000
01SCS19E220063,ESH.AR-RK0007,00ARRK0030,M,1,94500,135000,0,0,0,0,0,27000,135000,108000
01SCS19E220064,AR.PUB-RE051,20ARRE0594,S,1,204750,315000,2,0,63000,1,0,63000,252000,189000
01SCS19E220065,AR.TUC-SD014,20ARSD0476,XL,1,94250,145000,2,0,29000,1,0,29000,116000,87000
01SCS19E220065,ESH.AR-SB0008,00ARSB0031,30,1,90400,275000,0,0,0,0,0,55000,275000,220000
01SCS19E220066,AR.CPT-QL011,20ARQL0168,L,1,204750,315000,2,0,63000,1,0,63000,252000,189000
01SCS19E220067,AR.PUB-SB026,20ARSB0137,M,1,97500,150000,2,0,30000,1,0,30000,120000,90000
01SCS19E220067,AR.PUB-SE028,20ARSE0108,M,1,204750,315000,2,0,63000,1,0,63000,252000,189000
01SCS19E220067,AR.TUC-SE005,20ARSE0380,M,1,204750,315000,2,0,63000,1,0,63000,252000,189000
01SCS19E220068,BSC.AR-RL0025,00ARRL0168,L,1,94500,135000,0,0,0,0,0,27000,135000,108000
01SCS19E220068,ESH.AR-SB0021,00ARSB0121,L,1,44500,135000,0,0,0,0,0,27000,135000,108000
01SCS19E220069,AR.STY-RE007,20ARRE0120,ALL,1,61750,95000,2,0,19000,1,0,19000,76000,57000
01SCS19E220070,AR.PUB-SE027,20ARSE0103,S,1,204750,315000,2,0,63000,1,0,63000,252000,189000
01SCS19E220071,AR.STY-RE007,20ARRE0120,ALL,1,61750,95000,2,0,19000,1,0,19000,76000,57000
01SCS19E220071,AR.STY-RK003,20ARRK0525,ALL,1,61750,95000,2,0,19000,1,0,19000,76000,57000
01SCS19E220071,AR.STY-RK005,20ARRK0527,ALL,1,61750,95000,2,0,19000,1,0,19000,76000,57000
01SCS19E220071,AR.STY-RK006,20ARRK0528,ALL,1,61750,95000,2,0,19000,1,0,19000,76000,57000
01SCS19E220072,AR.TUC-SD002,20ARSD0145,M,1,204750,315000,2,0,63000,1,0,63000,252000,189000
01SCS19E220073,AR.CPT-RH012,20ARRH0885,M,1,94250,145000,2,0,29000,1,0,29000,116000,87000
01SCS19E220073,AR.PUB-SD001,20ARSD0082,M,1,204750,315000,2,0,63000,1,0,63000,252000,189000
01SCS19E220074,AR.PUB-SE026,20ARSE0099,S,1,204750,315000,2,0,63000,1,0,63000,252000,189000
01SCS19E220075,BSC.AR-SD0002,00ARSD0006,M,1,44000,159000,0,0,0,0,0,31800,159000,127200
01SCS19E220075,BSC.AR-SD0022,00ARSD0129,M,1,44000,159000,0,0,0,0,0,31800,159000,127200
01SCS19E220076,AR.HLW-SC004,20ARSC0128,L,1,195000,300000,2,0,90000,1,0,52500,210000,157500
01SCS19E220077,AR.MPR-SE032,20ARSE0299,S,1,230750,355000,2,0,71000,1,0,71000,284000,213000
01SCS19E220078,AR.STY-SE005,20ARSE0123,ALL,1,55250,85000,2,0,17000,1,0,17000,68000,51000
01SCS19E220079,AR.STY-SE009,20ARSE0127,ALL,1,55250,85000,2,0,17000,1,0,17000,68000,51000
01SCS19E220080,BSC.AR-SE0003,00ARSE0065,S,1,44000,159000,0,0,0,0,0,31800,159000,127200
01SCS19E220080,ESH.AR-SA0014,00ARSA0101,S,1,44000,135000,0,0,0,0,0,27000,135000,108000
01SCS19E220081,ESH.AR-SD0038,00ARSD0345,L,1,122500,350000,0,0,0,0,0,70000,350000,280000
01SCS19E220082,AR.YD-SC001,20ARSC0019,L,1,195000,300000,2,0,90000,1,0,52500,210000,157500
01SCS19E220083,AR.MKV-RJ005,20ARRJ0162,L,1,91000,140000,2,0,28000,1,0,28000,112000,84000
01SCS19E220083,ESH.AR-SE0029,00ARSE0264,M,1,44500,135000,0,0,0,0,0,27000,135000,108000
01SCS19E220084,AR.MDG-RL001,20ARRL0285,ALL,1,68250,105000,2,0,31500,1,0,18375,73500,55125
01SCS19E220085,AR.MPR-SE033,20ARSE0303,S,1,230750,355000,2,0,71000,1,0,71000,284000,213000
01SCS19E220086,ESH.AR-SB0007,00ARSB0027,S,1,44000,135000,0,0,0,0,0,27000,135000,108000
01SCS19E220086,ESH.AR-SC0021,00ARSC0158,M,1,44000,135000,0,0,0,0,0,27000,135000,108000
01SCS19E220087,BE.RAK-RX355,00BERX1305,M,1,91000,140000,2,0,28000,1,0,28000,112000,84000
01SCS19E220088,ESH.AR-SE0037,00ARSE0331,XL,1,44000,135000,0,0,0,0,0,27000,135000,108000
01SCS19E220089,AR.HMR-SD007,20ARSD0545,M,1,243750,375000,2,0,75000,1,0,75000,300000,225000
01SCS19E220090,BE.RAK-SB036,00BESB0111,L,1,91000,140000,2,0,28000,1,0,28000,112000,84000
01SCS19E220091,BE.RAK-RX328,00BERX1168,M,1,91000,140000,2,0,28000,1,0,28000,112000,84000
01SCS19E220092,AR.PUB-SB040,20ARSB0526,L,1,204750,315000,2,0,63000,1,0,63000,252000,189000
01SCS19E220093,AR.RDC-RL001,20ARRL0203,M,1,120250,185000,2,0,37000,1,0,37000,148000,111000
01SCS19E220094,AR.MKV-SE021,20ARSE0611,S,1,97500,150000,2,0,30000,1,0,30000,120000,90000
01SCS19E220095,AR.ASH-RJ005,20ARRJ0265,M,1,91000,140000,2,0,42000,1,0,24500,98000,73500
01SCS19E220095,AR.ASH-RJ010,20ARRJ0486,S,1,91000,140000,2,0,42000,1,0,24500,98000,73500
01SCS19E220095,AR.HLW-SE012,20ARSE0556,M,1,100750,155000,0,0,0,0,0,54250,155000,100750
01SCS19E220095,AR.PUB-RJ041,20ARRJ0514,M,1,97500,150000,2,0,30000,1,0,30000,120000,90000
01SCS19E220095,AR.PUB-RJ044,20ARRJ0526,M,1,97500,150000,2,0,30000,1,0,30000,120000,90000
01SCS19E220095,AR.PUB-SB024,20ARSB0128,S,1,97500,150000,2,0,30000,1,0,30000,120000,90000
01SCS19E220095,DKS.AR-SE0010,00ARSE0166,30,1,417272,696000,0,0,0,0,0,104400,696000,591600
01SCS19E220096,ESH.AR-RK0015,00ARRK0191,NON,1,43000,150000,0,0,0,0,0,30000,150000,120000
01SCS19E220096,ESH.AR-SD0004,00ARSD0045,S,1,44500,135000,0,0,0,0,0,27000,135000,108000
01SCS19E220097,AR.STY-SA002,20ARSA0061,ALL,1,61750,95000,2,0,19000,1,0,19000,76000,57000
01SCS19E220097,BSC.AR-RL0028,00ARRL0179,M,1,94500,135000,0,0,0,0,0,27000,135000,108000
01SCS19E220098,AR.TUC-SE014,20ARSE0417,L,1,94250,145000,2,0,29000,1,0,29000,116000,87000
01SCS19E220099,AR.MKV-RJ021,20ARSC0068,28,1,117000,180000,2,0,36000,1,0,36000,144000,108000
01SCS19E220100,AR.CPT-SD006,20ARSD0433,S,1,200850,309000,2,0,61800,1,0,61800,247200,185400
01SCS19E220100,ESH.AR-SD0043,00ARSD0394,S,1,125000,315000,0,0,0,0,0,63000,315000,252000
01SCS19E220101,AR.MKV-RJ003,20ARRJ0151,M,1,91000,140000,2,0,28000,1,0,28000,112000,84000
01SCS19E220102,AR.MKV-SA007,20ARSA0202,34,1,243750,375000,2,0,75000,1,0,75000,300000,225000
01SCS19E220103,AR.MKV-SB012,20ARSB0544,M,1,172250,265000,2,0,53000,1,0,53000,212000,159000
01SCS19E220103,AR.TUC-SA002,20ARSA0006,M,1,204750,315000,2,0,63000,1,0,63000,252000,189000
01SCS19E220104,AR.TUC-SE009,20ARSE0396,S,1,204750,315000,2,0,63000,1,0,63000,252000,189000
01SCS19E220104,ESH.AR-SD0006,00ARSD0053,S,1,44500,135000,0,0,0,0,0,27000,135000,108000
01SCS19E220104,ESH.AR-SE0027,00ARSE0255,S,1,44500,135000,0,0,0,0,0,27000,135000,108000
01SCS19E220105,AR.STY-SA013,20ARSA0072,ALL,1,55250,85000,2,0,17000,1,0,17000,68000,51000
01SCS19E220105,AR.STY-SE002,20ARSE0120,ALL,1,55250,85000,2,0,17000,1,0,17000,68000,51000
01SCS19E220106,ESH.AR-SD0024,00ARSD0260,L,1,44500,135000,0,0,0,0,0,27000,135000,108000
01SCS19E220107,AR.TUC-SE006,20ARSE0384,M,1,204750,315000,2,0,63000,1,0,63000,252000,189000
01SCS19E220108,AR.ESB-SE008,20ARSE0267,M,1,100750,155000,2,0,31000,1,0,31000,124000,93000
01SCS19E220108,AR.STY-RL001,20ARRL0392,ALL,1,61750,95000,2,0,19000,1,0,19000,76000,57000
01SCS19E220108,ESH.AR-SC0009,00ARSC0076,S,1,44500,135000,0,0,0,0,0,27000,135000,108000
01SCS19E220109,AR.MKV-SC005,20ARSC0082,S,1,253500,390000,2,0,78000,1,0,78000,312000,234000
01SCS19E220110,AR.FHL-SC001,20ARSC0327,M,1,91000,140000,2,0,28000,1,0,28000,112000,84000
01SCS19E220110,AR.MKV-SE019,20ARSE0606,M,1,97500,150000,2,0,30000,1,0,30000,120000,90000
01SCS19E220111,AR.YRX-RH003,20ARRH0720,ALL,1,172250,265000,2,0,53000,1,0,53000,212000,159000
01SCS19E220111,ESH.AR-SD0026,00ARSD0266,S,1,44500,135000,0,0,0,0,0,27000,135000,108000
01SCS19E220112,AR.CPT-RE010,20ARRE0706,M,1,204750,315000,2,0,63000,1,0,63000,252000,189000
01SCS19E220112,AR.TUC-SE005,20ARSE0380,M,1,204750,315000,2,0,63000,1,0,63000,252000,189000
01SCS19E220113,AR.SMD-QD004,20ARQD0096,M,1,84500,130000,2,0,39000,1,0,22750,91000,68250
01SCS19E220113,AR.SMD-RE005,20ARRE0777,L,1,100750,155000,2,0,46500,1,0,27125,108500,81375
01SCS19E220113,AR.STY-SE004,20ARSE0122,ALL,1,55250,85000,2,0,17000,1,0,17000,68000,51000
01SCS19E220114,ESH.AR-SA0008,00ARSA0084,M,1,113450,350000,0,0,0,0,0,70000,350000,280000
01SCS19E220115,AR.GTW-SA003,20ARSA0305,L,1,94250,145000,2,0,43500,1,0,25375,101500,76125
01SCS19E220115,AR.HLW-SE012,20ARSE0557,L,1,100750,155000,0,0,0,0,0,54250,155000,100750
01SCS19E220115,BSC.AR-RI0024,00ARRI0133,NON,1,43000,140000,0,0,0,0,0,28000,140000,112000
01SCS19E220116,BSC.AR-SB0007,00ARSB0075,M,1,44500,135000,0,0,0,0,0,27000,135000,108000
01SCS19E220116,ESH.AR-SE0009,00ARSE0035,L,1,44500,135000,0,0,0,0,0,27000,135000,108000
01SCS19E220117,ESH.AR-SA0017,00ARSA0117,M,1,122500,350000,0,0,0,0,0,70000,350000,280000
01SCS19E220118,AR.TUC-SB021,20ARSB0485,ALL,1,87750,135000,2,0,27000,1,0,27000,108000,81000
01SCS19E220119,ESH.AR-SC0032,00ARSC0281,M,1,44500,135000,0,0,0,0,0,27000,135000,108000
01SCS19E220120,AR.PUB-SE032,20ARSE0327,L,1,204750,315000,2,0,63000,1,0,63000,252000,189000
01SCS19E220121,AR.HLW-SC003,20ARSC0125,L,1,208000,320000,2,0,96000,1,0,56000,224000,168000
01SCS19E220121,AR.TUC-SA028,20ARSA0163,ALL,1,100750,155000,2,0,31000,1,0,31000,124000,93000
01SCS19E220121,ARN.AR-SB0001,00ARSB0086,NON,1,107400,179000,0,0,0,0,0,53700,179000,125300
01SCS19E220121,ESH.AR-SD0021,00ARSD0165,M,1,125000,315000,0,0,0,0,0,63000,315000,252000
01SCS19E220122,AR.ESB-SC005,20ARSC0427,M,1,94250,145000,2,0,29000,1,0,29000,116000,87000
01SCS19E220122,AR.HMR-SB024,20ARSB0411,32,1,211250,325000,2,0,65000,1,0,65000,260000,195000
01SCS19E220123,AR.CPT-RK005,20ARRK0021,ALL,1,77350,119000,2,0,23800,1,0,23800,95200,71400
01SCS19E220123,AR.STY-SE008,20ARSE0126,ALL,1,55250,85000,2,0,17000,1,0,17000,68000,51000
01SCS19E220124,AR.MKV-SC005,20ARSC0083,M,1,253500,390000,2,0,78000,1,0,78000,312000,234000
01SCS19E220125,AR.PCT-RK001,20ARRK0249,ALL,1,178750,275000,2,0,55000,1,0,55000,220000,165000
01SCS19E220126,AR.PUB-SE028,20ARSE0108,M,1,204750,315000,2,0,63000,1,0,63000,252000,189000
01SCS19E220127,AR.TUC-SE020,20ARSE0639,S,1,204750,315000,2,0,63000,1,0,63000,252000,189000
01SCS19E220127,ESH.AR-RJ0002,00ARRJ0015,S,1,44500,135000,0,0,0,0,0,27000,135000,108000
01SCS19E220127,ESH.AR-SE0003,00ARSE0009,S,1,44500,135000,0,0,0,0,0,27000,135000,108000
01SCS19E220128,AR.CPT-SC012,20ARSC0481,L,1,204750,315000,2,0,63000,1,0,63000,252000,189000
01SCS19E220128,AR.MPR-SE020,20ARSE0204,ALL,1,97500,150000,2,0,45000,1,0,26250,105000,78750
01SCS19E220128,AR.TUC-SA035,20ARSA0267,ALL,1,87750,135000,2,0,27000,1,0,27000,108000,81000
01SCS19E220129,AR.VLD-SA001,20ARSA0166,M,1,211250,325000,2,0,97500,1,0,56875,227500,170625
01SCS19E220130,AR.MKV-SA002,20ARSA0188,ALL,1,87750,135000,2,0,27000,1,0,27000,108000,81000
01SCS19E220130,AR.MPR-SE036,20ARSE0312,ALL,1,211250,325000,2,0,65000,1,0,65000,260000,195000
01SCS19E220130,AR.SMD-SD012,20ARSD0567,L,1,87750,135000,2,0,27000,1,0,27000,108000,81000
01SCS19E220131,AR.CPT-SD005,20ARSD0432,ALL,1,94250,145000,2,0,29000,1,0,29000,116000,87000
01SCS19E220132,AR.SMD-SD007,20ARSD0301,M,1,211250,325000,2,0,65000,1,0,65000,260000,195000
01SCS19E220133,AR.STY-SE009,20ARSE0127,ALL,1,55250,85000,2,0,17000,1,0,17000,68000,51000
01SCS19E220134,AR.PUB-SE029,20ARSE0113,L,1,224250,345000,2,0,69000,1,0,69000,276000,207000
01SCS19E220135,AR.FHL-SC005,20ARSC0345,XL,1,110500,170000,2,0,34000,1,0,34000,136000,102000
01SCS19E220135,AR.TUC-SD008,20ARSD0168,ALL,1,81250,125000,2,0,25000,1,0,25000,100000,75000
01SCS19E220136,ESH.AR-RH0008,00ARRH0060,NON,1,45000,150000,0,0,0,0,0,30000,150000,120000
01SCS19E220137,DKS.AR-SE0009,00ARSE0164,36,1,417272,696000,0,0,0,0,0,104400,696000,591600
01SCS19E220138,AR.TUC-SE006,20ARSE0384,M,1,204750,315000,2,0,63000,1,0,63000,252000,189000
01SCS19E220139,AR.ESB-RL005,20ARRL0256,L,1,71500,110000,2,0,22000,1,0,22000,88000,66000
01SCS19E220140,AR.CPT-SC009,20ARSC0273,M,1,94250,145000,2,0,29000,1,0,29000,116000,87000
01SCS19E220140,AR.SMD-QK001,20ARQK0357,S,1,243750,375000,2,0,112500,1,0,65625,262500,196875
01SCS19E220141,BSC.AR-RJ0019,00ARRJ0111,S,1,94500,135000,0,0,0,0,0,27000,135000,108000
01SCS19E220142,AR.STY-SE002,20ARSE0120,ALL,1,55250,85000,2,0,17000,1,0,17000,68000,51000
01SCS19E220143,AR.PUB-SD033,20ARSD0242,S,1,204750,315000,2,0,63000,1,0,63000,252000,189000
01SCS19E220143,ESH.AR-SA0014,00ARSA0101,S,1,44000,135000,0,0,0,0,0,27000,135000,108000
01SCS19E220144,ESH.AR-RH0018,00ARRH0100,M,1,94500,135000,0,0,0,0,0,27000,135000,108000
01SCS19E220145,ESH.AR-RJ0003,00ARRJ0020,M,1,43000,135000,0,0,0,0,0,27000,135000,108000
01SCS19E220146,AR.PUB-SE033,20ARSE0629,S,1,97500,150000,2,0,30000,1,0,30000,120000,90000
01SCS19E220147,AR.TUC-SE011,20ARSE0404,M,1,94250,145000,2,0,29000,1,0,29000,116000,87000
01SCS19E220148,AR.MPR-SE027,20ARSE0228,L,1,243750,375000,2,0,75000,1,0,75000,300000,225000
01SCS19E220149,BSC.AR-RK0007,00ARRK0074,M,1,52000,155000,0,0,0,0,0,31000,155000,124000
01SCS19E220149,BSC.AR-SC0003,00ARSC0025,NON,1,73000,220000,0,0,0,0,0,44000,220000,176000
01SCS19E220149,BSC.AR-SD0063,00ARSD0338,NON,1,60000,180000,0,0,0,0,0,36000,180000,144000
01SCS19E220150,AR.ASH-RJ013,20ARRJ0496,M,1,94250,145000,2,0,43500,1,0,25375,101500,76125
01SCS19E220150,AR.RDC-RK012,20ARRK0502,ALL,1,140400,185000,2,0,37000,1,0,37000,148000,111000
01SCS19E220150,AR.TUC-RL013,20ARRL0337,ALL,1,87750,135000,2,0,27000,1,0,27000,108000,81000
01SCS19E220151,AR.TRF-RJ013,20ARRJ0097,ALL,1,91000,140000,2,0,42000,1,0,24500,98000,73500
01SCS19E220151,AR.TUC-SA002,20ARSA0006,M,1,204750,315000,2,0,63000,1,0,63000,252000,189000
01SCS19E220152,AR.TUC-SE009,20ARSE0397,M,1,204750,315000,2,0,63000,1,0,63000,252000,189000
01SCS19E220153,AR.YD-RL009,20ARRL0025,ALL,1,55250,85000,2,0,25500,1,0,14875,59500,44625
01SCS19E220154,BSC.AR-SD0058,00ARSD0294,NON,1,50000,150000,0,0,0,0,0,30000,150000,120000
01SCS19E220155,AR.TUC-SD007,20ARSD0165,M,1,185250,285000,2,0,57000,1,0,57000,228000,171000
01SCS19E220156,AR.HLW-SE021,20ARSE0571,M,1,217750,335000,0,0,0,0,0,117250,335000,217750
01SCS19E220156,BSC.AR-SD0025,00ARSD0149,M,1,44500,159000,0,0,0,0,0,31800,159000,127200
01SCS19E220157,AR.MPR-SE008,20ARSE0165,S,1,97500,150000,2,0,45000,1,0,26250,105000,78750
01SCS19E220158,BSC.AR-RI0015,00ARRI0056,L,1,43000,135000,0,0,0,0,0,27000,135000,108000
01SCS19E220159,ESH.AR-SD0021,00ARSD0165,M,1,125000,315000,0,0,0,0,0,63000,315000,252000
01SCS19E220160,ESH.AR-RK0009,00ARRK0037,S,1,44500,135000,0,0,0,0,0,27000,135000,108000
01SCS19E220161,AR.PUB-RL014,20ARRL0159,M,1,191750,295000,2,0,59000,1,0,59000,236000,177000
01SCS19E220162,AR.TUC-SE014,20ARSE0417,L,1,94250,145000,2,0,29000,1,0,29000,116000,87000
01SCS19E220163,BSC.AR-RK0012,00ARRK0094,M,1,43000,135000,0,0,0,0,0,27000,135000,108000
01SCS19E220164,ESH.AR-SD0021,00ARSD0165,M,1,125000,315000,0,0,0,0,0,63000,315000,252000
01SCS19E220165,AR.FHL-SC001,20ARSC0327,M,1,91000,140000,2,0,28000,1,0,28000,112000,84000
01SCS19E220165,AR.PUB-RL004,20ARRL0120,M,1,97500,150000,2,0,30000,1,0,30000,120000,90000
01SCS19E220166,BSC.AR-SD0004,00ARSD0014,M,1,44000,159000,0,0,0,0,0,31800,159000,127200
01SCS19E220167,ESH.AR-SB0021,00ARSB0119,S,1,44500,135000,0,0,0,0,0,27000,135000,108000
01SCS19E220168,AR.MKV-QE005,20ARQE0162,30,1,234000,360000,2,0,180000,1,0,45000,180000,135000
01SCS19E220169,AR.MKV-SC021,20ARSC0230,M,1,107250,165000,2,0,33000,1,0,33000,132000,99000
01SCS19E220170,ESH.AR-RI0018,00ARRI0146,NON,1,39000,140000,0,0,0,0,0,28000,140000,112000
01SCS19E220171,ESH.AR-RH0004,00ARRH0039,L,1,94500,135000,0,0,0,0,0,27000,135000,108000
01SCS19E220172,ESH.AR-SC0022,00ARSC0161,S,1,125000,315000,0,0,0,0,0,63000,315000,252000
01SCS19E220173,AR.FHL-SC006,20ARSC0348,L,1,110500,170000,2,0,34000,1,0,34000,136000,102000
01SCS19E220173,BSC.AR-SC0017,00ARSC0118,L,1,44500,135000,0,0,0,0,0,27000,135000,108000
01SCS19E220174,BSC.AR-SD0004,00ARSD0015,L,1,44000,159000,0,0,0,0,0,31800,159000,127200
01SCS19E220175,BE.RAK-RK013,00BERK0042,L,1,256750,395000,2,0,79000,1,0,79000,316000,237000
01SCS19E220175,ESH.AR-RI0008,00ARRI0100,L,1,94500,135000,0,0,0,0,0,27000,135000,108000
01SCS19E220176,AR.SMD-SD012,20ARSD0567,L,1,87750,135000,2,0,27000,1,0,27000,108000,81000
01SCS19E230001,AR.MKV-SC005,20ARSC0083,M,1,253500,390000,2,0,78000,1,0,78000,312000,234000
01SCS19E230001,AR.TUC-SA031,20ARSA0259,L,1,87750,135000,2,0,27000,1,0,27000,108000,81000
01SCS19E230001,AR.TUC-SE024,20ARSE0656,30,1,204750,315000,2,0,63000,1,0,63000,252000,189000
01SCS19E230002,AR.MKV-SE014,20ARSE0587,S,1,22750,350000,2,0,70000,1,0,70000,280000,210000
01SCS19E230003,AR.TUC-SE005,20ARSE0379,S,1,204750,315000,2,0,63000,1,0,63000,252000,189000
01SCS19E230004,BSC.AR-SD0046,00ARSD0244,M,1,44500,159000,0,0,0,0,0,31800,159000,127200
01SCS19E230005,AR.ESB-RB002,20ARRB0336,M,1,84500,130000,2,0,65000,1,0,16250,65000,48750
01SCS19E230006,AR.MKV-PL011,20ARPL0431,M,1,91000,140000,2,0,70000,1,0,17500,70000,52500
01SCS19E230007,AR.CPT-SE003,20ARSE0361,M,1,94250,145000,2,0,29000,1,0,29000,116000,87000
01SCS19E230007,AR.PUB-SB030,20ARSB0455,XL,1,97500,150000,2,0,30000,1,0,30000,120000,90000
01SCS19E230008,AR.TUC-SD017,20ARSD0488,XL,1,94250,145000,2,0,29000,1,0,29000,116000,87000
01SCS19E230008,ESH.AR-SE0017,00ARSE0113,S,1,44000,135000,0,0,0,0,0,27000,135000,108000
01SCS19E230009,AR.STY-RE007,20ARRE0120,ALL,1,61750,95000,2,0,19000,1,0,19000,76000,57000
01SCS19E230010,AR.PUB-SE007,20ARSE0027,L,1,97500,150000,2,0,30000,1,0,30000,120000,90000
01SCS19E230011,BSC.AR-RH0018,00ARRH0080,L,1,120000,315000,0,0,0,0,0,63000,315000,252000
01SCS19E230012,AR.TUC-SE006,20ARSE0385,L,1,204750,315000,2,0,63000,1,0,63000,252000,189000
01SCS19E230012,BSC.AR-SC0029,00ARSC0201,L,1,125000,315000,0,0,0,0,0,63000,315000,252000
01SCS19E230013,BSC.AR-SB0011,00ARSB0097,M,1,44500,135000,0,0,0,0,0,27000,135000,108000
01SCS19E230014,ESH.AR-SD0010,00ARSD0070,M,1,44500,135000,0,0,0,0,0,27000,135000,108000
01SCS19E230015,AR.SMD-RH003,20ARRH0399,M,1,211250,325000,2,0,97500,1,0,56875,227500,170625
01SCS19E230016,BSC.AR-SC0050,00ARSC0315,XL,1,44000,159000,0,0,0,0,0,31800,159000,127200
01SCS19E230017,ESH.AR-SE0027,00ARSE0257,L,1,44500,135000,0,0,0,0,0,27000,135000,108000
01SCS19E230018,AR.CPT-RE010,20ARRE0706,M,1,204750,315000,2,0,63000,1,0,63000,252000,189000
01SCS19E230019,AR.MER-SB002,20ARSB0215,S,1,97500,150000,2,0,45000,1,0,26250,105000,78750
01SCS19E230019,AR.MPR-SB010,20ARSB0272,L,1,97500,150000,2,0,45000,1,0,26250,105000,78750
01SCS19E230019,BSC.AR-RI0011,00ARRI0038,S,1,43000,135000,0,0,0,0,0,27000,135000,108000
01SCS19E230019,BSC.AR-SE0003,00ARSE0067,L,1,44000,159000,0,0,0,0,0,31800,159000,127200
01SCS19E230020,AR.ASH-RJ012,20ARRJ0492,S,1,94250,145000,2,0,43500,1,0,25375,101500,76125
01SCS19E230020,AR.ESB-SD012,20ARSD0322,S,1,91000,140000,2,0,28000,1,0,28000,112000,84000
01SCS19E230020,AR.HMR-SB032,20ARSB0445,30,1,204750,315000,2,0,63000,1,0,63000,252000,189000
01SCS19E230021,ESH.AR-SD0016,00ARSD0096,L,1,106400,350000,0,0,0,0,0,70000,350000,280000
01SCS19E230022,AR.ASH-RJ005,20ARRJ0265,M,1,91000,140000,2,0,42000,1,0,24500,98000,73500
01SCS19E230022,AR.HMR-SB007,20ARSB0360,S,1,83850,129000,2,0,25800,1,0,25800,103200,77400
01SCS19E230022,AR.MER-SB004,20ARSB0223,M,1,97500,150000,2,0,45000,1,0,26250,105000,78750
01SCS19E230022,AR.PUB-SC015,20ARSC0361,M,1,97500,150000,2,0,30000,1,0,30000,120000,90000
01SCS19E230023,AR.MPR-SE020,20ARSE0204,ALL,1,97500,150000,2,0,45000,1,0,26250,105000,78750
01SCS19E230023,AR.MPR-SE023,20ARSE0210,S,1,230750,355000,2,0,71000,1,0,71000,284000,213000
01SCS19E230024,AR.PCT-RE013,20ARRE1441,L,1,81250,125000,2,0,62500,1,0,15625,62500,46875
01SCS19E230024,AR.TUC-SC005,20ARSC0061,30,1,185250,285000,2,0,57000,1,0,57000,228000,171000
01SCS19E230025,BSC.AR-SD0009,00ARSD0099,S,1,44000,159000,0,0,0,0,0,31800,159000,127200
01SCS19E230025,ESH.AR-SE0005,00ARSE0017,S,1,44500,135000,0,0,0,0,0,27000,135000,108000
01SCS19E230026,AR.STY-SE004,20ARSE0122,ALL,1,55250,85000,2,0,17000,1,0,17000,68000,51000
01SCS19E230027,AR.TUC-SA027,20ARSA0162,ALL,1,100750,155000,2,0,31000,1,0,31000,124000,93000
01SCS19E230028,AR.MDS-RE009,20ARRE0661,S,1,126750,195000,2,0,39000,1,0,39000,156000,117000
01SCS19E230028,AR.MKV-SE021,20ARSE0611,S,1,97500,150000,2,0,30000,1,0,30000,120000,90000
01SCS19E230028,AR.PUB-SD031,20ARSD0213,28,1,211250,325000,2,0,65000,1,0,65000,260000,195000
01SCS19E230028,BSC.AR-RK0007,00ARRK0073,S,1,52000,155000,0,0,0,0,0,31000,155000,124000
01SCS19E230029,AR.TUC-SE011,20ARSE0404,M,1,94250,145000,2,0,29000,1,0,29000,116000,87000
01SCS19E230029,ESH.AR-RI0009,00ARRI0104,L,1,94500,135000,0,0,0,0,0,27000,135000,108000
01SCS19E230030,BE.RAK-SA027,00BESA0112,M,1,104000,160000,2,0,32000,1,0,32000,128000,96000
01SCS19E230030,ESH.AR-SD0019,00ARSD0141,M,1,125000,315000,0,0,0,0,0,63000,315000,252000
01SCS19E230031,AR.MKV-SE021,20ARSE0612,M,1,97500,150000,2,0,30000,1,0,30000,120000,90000
01SCS19E230032,ESH.AR-SE0005,00ARSE0017,S,1,44500,135000,0,0,0,0,0,27000,135000,108000
01SCS19E230033,ESH.AR-SE0011,00ARSE0041,S,1,44500,135000,0,0,0,0,0,27000,135000,108000
01SCS19E230033,ESH.AR-SE0027,00ARSE0255,S,1,44500,135000,0,0,0,0,0,27000,135000,108000
01SCS19E230034,AR.MPR-SE015,20ARSE0193,S,1,256750,395000,2,0,79000,1,0,79000,316000,237000
01SCS19E230035,AR.VRS-QJ008,20ARQJ0343,L,1,96850,149000,2,0,44700,1,0,26075,104300,78225
01SCS19E230036,AR.SMD-SD017,20ARSD0579,ALL,1,97500,150000,2,0,30000,1,0,30000,120000,90000
01SCS19E230037,AR.MKV-SA004,20ARSA0190,ALL,1,87750,135000,2,0,27000,1,0,27000,108000,81000
01SCS19E230038,AR.TUC-SE024,20ARSE0655,28,1,204750,315000,2,0,63000,1,0,63000,252000,189000
01SCS19E230039,ESH.AR-RD0006,00ARRD0053,NON,1,37500,115000,0,0,0,0,0,23000,115000,92000
01SCS19E230040,AR.MKV-SE019,20ARSE0606,M,1,97500,150000,2,0,30000,1,0,30000,120000,90000
01SCS19E230041,AR.TUC-SB019,20ARSB0481,M,1,87750,135000,2,0,27000,1,0,27000,108000,81000
01SCS19E230042,AR.MPR-SE008,20ARSE0166,M,1,97500,150000,2,0,45000,1,0,26250,105000,78750
01SCS19E230042,AR.PUB-SB026,20ARSB0138,L,1,97500,150000,2,0,30000,1,0,30000,120000,90000
01SCS19E230043,ESH.AR-SC0037,00ARSC0302,NON,1,40000,140000,0,0,0,0,0,28000,140000,112000
01SCS19E230044,AR.CPT-SD005,20ARSD0432,ALL,1,94250,145000,2,0,29000,1,0,29000,116000,87000
01SCS19E230045,BSC.AR-RI0015,00ARRI0056,L,1,43000,135000,0,0,0,0,0,27000,135000,108000
01SCS19E230046,AR.TUC-SE011,20ARSE0406,XL,1,94250,145000,2,0,29000,1,0,29000,116000,87000
01SCS19E230047,ARN.AR-SB0001,00ARSB0086,NON,1,107400,179000,0,0,0,0,0,53700,179000,125300
01SCS19E230048,AR.PUB-SE032,20ARSE0327,L,1,204750,315000,2,0,63000,1,0,63000,252000,189000
01SCS19E230049,AR.TUC-SB016,20ARSB0470,M,1,87750,135000,2,0,27000,1,0,27000,108000,81000
01SCS19E230049,AR.TUC-SE011,20ARSE0405,L,1,94250,145000,2,0,29000,1,0,29000,116000,87000
01SCS19E230050,AR.MPR-SE014,20ARSE0189,S,1,237250,365000,2,0,73000,1,0,73000,292000,219000
01SCS19E230050,ESH.AR-SD0032,00ARSD0304,M,1,44500,135000,0,0,0,0,0,27000,135000,108000
01SCS19E230051,AR.CPT-SD009,20ARSD0446,M,1,94250,145000,2,0,29000,1,0,29000,116000,87000
01SCS19E230051,AR.MDS-RL006,20ARRL0376,L,1,117000,180000,2,0,36000,1,0,36000,144000,108000
01SCS19E230052,AR.TUC-SE005,20ARSE0379,S,1,204750,315000,2,0,63000,1,0,63000,252000,189000
01SCS19E230053,AR.MDS-RL006,20ARRL0376,L,1,117000,180000,2,0,36000,1,0,36000,144000,108000
01SCS19E230053,BSC.AR-RL0025,00ARRL0167,M,1,94500,135000,0,0,0,0,0,27000,135000,108000
01SCS19E230054,AR.STY-SE015,20ARSE0581,ALL,1,55250,85000,2,0,17000,1,0,17000,68000,51000
01SCS19E230054,BSC.AR-SE0001,00ARSE0058,M,1,44500,159000,0,0,0,0,0,31800,159000,127200
01SCS19E230054,ESH.AR-SE0027,00ARSE0255,S,1,44500,135000,0,0,0,0,0,27000,135000,108000
01SCS19E230055,AR.CPT-RK007,20ARRK0023,S,1,204750,315000,2,0,63000,1,0,63000,252000,189000
01SCS19E230056,BSC.AR-SD0043,00ARSD0233,L,1,44500,159000,0,0,0,0,0,31800,159000,127200
01SCS19E230057,ESH.AR-SC0011,00ARSC0084,S,1,44000,135000,0,0,0,0,0,27000,135000,108000
01SCS19E230058,BSC.AR-RI0007,00ARRI0022,S,1,108500,155000,0,0,0,0,0,31000,155000,124000
01SCS19E230058,BSC.AR-RJ0012,00ARRJ0084,M,1,44500,135000,0,0,0,0,0,27000,135000,108000
01SCS19E230058,BSC.AR-SD0014,00ARSD0110,S,1,122000,375000,0,0,0,0,0,75000,375000,300000
01SCS19E230059,AR.MPR-SB010,20ARSB0271,M,1,97500,150000,2,0,45000,1,0,26250,105000,78750
01SCS19E230059,AR.PUB-SE009,20ARSE0034,M,1,97500,150000,2,0,30000,1,0,30000,120000,90000
01SCS19E230059,ESH.AR-SC0010,00ARSC0082,L,1,44500,135000,0,0,0,0,0,27000,135000,108000
01SCS19E230060,AR.TUC-SA027,20ARSA0162,ALL,1,100750,155000,2,0,31000,1,0,31000,124000,93000
01SCS19E230061,AR.STY-RK003,20ARRK0525,ALL,1,61750,95000,2,0,19000,1,0,19000,76000,57000
01SCS19E230062,BSC.AR-SA0013,00ARSA0039,NON,1,47500,140000,0,0,0,0,0,28000,140000,112000
01SCS19E230063,AR.MKV-SE001,20ARSE0470,30,1,214500,330000,2,0,66000,1,0,66000,264000,198000
01SCS19E230063,AR.SMD-PL002,20ARPL0265,S,1,84500,130000,2,0,39000,1,0,22750,91000,68250
01SCS19E230064,AR.CPT-RE009,20ARRE0701,S,1,204750,315000,2,0,63000,1,0,63000,252000,189000
01SCS19E230065,AR.TUC-SE020,20ARSE0640,M,1,204750,315000,2,0,63000,1,0,63000,252000,189000
01SCS19E230066,AR.MPR-SE023,20ARSE0211,M,1,230750,355000,2,0,71000,1,0,71000,284000,213000
01SCS19E230067,AR.BPH-RL001,20ARRL0069,ALL,1,96850,149000,2,0,44700,1,0,26075,104300,78225
01SCS19E230068,AR.CPT-SD003,20ARSD0139,ALL,1,94250,145000,2,0,29000,1,0,29000,116000,87000
01SCS19E230068,BSC.AR-SD0014,00ARSD0110,S,1,122000,375000,0,0,0,0,0,75000,375000,300000
01SCS19E230069,DKS.AR-SE0011,00ARSE0171,30,1,417272,696000,0,0,0,0,0,104400,696000,591600
01SCS19E230070,AR.CPT-SE003,20ARSE0360,S,1,94250,145000,2,0,29000,1,0,29000,116000,87000
01SCS19E230071,BSC.AR-SA0001,00ARSA0002,M,1,120000,315000,0,0,0,0,0,63000,315000,252000
01SCS19E230072,AR.CLB-SB004,20ARSB0175,ALL,1,185250,285000,2,0,57000,1,0,57000,228000,171000
01SCS19E230073,AR.MKV-SE016,20ARSE0596,M,1,22750,350000,2,0,70000,1,0,70000,280000,210000
01SCS19E230073,AR.TUC-SB016,20ARSB0470,M,1,87750,135000,2,0,27000,1,0,27000,108000,81000
01SCS19E230074,AR.CPT-RK004,20ARRK0020,ALL,1,77350,119000,2,0,23800,1,0,23800,95200,71400
01SCS19E230074,ESH.AR-SD0029,00ARSD0278,NON,1,58000,175000,0,0,0,0,0,35000,175000,140000
01SCS19E230075,AR.TUC-SE009,20ARSE0397,M,1,204750,315000,2,0,63000,1,0,63000,252000,189000
01SCS19E230076,BSC.AR-RE0027,00ARRE0302,NON,1,35000,120000,0,0,0,0,0,24000,120000,96000
01SCS19E230077,AR.CPT-RI009,20ARRI0075,XL,1,94251,169000,2,0,33800,1,0,33800,135200,101400
01SCS19E230077,BSC.AR-SC0026,00ARSC0188,XL,1,106400,350000,0,0,0,0,0,70000,350000,280000
01SCS19E230078,AR.TUC-RK002,20ARRK0081,S,1,204750,315000,2,0,63000,1,0,63000,252000,189000
01SCS19E230079,AR.MKV-SE002,20ARSE0474,28,1,214500,330000,2,0,66000,1,0,66000,264000,198000
01SCS19E230080,AR.MDS-RL004,20ARRL0367,M,1,117000,180000,2,0,36000,1,0,36000,144000,108000
01SCS19E230080,AR.PUB-SD006,20ARSD0092,ALL,1,81250,125000,2,0,25000,1,0,25000,100000,75000
01SCS19E230081,BE.RAK-SC041,00BESC0177,S,1,91000,140000,2,0,28000,1,0,28000,112000,84000
01SCS19E230082,AR.PUB-RJ038,20ARRJ0501,S,1,97500,150000,2,0,30000,1,0,30000,120000,90000
01SCS19E230083,AR.RDC-RL003,20ARRL0446,ALL,1,81250,125000,2,0,37500,1,0,21875,87500,65625
01SCS19E230083,AR.TUC-RK018,20ARRK0114,ALL,1,42250,65000,2,0,13000,1,0,13000,52000,39000
01SCS19E230084,AR.TUC-SA035,20ARSA0267,ALL,1,87750,135000,2,0,27000,1,0,27000,108000,81000
01SCS19E230084,AR.TUC-SE024,20ARSE0655,28,1,204750,315000,2,0,63000,1,0,63000,252000,189000
01SCS19E230085,AR.ESB-RL010,20ARRL0461,ALL,1,91000,140000,2,0,70000,1,0,17500,70000,52500
01SCS19E230085,AR.TUC-SB001,20ARSB0025,L,1,204750,315000,2,0,63000,1,0,63000,252000,189000
01SCS19E230086,AR.MKV-SE021,20ARSE0611,S,1,97500,150000,2,0,30000,1,0,30000,120000,90000
01SCS19E230087,AR.TUC-SA034,20ARSA0266,ALL,1,87750,135000,2,0,27000,1,0,27000,108000,81000
01SCS19E230088,BSC.AR-SA0004,00ARSA0019,M,1,125000,315000,0,0,0,0,0,63000,315000,252000
01SCS19E230089,AR.MKV-SA006,20ARSA0196,30,1,243750,375000,2,0,75000,1,0,75000,300000,225000
01SCS19E230090,AR.SLS-SC004,20ARSC0014,M,1,467500,550000,0,0,0,0,0,82500,550000,467500
01SCS19E230090,AR.TUC-SE009,20ARSE0397,M,1,204750,315000,2,0,63000,1,0,63000,252000,189000
01SCS19E230091,AR.TUC-SB001,20ARSB0025,L,1,204750,315000,2,0,63000,1,0,63000,252000,189000
01SCS19E230092,ESH.AR-SD0040,00ARSD0367,M,1,122500,350000,0,0,0,0,0,70000,350000,280000
01SCS19E230093,AR.MDS-RI001,20ARRI0090,L,1,221000,340000,2,0,68000,1,0,68000,272000,204000
01SCS19E230094,BSC.AR-SD0051,00ARSD0255,M,1,44000,159000,0,0,0,0,0,31800,159000,127200
01SCS19E230095,BE.RAK-RX066,00BERX0066,ALL,1,97500,150000,2,0,30000,1,0,30000,120000,90000
01SCS19E230096,AR.MKV-QA005,20ARQA0028,32,1,214500,330000,2,0,165000,1,0,41250,165000,123750
01SCS19E230097,AR.CPT-SE001,20ARSE0355,XL,1,94250,145000,2,0,29000,1,0,29000,116000,87000
01SCS19E230097,ESH.AR-SE0009,00ARSE0036,XL,1,44500,135000,0,0,0,0,0,27000,135000,108000
01SCS19E230098,AR.TUC-SD016,20ARSD0483,L,1,94250,145000,2,0,29000,1,0,29000,116000,87000
01SCS19E230099,AR.HLW-SA020,20ARSA0127,32,1,243750,375000,2,0,112500,1,0,65625,262500,196875
01SCS19E230099,BSC.AR-RI0001,00ARRI0002,M,1,315000,450000,0,0,0,0,0,90000,450000,360000
01SCS19E230100,AR.MPR-SE025,20ARSE0219,M,1,230750,355000,2,0,71000,1,0,71000,284000,213000
01SCS19E230101,AR.ESB-SC003,20ARSC0419,M,1,91000,140000,2,0,28000,1,0,28000,112000,84000
01SCS19E230101,BSC.AR-SE0031,00ARSE0291,S,1,52000,155000,0,0,0,0,0,31000,155000,124000
01SCS19E230101,ESH.AR-SD0026,00ARSD0268,L,1,44500,135000,0,0,0,0,0,27000,135000,108000
01SCS19E230102,AR.TUC-SE016,20ARSE0425,L,1,146250,225000,2,0,45000,1,0,45000,180000,135000
01SCS19E230103,AR.PUB-SE002,20ARSE0006,M,1,97500,150000,2,0,30000,1,0,30000,120000,90000
01SCS19E230104,ESH.AR-SA0001,00ARSA0015,32,1,122500,175000,0,0,0,0,0,35000,175000,140000
01SCS19E230104,ESH.AR-SE0005,00ARSE0018,M,1,44500,135000,0,0,0,0,0,27000,135000,108000
01SCS19E230105,AR.PUB-SE004,20ARSE0014,M,1,97500,150000,2,0,30000,1,0,30000,120000,90000
01SCS19E230106,AR.HLW-SE001,20ARSE0526,ALL,1,71500,110000,0,0,0,0,0,38500,110000,71500
01SCS19E230106,BSC.AR-SD0052,00ARSD0281,L,1,44500,159000,0,0,0,0,0,31800,159000,127200
01SCS19E230107,AR.MPR-SE002,20ARSE0141,S,1,97500,150000,2,0,45000,1,0,26250,105000,78750
01SCS19E230108,AR.ESB-QJ014,20ARQJ0095,ALL,1,91000,140000,2,0,70000,1,0,17500,70000,52500
01SCS19E230108,ESH.AR-SE0036,00ARSE0324,S,1,44500,135000,0,0,0,0,0,27000,135000,108000
01SCS19E230109,ESH.AR-SD0043,00ARSD0396,L,1,125000,315000,0,0,0,0,0,63000,315000,252000
01SCS19E230110,AR.ESB-RK002,20ARRK0228,M,1,198250,305000,2,0,61000,1,0,61000,244000,183000
01SCS19E230111,AR.PUB-SC009,20ARSC0289,M,1,97500,150000,2,0,30000,1,0,30000,120000,90000
01SCS19E230111,ESH.AR-SE0017,00ARSE0113,S,1,44000,135000,0,0,0,0,0,27000,135000,108000
01SCS19E230112,ESH.AR-SD0032,00ARSD0305,L,1,44500,135000,0,0,0,0,0,27000,135000,108000
01SCS19E230113,AR.ESB-SC017,20ARSC0462,L,1,91000,140000,2,0,28000,1,0,28000,112000,84000
01SCS19E230114,AR.ESB-RK002,20ARRK0229,L,1,198250,305000,2,0,61000,1,0,61000,244000,183000
01SCS19E230115,BSC.AR-RL0018,00ARRL0111,L,1,125000,315000,1,0,63000,1,0,50400,252000,201600
01SCS19E230116,BE.RAK-SC018,00BESC0063,M,1,201500,310000,2,0,62000,1,0,62000,248000,186000
01SCS19E230117,ESH.AR-SD0018,00ARSD0136,S,1,125000,315000,0,0,0,0,0,63000,315000,252000
01SCS19E230118,AR.SMD-SD018,20ARSD0580,ALL,1,97500,150000,2,0,30000,1,0,30000,120000,90000
01SCS19E230119,BSC.AR-SD0051,00ARSD0254,S,1,44000,159000,0,0,0,0,0,31800,159000,127200
01SCS19E230120,ESH.AR-SC0023,00ARSC0165,S,1,125000,315000,0,0,0,0,0,63000,315000,252000
01SCS19E230121,BE.RAK-SC037,00BESC0158,M,1,91000,140000,2,0,28000,1,0,28000,112000,84000
01SCS19E230122,BSC.AR-SC0009,00ARSC0052,S,1,125000,315000,0,0,0,0,0,63000,315000,252000
01SCS19E230123,BSC.AR-SA0021,00ARSA0106,M,1,44000,135000,0,0,0,0,0,27000,135000,108000
01SCS19E230124,BSC.AR-RJ0016,00ARRJ0100,M,1,43000,135000,0,0,0,0,0,27000,135000,108000
01SCS19E230125,BSC.AR-SD0058,00ARSD0294,NON,1,50000,150000,0,0,0,0,0,30000,150000,120000
01SCS19E230126,ARN.AR-RK0004,00ARRK0231,M,1,150000,450000,0,0,0,0,0,135000,450000,315000
01SCS19E230126,BSC.AR-SD0058,00ARSD0294,NON,1,50000,150000,0,0,0,0,0,30000,150000,120000
01SCS19E230127,AR.BPH-RD005,20ARRD0323,S,1,182000,280000,2,0,140000,1,0,35000,140000,105000
01SCS19E230127,AR.GTW-SA003,20ARSA0304,M,1,94250,145000,2,0,43500,1,0,25375,101500,76125
01SCS19E230128,AR.RDC-RK006,20ARRK0474,L,1,136500,210000,2,0,42000,1,0,42000,168000,126000
01SCS19E230129,AR.SMD-SD018,20ARSD0580,ALL,1,97500,150000,2,0,30000,1,0,30000,120000,90000
01SCS19E230130,ESH.AR-SE0037,00ARSE0329,M,1,44000,135000,0,0,0,0,0,27000,135000,108000
01SCS19E230131,ESH.AR-SE0011,00ARSE0041,S,1,44500,135000,0,0,0,0,0,27000,135000,108000
01SCS19E230132,AR.HLW-SA020,20ARSA0126,30,1,243750,375000,2,0,112500,1,0,65625,262500,196875
01SCS19E230132,AR.MKV-SE006,20ARSE0494,28,1,165750,255000,2,0,51000,1,0,51000,204000,153000
01SCS19E230132,ESH.AR-SC0021,00ARSC0159,L,1,44000,135000,0,0,0,0,0,27000,135000,108000
01SCS19E230133,AR.MPR-SE004,20ARSE0149,S,1,97500,150000,2,0,45000,1,0,26250,105000,78750
01SCS19E230133,AR.MPR-SE030,20ARSE0291,S,1,230750,355000,2,0,71000,1,0,71000,284000,213000
01SCS19E230133,AR.SMD-SD018,20ARSD0580,ALL,1,97500,150000,2,0,30000,1,0,30000,120000,90000
01SCS19E230134,ESH.AR-RH0008,00ARRH0060,NON,1,45000,150000,0,0,0,0,0,30000,150000,120000
01SCS19E230135,AR.TUC-SD016,20ARSD0483,L,1,94250,145000,2,0,29000,1,0,29000,116000,87000
01SCS19E230136,AR.PUB-SD034,20ARSD0341,M,1,97500,150000,2,0,30000,1,0,30000,120000,90000
01SCS19E230136,BSC.AR-RJ0014,00ARRJ0092,M,1,43000,135000,0,0,0,0,0,27000,135000,108000
01SCS19E230137,ESH.AR-SD0018,00ARSD0137,M,1,125000,315000,0,0,0,0,0,63000,315000,252000
01SCS19E230138,AR.TUC-SE009,20ARSE0398,L,1,204750,315000,2,0,63000,1,0,63000,252000,189000
01SCS19E230139,ESH.AR-SC0008,00ARSC0068,S,1,44500,135000,0,0,0,0,0,27000,135000,108000
01SCS19E230140,AR.TUC-SE016,20ARSE0426,XL,1,146250,225000,2,0,45000,1,0,45000,180000,135000
01SCS19E230141,AR.PUB-SD001,20ARSD0082,M,1,204750,315000,2,0,63000,1,0,63000,252000,189000
01SCS19E230142,ESH.AR-SD0005,00ARSD0049,S,1,44000,135000,0,0,0,0,0,27000,135000,108000
01SCS19E230143,ESH.AR-SD0018,00ARSD0136,S,1,125000,315000,0,0,0,0,0,63000,315000,252000
01SCS19E230144,AR.CPT-SD005,20ARSD0432,ALL,1,94250,145000,2,0,29000,1,0,29000,116000,87000
01SCS19E230145,AR.MPR-SE033,20ARSE0303,S,1,230750,355000,2,0,71000,1,0,71000,284000,213000
01SCS19E230145,AR.TUC-SA031,20ARSA0258,M,1,87750,135000,2,0,27000,1,0,27000,108000,81000
01SCS19E230145,ESH.AR-RH0008,00ARRH0060,NON,1,45000,150000,0,0,0,0,0,30000,150000,120000
01SCS19E230145,ESH.AR-SD0031,00ARSD0299,S,1,44000,135000,0,0,0,0,0,27000,135000,108000
01SCS19E230146,BSC.AR-SD0052,00ARSD0279,S,1,44500,159000,0,0,0,0,0,31800,159000,127200
01SCS19E230147,BSC.AR-SE0027,00ARSE0276,M,1,52000,155000,0,0,0,0,0,31000,155000,124000
01SCS19E230148,AR.MPR-SE020,20ARSE0204,ALL,1,97500,150000,2,0,45000,1,0,26250,105000,78750
01SCS19E230149,AR.TUC-RK015,20ARRK0111,ALL,1,87750,135000,2,0,27000,1,0,27000,108000,81000
01SCS19E230149,AR.TUC-SE024,20ARSE0656,30,1,204750,315000,2,0,63000,1,0,63000,252000,189000
01SCS19E230150,ESH.AR-RJ0003,00ARRJ0019,S,1,43000,135000,0,0,0,0,0,27000,135000,108000
01SCS19E230151,BSC.AR-SD0012,00ARSD0105,NON,1,18000,75000,0,0,0,0,0,15000,75000,60000
01SCS19E230152,AR.PUB-SA007,20ARSA0322,M,1,97500,150000,2,0,30000,1,0,30000,120000,90000
01SCS19E230153,BE.RAK-SC040,00BESC0173,M,1,91000,140000,2,0,28000,1,0,28000,112000,84000
01SCS19E230154,AR.MKV-SA006,20ARSA0195,28,1,243750,375000,2,0,75000,1,0,75000,300000,225000
01SCS19E230155,ESH.AR-SC0011,00ARSC0084,S,1,44000,135000,0,0,0,0,0,27000,135000,108000
01SCS19E230156,BSC.AR-SC0013,00ARSC0094,L,1,44000,135000,0,0,0,0,0,27000,135000,108000
01SCS19E230157,BSC.AR-SE0027,00ARSE0276,M,1,52000,155000,0,0,0,0,0,31000,155000,124000
01SCS19E230157,BSC.AR-SE0027,00ARSE0277,L,1,52000,155000,0,0,0,0,0,31000,155000,124000
01SCS19E230158,DKS.AR-SE0009,00ARSE0160,28,1,417272,696000,0,0,0,0,0,104400,696000,591600
01SCS19E230159,ESH.AR-SE0003,00ARSE0009,S,1,44500,135000,1,0,27000,1,0,21600,108000,86400
01SCS19E230159,ESH.AR-SE0010,00ARSE0037,S,1,44000,135000,1,0,27000,1,0,21600,108000,86400
01SCS19E230160,BE.RAK-SC010,00BESC0025,L,1,91000,140000,2,0,28000,1,0,28000,112000,84000
01SCS19E230161,AR.STY-SE009,20ARSE0127,ALL,1,55250,85000,2,0,17000,1,0,17000,68000,51000
01SCS19E230162,BSC.AR-RI0010,00ARRI0036,L,1,94500,135000,0,0,0,0,0,27000,135000,108000
01SCS19E230163,AR.MKV-SE021,20ARSE0611,S,1,97500,150000,2,0,30000,1,0,30000,120000,90000
01SCS19E230164,AR.CPT-SB001,20ARSB0083,M,1,204750,315000,2,0,63000,1,0,63000,252000,189000
01SCS19E230165,AR.GTW-SA002,20ARSA0300,M,1,107250,165000,2,0,49500,1,0,28875,115500,86625
01SCS19E230166,AR.MKV-SE017,20ARSE0599,S,1,97500,150000,2,0,30000,1,0,30000,120000,90000
01SCS19E230167,AR.MPR-SE037,20ARSE0313,ALL,1,130000,200000,2,0,40000,1,0,40000,160000,120000
01SCS19E230168,BNV.AR-RI0001,00ARRI0157,30,1,625000,625000,0,0,0,0,0,93750,625000,531250
01SCS19E230169,AR.PUB-RJ045,20ARRJ0531,L,1,97500,150000,2,0,30000,1,0,30000,120000,90000
01SCS19E230169,AR.TUC-SE014,20ARSE0418,XL,1,94250,145000,2,0,29000,1,0,29000,116000,87000
01SCS19E230170,ESH.AR-SD0018,00ARSD0136,S,1,125000,315000,0,0,0,0,0,63000,315000,252000
01SCS19E230170,ESH.AR-SE0027,00ARSE0255,S,1,44500,135000,0,0,0,0,0,27000,135000,108000
01SCS19E230171,AR.STY-SE009,20ARSE0127,ALL,1,55250,85000,2,0,17000,1,0,17000,68000,51000
01SCS19E230171,BSC.AR-SD0027,00ARSD0158,L,1,125000,315000,0,0,0,0,0,63000,315000,252000
01SCS19E230172,AR.SMD-SD006,20ARSD0296,S,1,87750,135000,2,0,27000,1,0,27000,108000,81000
01SCS19E230173,BE.RAK-RX615,00BERX2619,L,1,110500,170000,2,0,34000,1,0,34000,136000,102000
01SCS19E230174,ESH.AR-SE0037,00ARSE0328,S,1,44000,135000,0,0,0,0,0,27000,135000,108000
01SCS19E230175,ESH.AR-SE0030,00ARSE0268,M,1,125000,315000,0,0,0,0,0,63000,315000,252000
01SCS19E230176,AR.PUB-SB011,20ARSB0015,28,1,211250,325000,2,0,65000,1,0,65000,260000,195000
01SCS19E230177,AR.TUC-SA002,20ARSA0007,L,1,204750,315000,2,0,63000,1,0,63000,252000,189000
01SCS19E230178,AR.TUC-SE023,20ARSE0652,30,1,204750,315000,2,0,63000,1,0,63000,252000,189000
01SCS19E230179,AR.MPR-SE012,20ARSE0182,M,1,97500,150000,2,0,45000,1,0,26250,105000,78750
01SCS19E230180,ESH.AR-SC0017,00ARSC0140,S,1,44000,135000,0,0,0,0,0,27000,135000,108000
01SCS19E230181,AR.PUB-SE029,20ARSE0112,M,1,224250,345000,2,0,69000,1,0,69000,276000,207000
01SCS19E230182,ESH.AR-RJ0002,00ARRJ0016,M,1,94500,135000,0,0,0,0,0,27000,135000,108000
01SCS19E230183,AR.CPT-SD011,20ARSD0454,M,1,94250,145000,2,0,29000,1,0,29000,116000,87000
01SCS19E230183,AR.PUB-SE028,20ARSE0109,L,1,204750,315000,2,0,63000,1,0,63000,252000,189000
01SCS19E230184,AR.PUB-SD031,20ARSD0213,28,1,211250,325000,2,0,65000,1,0,65000,260000,195000
01SCS19E230185,AR.MKV-SC012,20ARSC0110,ALL,1,97500,150000,2,0,30000,1,0,30000,120000,90000
01SCS19E230186,AR.MKV-SE011,20ARSE0519,28,1,227500,350000,2,0,70000,1,0,70000,280000,210000
01SCS19E230187,ESH.AR-SD0038,00ARSD0344,M,1,122500,350000,0,0,0,0,0,70000,350000,280000
01SCS19E230188,AR.MPR-SE034,20ARSE0307,S,1,237250,365000,2,0,73000,1,0,73000,292000,219000
01SCS19E230189,AR.MPR-SE031,20ARSE0296,M,1,230750,355000,2,0,71000,1,0,71000,284000,213000
01SCS19E230190,AR.MKV-SE010,20ARSE0517,34,1,227500,350000,2,0,70000,1,0,70000,280000,210000
01SCS19E230191,AR.MPR-SE035,20ARSE0311,ALL,1,136500,210000,2,0,42000,1,0,42000,168000,126000
01SCS19E230192,AR.CPT-RK007,20ARRK0023,S,1,204750,315000,2,0,63000,1,0,63000,252000,189000
01SCS19E230192,BSC.AR-RK0007,00ARRK0073,S,1,52000,155000,0,0,0,0,0,31000,155000,124000
01SCS19E230192,ESH.AR-SE0007,00ARSE0025,S,1,44500,135000,0,0,0,0,0,27000,135000,108000
01SCS19E230193,BSC.AR-RK0012,00ARRK0095,L,1,43000,135000,0,0,0,0,0,27000,135000,108000
01SCS19E230194,AR.PUB-SB011,20ARSB0016,30,1,211250,325000,2,0,65000,1,0,65000,260000,195000
01SCS19E230194,BSC.AR-SB0003,00ARSB0043,S,1,125000,315000,0,0,0,0,0,63000,315000,252000
01SCS19E230194,ESH.AR-SD0009,00ARSD0067,L,1,44500,135000,0,0,0,0,0,27000,135000,108000
01SCS19E230195,AR.TUC-SE025,20ARSE0661,32,1,204750,315000,2,0,63000,1,0,63000,252000,189000
01SCS19E230196,AR.CPT-SD011,20ARSD0454,M,1,94250,145000,2,0,29000,1,0,29000,116000,87000
01SCS19E230197,AR.PUB-SA009,20ARSA0332,XL,1,224250,345000,2,0,69000,1,0,69000,276000,207000
01SCS19E230198,AR.ASH-RK003,20ARRK0511,S,1,195000,300000,2,0,90000,1,0,52500,210000,157500
01SCS19E230198,AR.STY-SA002,20ARSA0061,ALL,1,61750,95000,2,0,19000,1,0,19000,76000,57000
01SCS19E230198,AR.STY-SE010,20ARSE0576,ALL,1,61750,95000,2,0,19000,1,0,19000,76000,57000
01SCS19E230198,BSC.AR-SC0029,00ARSC0202,XL,1,125000,315000,0,0,0,0,0,63000,315000,252000
01SCS19E230199,AR.CPT-RE009,20ARRE0703,L,1,204750,315000,2,0,63000,1,0,63000,252000,189000
01SCS19E230199,AR.CPT-SC012,20ARSC0481,L,1,204750,315000,2,0,63000,1,0,63000,252000,189000
01SCS19E230200,AR.PUB-RI016,20ARRI0259,L,1,97500,150000,2,0,30000,1,0,30000,120000,90000
01SCS19E230200,AR.STY-SE007,20ARSE0125,ALL,1,55250,85000,2,0,17000,1,0,17000,68000,51000
01SCS19E230201,AR.MPR-SE016,20ARSE0197,S,1,243750,375000,2,0,75000,1,0,75000,300000,225000
01SCS19E230202,AR.CPT-SC011,20ARSC0477,L,1,204750,315000,2,0,63000,1,0,63000,252000,189000
01SCS19E230203,BSC.AR-SE0033,00ARSE0315,28,1,125400,365000,0,0,0,0,0,73000,365000,292000
01SCS19E230204,AR.TUC-SE003,20ARSE0289,ALL,1,159250,245000,2,0,49000,1,0,49000,196000,147000
01SCS19E230205,AR.MKV-SE011,20ARSE0519,28,1,227500,350000,2,0,70000,1,0,70000,280000,210000
01SCS19E230205,AR.YD-RL016,20ARRL0043,M,1,91000,140000,2,0,70000,1,0,17500,70000,52500
01SCS19E230206,AR.HMR-SB021,20ARSB0395,28,1,204750,315000,2,0,63000,1,0,63000,252000,189000
01SCS19E230206,AR.PUB-SB023,20ARSB0124,S,1,97500,150000,2,0,30000,1,0,30000,120000,90000
01SCS19E230206,AR.SMD-SD006,20ARSD0297,M,1,87750,135000,2,0,27000,1,0,27000,108000,81000
01SCS19E230207,ESH.AR-SE0003,00ARSE0010,M,1,44500,135000,0,0,0,0,0,27000,135000,108000
01SCS19E230208,AR.ESB-SC002,20ARSC0309,M,1,204750,315000,2,0,63000,1,0,63000,252000,189000
01SCS19E230209,AR.MPR-SE032,20ARSE0299,S,1,230750,355000,2,0,71000,1,0,71000,284000,213000
01SCS19E230209,AR.SMD-RI007,20ARRI0331,L,1,87750,135000,2,0,40500,1,0,23625,94500,70875
01SCS19E230210,AR.TUC-SE005,20ARSE0380,M,1,204750,315000,2,0,63000,1,0,63000,252000,189000
01SCS19E230211,ESH.AR-RK0014,00ARRK0187,S,1,112500,350000,0,0,0,0,0,70000,350000,280000
01SCS19E230212,AR.MKV-SC005,20ARSC0083,M,1,253500,390000,2,0,78000,1,0,78000,312000,234000
01SCS19E230213,AR.ESB-SD007,20ARSD0171,S,1,91000,140000,2,0,28000,1,0,28000,112000,84000
01SCS19E230214,AR.ESB-RH004,20ARRH0193,ALL,1,91000,140000,2,0,70000,1,0,17500,70000,52500
01SCS19E230214,AR.ESB-RK008,20ARRK0241,ALL,1,87750,135000,2,0,40500,1,0,23625,94500,70875
01SCS19E230215,AR.ESB-SE010,20ARSE0276,L,1,227500,350000,2,0,70000,1,0,70000,280000,210000
01SCS19E240001,AR.ESB-RK002,20ARRK0227,S,1,198250,305000,2,0,61000,1,0,61000,244000,183000
01SCS19E240002,AR.ESB-SC018,20ARSC0465,M,1,91000,140000,2,0,28000,1,0,28000,112000,84000
01SCS19E240003,AR.MKV-RL002,20ARRL0241,L,1,204750,315000,0,0,0,0,0,110250,315000,204750
01SCS19E240003,ESH.AR-SA0001,00ARSA0014,30,1,122500,175000,0,0,0,0,0,35000,175000,140000
01SCS19E240004,AR.MPR-SE006,20ARSE0157,S,1,97500,150000,2,0,45000,1,0,26250,105000,78750
01SCS19E240005,ESH.AR-SD0041,00ARSD0370,S,1,125000,315000,0,0,0,0,0,63000,315000,252000
01SCS19E240006,BSC.AR-SD0007,00ARSD0025,S,1,44500,159000,0,0,0,0,0,31800,159000,127200
01SCS19E240007,AR.STY-RK003,20ARRK0525,ALL,1,61750,95000,2,0,19000,1,0,19000,76000,57000
01SCS19E240007,AR.STY-SB001,20ARSB0488,ALL,1,61750,95000,2,0,19000,1,0,19000,76000,57000
01SCS19E240008,ESH.AR-SD0039,00ARSD0349,L,1,122500,350000,0,0,0,0,0,70000,350000,280000
01SCS19E240009,AR.PUB-RG008,20ARRG0048,L,1,97500,150000,2,0,30000,1,0,30000,120000,90000
01SCS19E240009,AR.PUB-SE016,20ARSE0063,L,1,159250,245000,2,0,49000,1,0,49000,196000,147000
01SCS19E240010,AR.CLK-RE010,20ARRE0919,ALL,1,84500,130000,2,0,26000,1,0,26000,104000,78000
01SCS19E240011,DKS.AR-SE0009,00ARSE0162,32,1,417272,696000,0,0,0,0,0,104400,696000,591600
01SCS19E240012,AR.RDC-RH012,20ARRH0644,XL,1,97500,150000,2,0,30000,1,0,30000,120000,90000
01SCS19E240012,AR.TUC-SA024,20ARSA0151,M,1,87750,135000,2,0,27000,1,0,27000,108000,81000
01SCS19E240012,AR.TUC-SD018,20ARSD0490,M,1,94250,145000,2,0,29000,1,0,29000,116000,87000
01SCS19E240013,AR.TUC-SD027,20ARSD0522,ALL,1,35750,55000,2,0,11000,1,0,11000,44000,33000
01SCS19E240014,DKS.AR-SE0008,00ARSE0156,28,1,41727,696000,0,0,0,0,0,104400,696000,591600
01SCS19E240015,ESH.AR-SC0002,00ARSC0006,M,1,44500,135000,0,0,0,0,0,27000,135000,108000
01SCS19E240016,BSC.AR-SD0064,00ARSD0339,S,1,125000,315000,0,0,0,0,0,63000,315000,252000
01SCS19E240017,AR.MPR-SE035,20ARSE0311,ALL,1,136500,210000,2,0,42000,1,0,42000,168000,126000
01SCS19E240017,BSC.AR-SA0008,00ARSA0034,NON,1,47500,140000,0,0,0,0,0,28000,140000,112000
01SCS19E240018,AR.HLW-SE021,20ARSE0571,M,1,217750,335000,0,0,0,0,0,117250,335000,217750
01SCS19E240019,ESH.AR-SE0037,00ARSE0328,S,1,44000,135000,0,0,0,0,0,27000,135000,108000
01SCS19E240020,BSC.AR-SE0031,00ARSE0292,M,1,52000,155000,0,0,0,0,0,31000,155000,124000
01SCS19E240021,AR.TUC-RH015,20ARRH0687,ALL,1,87750,135000,2,0,27000,1,0,27000,108000,81000
01SCS19E240022,AR.PUB-RJ017,20ARRL0443,34,1,113750,175000,2,0,35000,1,0,35000,140000,105000
01SCS19E240023,AR.ESB-RE023,20ARRE0403,ALL,1,94250,145000,2,0,43500,1,0,25375,101500,76125
01SCS19E240024,BSC.AR-SD0008,00ARSD0034,M,1,44500,159000,0,0,0,0,0,31800,159000,127200
01SCS19E240025,AR.PUB-SE021,20ARSE0079,S,1,159250,245000,2,0,49000,1,0,49000,196000,147000
01SCS19E240026,AR.ESB-RL012,20ARRL0463,ALL,1,91000,140000,2,0,70000,1,0,17500,70000,52500
01SCS19E240027,AR.TUC-SE005,20ARSE0380,M,1,204750,315000,2,0,63000,1,0,63000,252000,189000
01SCS19E240028,BE.RAK-SB034,00BESB0102,XL,1,91000,140000,2,0,28000,1,0,28000,112000,84000
01SCS19E240028,BE.RAK-SC013,00BESC0041,XL,1,91000,140000,2,0,28000,1,0,28000,112000,84000
01SCS19E240029,AR.TUC-SE020,20ARSE0640,M,1,204750,315000,2,0,63000,1,0,63000,252000,189000
01SCS19E240030,AR.CPT-SD005,20ARSD0432,ALL,1,94250,145000,2,0,29000,1,0,29000,116000,87000
01SCS19E240031,THR.AR-QG0008,00ARQG0036,L,1,332000,415000,0,0,0,0,0,62250,415000,352750
01SCS19E240032,BSC.AR-RH0018,00ARRH0080,L,1,120000,315000,0,0,0,0,0,63000,315000,252000
01SCS19E240033,AR.PUB-SD031,20ARSD0215,32,1,211250,325000,2,0,65000,1,0,65000,260000,195000
01SCS19E240034,ESH.AR-SB0021,00ARSB0119,S,1,44500,135000,0,0,0,0,0,27000,135000,108000
01SCS19E240035,AR.TUC-SE014,20ARSE0417,L,1,94250,145000,2,0,29000,1,0,29000,116000,87000
01SCS19E240035,ESH.AR-SC0009,00ARSC0078,L,1,44500,135000,0,0,0,0,0,27000,135000,108000
01SCS19E240036,BSC.AR-RH0008,00ARRH0051,L,1,110000,350000,0,0,0,0,0,70000,350000,280000
01SCS19E240037,AR.CPT-SE006,20ARSE0372,S,1,204750,315000,2,0,63000,1,0,63000,252000,189000
01SCS19E240037,ESH.AR-SD0010,00ARSD0069,S,1,44500,135000,0,0,0,0,0,27000,135000,108000
01SCS19E240038,AR.MPR-SE003,20ARSE0147,L,1,97500,150000,2,0,45000,1,0,26250,105000,78750
01SCS19E240039,BSC.AR-SD0004,00ARSD0014,M,1,44000,159000,0,0,0,0,0,31800,159000,127200
01SCS19E240040,AR.CPT-SE005,20ARSE0368,S,1,204750,315000,2,0,63000,1,0,63000,252000,189000
01SCS19E240040,AR.MPR-SE004,20ARSE0149,S,1,97500,150000,2,0,45000,1,0,26250,105000,78750
01SCS19E240041,ESH.AR-SE0037,00ARSE0328,S,1,44000,135000,0,0,0,0,0,27000,135000,108000
01SCS19E240042,ESH.AR-SA0012,00ARSA0094,M,1,44000,135000,0,0,0,0,0,27000,135000,108000
01SCS19E240043,AR.PCT-SE013,20ARSE0674,M,1,87750,135000,2,0,27000,1,0,27000,108000,81000
01SCS19E240044,AR.SLT-QB013,20ARQB0111,XL,1,304000,380000,0,0,0,0,0,76000,380000,304000
01SCS19E240045,AR.STY-SE004,20ARSE0122,ALL,1,55250,85000,2,0,17000,1,0,17000,68000,51000
01SCS19E240046,ESH.AR-SD0005,00ARSD0051,L,1,44000,135000,0,0,0,0,0,27000,135000,108000
01SCS19E240047,AR.MPR-SE012,20ARSE0182,M,1,97500,150000,2,0,45000,1,0,26250,105000,78750
01SCS19E240048,AR.HLW-SE012,20ARSE0555,S,1,100750,155000,0,0,0,0,0,54250,155000,100750
01SCS19E240049,AR.PUB-SE031,20ARSE0323,M,1,204750,315000,2,0,63000,1,0,63000,252000,189000
01SCS19E240050,AR.PUB-SE034,20ARSE0632,M,1,191750,295000,2,0,59000,1,0,59000,236000,177000
01SCS19E240051,AR.MPR-SE002,20ARSE0143,L,1,97500,150000,2,0,45000,1,0,26250,105000,78750
01SCS19E240051,BSC.AR-RK0009,00ARRK0083,L,1,108500,155000,0,0,0,0,0,31000,155000,124000
01SCS19E240051,ESH.AR-RK0019,00ARRK0197,L,1,192500,275000,0,0,0,0,0,55000,275000,220000
01SCS19E240052,AR.CPT-RI008,20ARRI0068,S,1,94250,145000,2,0,29000,1,0,29000,116000,87000
01SCS19E240053,AR.MPR-SE002,20ARSE0142,M,1,97500,150000,2,0,45000,1,0,26250,105000,78750
01SCS19E240053,AR.MPR-SE004,20ARSE0150,M,1,97500,150000,2,0,45000,1,0,26250,105000,78750
01SCS19E240053,BSC.AR-SD0044,00ARSD0235,S,1,44500,159000,0,0,0,0,0,31800,159000,127200
01SCS19E240054,BSC.AR-SD0026,00ARSD0154,L,1,44500,159000,0,0,0,0,0,31800,159000,127200
01SCS19E240055,AR.TUC-RK020,20ARRK0116,ALL,1,42250,65000,2,0,13000,1,0,13000,52000,39000
01SCS19E240056,AR.TUC-SB012,20ARSB0196,M,1,204750,315000,2,0,63000,1,0,63000,252000,189000
01SCS19E240056,BSC.AR-RJ0016,00ARRJ0100,M,1,43000,135000,0,0,0,0,0,27000,135000,108000
01SCS19E240056,BSC.AR-SD0043,00ARSD0232,M,1,44500,159000,0,0,0,0,0,31800,159000,127200
01SCS19E240056,ESH.AR-RG0005,00ARRG0101,M,1,94500,135000,0,0,0,0,0,27000,135000,108000
01SCS19E240057,AR.SMD-RI006,20ARRI0328,L,1,87750,135000,2,0,40500,1,0,23625,94500,70875
01SCS19E240057,BSC.AR-SB0005,00ARSB0061,NON,1,47500,140000,0,0,0,0,0,28000,140000,112000
01SCS19E240057,ESH.AR-SB0032,00ARSB0209,M,1,125000,315000,0,0,0,0,0,63000,315000,252000
01SCS19E240058,AR.CPT-RK007,20ARRK0023,S,1,204750,315000,2,0,63000,1,0,63000,252000,189000
01SCS19E240059,BSC.AR-SC0009,00ARSC0052,S,1,125000,315000,0,0,0,0,0,63000,315000,252000
01SCS19E240060,ESH.AR-SC0010,00ARSC0081,M,1,44500,135000,0,0,0,0,0,27000,135000,108000
01SCS19E240060,ESH.AR-SD0001,00ARSD0030,M,1,44500,135000,0,0,0,0,0,27000,135000,108000
01SCS19E240061,BSC.AR-RK0007,00ARRK0074,M,1,52000,155000,0,0,0,0,0,31000,155000,124000
01SCS19E240062,BSC.AR-SE0034,00ARSE0321,M,1,124000,370000,0,0,0,0,0,74000,370000,296000
01SCS19E240063,BSC.AR-SE0034,00ARSE0322,L,1,124000,370000,0,0,0,0,0,74000,370000,296000
01SCS19E240064,AR.PUB-SE021,20ARSE0080,M,1,159250,245000,2,0,49000,1,0,49000,196000,147000
01SCS19E240064,ESH.AR-SD0027,00ARSD0271,M,1,44000,135000,0,0,0,0,0,27000,135000,108000
01SCS19E240065,AR.PCT-SE013,20ARSE0674,M,1,87750,135000,2,0,27000,1,0,27000,108000,81000
01SCS19E240066,AR.TUC-SD007,20ARSD0165,M,1,185250,285000,2,0,57000,1,0,57000,228000,171000
01SCS19E240067,AR.TUC-SE020,20ARSE0641,L,1,204750,315000,2,0,63000,1,0,63000,252000,189000
01SCS19E240068,BE.RAK-SC019,00BESC0068,M,1,201500,310000,2,0,62000,1,0,62000,248000,186000
01SCS19E240069,AR.ESB-RH009,20ARRH0470,ALL,1,91000,140000,2,0,70000,1,0,17500,70000,52500
01SCS19E240070,ESH.AR-RJ0001,00ARRJ0012,M,1,44500,135000,0,0,0,0,0,27000,135000,108000
01SCS19E240071,AR.STY-SE012,20ARSE0578,ALL,1,55250,85000,2,0,17000,1,0,17000,68000,51000
01SCS19E240072,AR.CPT-SD008,20ARSD0443,L,1,204750,315000,2,0,63000,1,0,63000,252000,189000
01SCS19E240073,ESH.AR-SD0025,00ARSD0263,M,1,44000,135000,0,0,0,0,0,27000,135000,108000
01SCS19E240074,BSC.AR-SC0050,00ARSC0315,XL,1,44000,159000,0,0,0,0,0,31800,159000,127200
01SCS19E240075,ESH.AR-SC0017,00ARSC0140,S,1,44000,135000,0,0,0,0,0,27000,135000,108000
01SCS19E240076,AR.PUB-SE028,20ARSE0109,L,1,204750,315000,2,0,63000,1,0,63000,252000,189000
01SCS19E240076,BSC.AR-SC0013,00ARSC0094,L,1,44000,135000,0,0,0,0,0,27000,135000,108000
01SCS19E240077,AR.MKV-RJ015,20ARRJ0198,ALL,1,97500,150000,0,0,0,0,0,52500,150000,97500
01SCS19E240078,AR.TUC-SE014,20ARSE0417,L,1,94250,145000,2,0,29000,1,0,29000,116000,87000
01SCS19E240078,BSC.AR-SD0022,00ARSD0130,L,1,44000,159000,0,0,0,0,0,31800,159000,127200
01SCS19E240079,AR.PUB-SE012,20ARSE0047,L,1,97500,150000,2,0,30000,1,0,30000,120000,90000
01SCS19E240080,AR.ESB-SC020,20ARSC0469,ALL,1,68250,105000,2,0,52500,1,0,13125,52500,39375
01SCS19E240081,AR.MPR-SB008,20ARSB0265,XL,1,97500,150000,2,0,45000,1,0,26250,105000,78750
01SCS19E240082,BSC.AR-SC0023,00ARSC0173,S,1,44500,135000,0,0,0,0,0,27000,135000,108000
01SCS19E240082,ESH.AR-SD0018,00ARSD0136,S,1,125000,315000,0,0,0,0,0,63000,315000,252000
01SCS19E240083,ESH.AR-SC0025,00ARSC0215,S,1,119000,350000,0,0,0,0,0,70000,350000,280000
01SCS19E240084,ESH.AR-RK0010,00ARRK0041,S,1,44500,135000,0,0,0,0,0,27000,135000,108000
01SCS19E240085,AR.TUC-SD001,20ARSD0143,XL,1,204750,315000,2,0,63000,1,0,63000,252000,189000
01SCS19E240086,AR.TUC-SE025,20ARSE0659,28,1,204750,315000,2,0,63000,1,0,63000,252000,189000
01SCS19E240087,AR.GTW-SA002,20ARSA0300,M,1,107250,165000,2,0,49500,1,0,28875,115500,86625
01SCS19E240087,AR.YD-SB003,20ARSB0177,ALL,1,78000,120000,2,0,36000,1,0,21000,84000,63000
01SCS19E240088,AR.PUB-RH040,20ARRH0732,ALL,1,81250,125000,2,0,25000,1,0,25000,100000,75000
01SCS19E240088,AR.TUC-SB016,20ARSB0469,S,1,87750,135000,2,0,27000,1,0,27000,108000,81000
01SCS19E240088,AR.TUC-SE014,20ARSE0416,M,1,94250,145000,2,0,29000,1,0,29000,116000,87000
01SCS19E240089,ESH.AR-SE0027,00ARSE0256,M,1,44500,135000,0,0,0,0,0,27000,135000,108000
01SCS19E240090,AR.ESB-RE044,20ARRE0807,L,1,94250,145000,2,0,72500,1,0,18125,72500,54375
01SCS19E240090,AR.HLW-SE004,20ARSE0533,L,1,100750,155000,2,0,31000,1,0,31000,124000,93000
01SCS19E240091,ESH.AR-SE0006,00ARSE0021,S,1,44000,135000,0,0,0,0,0,27000,135000,108000
01SCS19E240092,AR.PUB-RJ008,20ARRJ0028,ALL,1,97500,150000,2,0,30000,1,0,30000,120000,90000
01SCS19E240092,AR.TUC-SA027,20ARSA0162,ALL,1,100750,155000,2,0,31000,1,0,31000,124000,93000
01SCS19E240092,THR.AR-RB0016,00ARRE0219,NON,1,415000,415000,0,0,0,0,0,62250,415000,352750
01SCS19E240093,BSC.AR-RL0025,00ARRL0168,L,1,94500,135000,0,0,0,0,0,27000,135000,108000
01SCS19E240094,AR.SMD-RL001,20ARRL0265,ALL,1,22750,35000,2,0,7000,1,0,7000,28000,21000
01SCS19E240095,AR.ESB-SC002,20ARSC0311,XL,1,204750,315000,2,0,63000,1,0,63000,252000,189000
01SCS19E240096,AR.TUC-SB016,20ARSB0470,M,1,87750,135000,2,0,27000,1,0,27000,108000,81000
01SCS19E240097,AR.CPT-SE001,20ARSE0352,S,1,94250,145000,2,0,29000,1,0,29000,116000,87000
01SCS19E240097,BSC.AR-SE0014,00ARSE0179,S,1,44000,159000,0,0,0,0,0,31800,159000,127200
01SCS19E240097,ESH.AR-SC0028,00ARSC0265,S,1,44500,135000,0,0,0,0,0,27000,135000,108000
01SCS19E240098,AR.MPR-SE005,20ARSE0154,M,1,97500,150000,2,0,45000,1,0,26250,105000,78750
01SCS19E240098,AR.PUB-SD034,20ARSD0341,M,1,97500,150000,2,0,30000,1,0,30000,120000,90000
01SCS19E240098,AR.PUB-SD034,20ARSD0342,L,1,97500,150000,2,0,30000,1,0,30000,120000,90000
01SCS19E240098,AR.STY-SE008,20ARSE0126,ALL,1,55250,85000,2,0,17000,1,0,17000,68000,51000
01SCS19E240099,AR.MKV-SE004,20ARSE0484,28,1,214500,330000,0,0,0,0,0,115500,330000,214500
01SCS19E240100,BSC.AR-SC0046,00ARSC0298,NON,1,45000,150000,0,0,0,0,0,30000,150000,120000
01SCS19E240101,BSC.AR-SA0021,00ARSA0106,M,1,44000,135000,0,0,0,0,0,27000,135000,108000
01SCS19E240101,BSC.AR-SD0046,00ARSD0245,L,1,44500,159000,0,0,0,0,0,31800,159000,127200
01SCS19E240102,AR.YD-SD002,20ARSD0264,S,1,87750,135000,2,0,67500,1,0,16875,67500,50625
01SCS19E240103,BSC.AR-SC0046,00ARSC0298,NON,1,45000,150000,0,0,0,0,0,30000,150000,120000
01SCS19E240103,ESH.AR-SD0031,00ARSD0299,S,1,44000,135000,0,0,0,0,0,27000,135000,108000
01SCS19E240104,BSC.AR-RL0020,00ARRL0118,M,1,125000,315000,0,0,0,0,0,63000,315000,252000
01SCS19E240104,ESH.AR-SA0001,00ARSA0014,30,1,122500,175000,0,0,0,0,0,35000,175000,140000
01SCS19E240105,AR.CPT-SC007,20ARSC0265,M,1,94250,145000,2,0,29000,1,0,29000,116000,87000
01SCS19E240105,AR.STY-RL001,20ARRL0392,ALL,1,61750,95000,2,0,19000,1,0,19000,76000,57000
01SCS19E240106,AR.BPH-RH027,20ARRH0787,L,1,187850,289000,2,0,144500,1,0,36125,144500,108375
01SCS19E240106,AR.PCT-RE012,20ARRE1437,M,1,81250,125000,2,0,62500,1,0,15625,62500,46875
01SCS19E240107,AR.MPR-SE011,20ARSE0179,L,1,97500,150000,2,0,45000,1,0,26250,105000,78750
01SCS19E240108,AR.SMD-SE003,20ARSE0441,M,1,87750,135000,2,0,27000,1,0,27000,108000,81000
01SCS19E240109,AR.ESB-RK010,20ARRK0366,M,1,87750,135000,2,0,27000,1,0,27000,108000,81000
01SCS19E240109,ESH.AR-SC0011,00ARSC0085,M,1,44000,135000,0,0,0,0,0,27000,135000,108000
01SCS19E240110,AR.CPT-SD005,20ARSD0432,ALL,1,94250,145000,2,0,29000,1,0,29000,116000,87000
01SCS19E240111,AR.PCT-SE011,20ARSE0670,M,1,211250,325000,2,0,65000,1,0,65000,260000,195000
01SCS19E240111,AR.PUB-RH021,20ARRH0288,41,1,146250,225000,2,0,45000,1,0,45000,180000,135000
01SCS19E240112,AR.FHL-SC008,20ARSC0351,ALL,1,110500,170000,2,0,34000,1,0,34000,136000,102000
01SCS19E240113,AR.TUC-SE025,20ARSE0660,30,1,204750,315000,2,0,63000,1,0,63000,252000,189000
01SCS19E240114,DKS.AR-SE0011,00ARSE0170,28,1,417272,696000,0,0,0,0,0,104400,696000,591600
01SCS19E240115,AR.SMD-SD006,20ARSD0297,M,1,87750,135000,2,0,27000,1,0,27000,108000,81000
01SCS19E240116,AR.PUB-SB025,20ARSB0134,L,1,97500,150000,2,0,30000,1,0,30000,120000,90000
01SCS19E240116,AR.SMD-SA002,20ARSA0226,XL,1,87750,135000,2,0,27000,1,0,27000,108000,81000
01SCS19E240117,AR.PUB-SE002,20ARSE0006,M,1,97500,150000,2,0,30000,1,0,30000,120000,90000
01SCS19E240118,AR.MPR-SE005,20ARSE0153,S,1,97500,150000,2,0,45000,1,0,26250,105000,78750
01SCS19E240119,ESH.AR-SE0038,00ARSE0333,M,1,44500,135000,0,0,0,0,0,27000,135000,108000
01SCS19E240120,BSC.AR-SC0007,00ARSC0042,S,1,44000,135000,0,0,0,0,0,27000,135000,108000
01SCS19E240120,ESH.AR-SC0017,00ARSC0140,S,1,44000,135000,0,0,0,0,0,27000,135000,108000
01SCS19E240121,AR.SMD-QE001,20ARQE0003,L,1,87750,135000,2,0,40500,1,0,23625,94500,70875
01SCS19E240121,AR.TUC-RC010,20ARRC0093,M,1,87750,135000,2,0,27000,1,0,27000,108000,81000
01SCS19E240122,AR.CPT-SC006,20ARSC0263,XL,1,94250,145000,2,0,29000,1,0,29000,116000,87000
01SCS19E240123,AR.PUB-SD015,20ARSD0125,S,1,97500,150000,2,0,30000,1,0,30000,120000,90000
01SCS19E240123,ESH.AR-RH0015,00ARRH0087,S,1,43000,135000,0,0,0,0,0,27000,135000,108000
01SCS19E240124,ESH.AR-SE0029,00ARSE0265,L,1,44500,135000,0,0,0,0,0,27000,135000,108000
01SCS19E240125,AR.STY-RE007,20ARRE0120,ALL,1,61750,95000,2,0,19000,1,0,19000,76000,57000
01SCS19E240125,AR.STY-RL001,20ARRL0392,ALL,1,61750,95000,2,0,19000,1,0,19000,76000,57000
01SCS19E240126,AR.SMD-RL001,20ARRL0265,ALL,1,22750,35000,2,0,7000,1,0,7000,28000,21000
01SCS19E240126,DKS.AR-SE0008,00ARSE0157,30,1,41727,696000,0,0,0,0,0,104400,696000,591600
01SCS19E240127,AR.TUC-SB001,20ARSB0025,L,1,204750,315000,2,0,63000,1,0,63000,252000,189000
01SCS19E240127,AR.YD-RL001,20ARRL0017,ALL,1,91000,140000,2,0,70000,1,0,17500,70000,52500
01SCS19E240128,BE.RAK-SC017,00BESC0059,M,1,201500,310000,2,0,62000,1,0,62000,248000,186000
01SCS19E240128,ESH.AR-SE0004,00ARSE0014,M,1,44500,135000,0,0,0,0,0,27000,135000,108000
01SCS19E240129,ESH.AR-SE0005,00ARSE0018,M,1,44500,135000,0,0,0,0,0,27000,135000,108000
01SCS19E240130,AR.HMR-SD004,20ARSD0538,M,1,273000,420000,2,0,84000,1,0,84000,336000,252000
01SCS19E240131,BSC.AR-SE0028,00ARSE0280,M,1,130000,375000,0,0,0,0,0,75000,375000,300000
01SCS19E240132,AR.ESB-SE004,20ARSE0251,M,1,94250,145000,2,0,29000,1,0,29000,116000,87000
01SCS19E240132,AR.MKV-SB012,20ARSB0544,M,1,172250,265000,0,0,0,0,0,92750,265000,172250
01SCS19E240132,BSC.AR-RK0007,00ARRK0074,M,1,52000,155000,0,0,0,0,0,31000,155000,124000
01SCS19E240133,AR.HLW-SE006,20ARSE0539,L,1,100750,155000,2,0,31000,1,0,31000,124000,93000
01SCS19E240134,AR.TUC-SE015,20ARSE0421,L,1,94250,145000,2,0,29000,1,0,29000,116000,87000
01SCS19E240135,AR.PUB-SD031,20ARSD0214,30,1,211250,325000,2,0,65000,1,0,65000,260000,195000
01SCS19E240136,AR.ESB-SC005,20ARSC0426,S,1,94250,145000,2,0,29000,1,0,29000,116000,87000
01SCS19E240136,AR.MKV-QA010,20ARQA0048,34,1,97500,150000,2,0,75000,1,0,18750,75000,56250
01SCS19E240136,ESH.AR-SE0009,00ARSE0033,S,1,44500,135000,0,0,0,0,0,27000,135000,108000
01SCS19E240137,AR.MKV-SA006,20ARSA0197,32,1,243750,375000,0,0,0,0,0,131250,375000,243750
01SCS19E240138,AR.CPT-SC007,20ARSC0265,M,1,94250,145000,2,0,29000,1,0,29000,116000,87000
01SCS19E240138,AR.PUB-SB001,20ARSB0005,ALL,1,97500,150000,2,0,30000,1,0,30000,120000,90000
01SCS19E240139,AR.STY-RJ009,20ARRJ0112,ALL,1,61750,95000,2,0,19000,1,0,19000,76000,57000
01SCS19E240140,AR.STY-RL001,20ARRL0392,ALL,1,61750,95000,2,0,19000,1,0,19000,76000,57000
01SCS19E240140,AR.STY-SE007,20ARSE0125,ALL,1,55250,85000,2,0,17000,1,0,17000,68000,51000
01SCS19E240141,AR.CPT-SC003,20ARSC0250,32,1,227500,350000,2,0,70000,1,0,70000,280000,210000
01SCS19E240142,ESH.AR-SA0013,00ARSA0097,S,1,44000,135000,0,0,0,0,0,27000,135000,108000
01SCS19E240143,AR.STY-RE007,20ARRE0120,ALL,1,61750,95000,2,0,19000,1,0,19000,76000,57000
01SCS19E240144,ESH.AR-SB0028,00ARSB0173,L,1,44000,135000,0,0,0,0,0,27000,135000,108000
01SCS19E240145,BSC.AR-SD0045,00ARSD0239,S,1,44500,159000,0,0,0,0,0,31800,159000,127200
01SCS19E240146,AR.PCT-SE016,20ARSE0681,L,1,87750,135000,2,0,27000,1,0,27000,108000,81000
01SCS19E240146,BE.RAK-SB035,00BESB0107,XL,1,91000,140000,2,0,28000,1,0,28000,112000,84000
01SCS19E240147,AR.TUC-SE014,20ARSE0416,M,1,94250,145000,2,0,29000,1,0,29000,116000,87000
01SCS19E240147,BSC.AR-RL0019,00ARRL0115,L,1,125000,315000,0,0,0,0,0,63000,315000,252000
01SCS19E240148,AR.YD-RL009,20ARRL0025,ALL,1,55250,85000,2,0,25500,1,0,14875,59500,44625
01SCS19E240148,BSC.AR-SC0029,00ARSC0201,L,1,125000,315000,0,0,0,0,0,63000,315000,252000
01SCS19E240149,ESH.AR-RH0018,00ARRH0101,L,1,94500,135000,0,0,0,0,0,27000,135000,108000
01SCS19E240150,ESH.AR-SE0009,00ARSE0034,M,1,44500,135000,0,0,0,0,0,27000,135000,108000
01SCS19E240151,BSC.AR-RK0007,00ARRK0073,S,1,52000,155000,0,0,0,0,0,31000,155000,124000
01SCS19E240152,AR.ASH-RE009,20ARRE1374,32,1,273000,420000,2,0,210000,1,0,52500,210000,157500
01SCS19E240153,AR.SMD-RC001,20ARRC0618,ALL,1,97500,150000,2,0,45000,1,0,26250,105000,78750
01SCS19E240154,AR.ESB-SC018,20ARSC0466,L,1,91000,140000,2,0,28000,1,0,28000,112000,84000
01SCS19E240154,ESH.AR-SD0044,00ARSD0400,L,1,125000,315000,0,0,0,0,0,63000,315000,252000
01SCS19E240155,AR.MKV-SE016,20ARSE0595,S,1,22750,350000,0,0,0,0,0,122500,350000,227500
01SCS19E240155,AR.STY-SE004,20ARSE0122,ALL,2,55250,85000,2,0,17000,1,0,17000,136000,102000
01SCS19E240156,AR.SMD-RE008,20ARRE1125,L,1,87750,135000,2,0,40500,1,0,23625,94500,70875
01SCS19E240156,BSC.AR-SC0048,00ARSC0305,M,1,44500,159000,0,0,0,0,0,31800,159000,127200
01SCS19E240156,BSC.AR-SD0066,00ARSD0356,M,1,44500,159000,0,0,0,0,0,31800,159000,127200
01SCS19E240156,ESH.AR-RK0019,00ARRK0197,L,1,192500,275000,0,0,0,0,0,55000,275000,220000
01SCS19E240156,ESH.AR-SB0015,00ARSB0064,L,1,125000,315000,0,0,0,0,0,63000,315000,252000
01SCS19E240157,AR.STY-RE007,20ARRE0120,ALL,1,61750,95000,2,0,19000,1,0,19000,76000,57000
01SCS19E240158,ESH.AR-SE0017,00ARSE0114,M,1,44000,135000,0,0,0,0,0,27000,135000,108000
01SCS19E240159,AR.PUB-SB029,20ARSB0449,M,1,97500,150000,2,0,30000,1,0,30000,120000,90000
01SCS19E240160,AR.MKV-SA006,20ARSA0196,30,1,243750,375000,0,0,0,0,0,131250,375000,243750
01SCS19E240160,AR.MPR-SE037,20ARSE0313,ALL,1,130000,200000,2,0,40000,1,0,40000,160000,120000
01SCS19E240161,BSC.AR-SD0004,00ARSD0014,M,1,44000,159000,0,0,0,0,0,31800,159000,127200
01SCS19E240161,ESH.AR-SD0011,00ARSD0074,M,1,125000,315000,0,0,0,0,0,63000,315000,252000
01SCS19E240162,DKS.AR-SE0004,00ARSE0140,30,1,417272,696000,0,0,0,0,0,104400,696000,591600
01SCS19E240163,AR.TUC-SE009,20ARSE0398,L,1,204750,315000,2,0,63000,1,0,63000,252000,189000
01SCS19E240164,AR.MKV-SE017,20ARSE0599,S,1,97500,150000,0,0,0,0,0,52500,150000,97500
01SCS19E240164,AR.PUB-SE010,20ARSE0039,L,1,97500,150000,2,0,30000,1,0,30000,120000,90000
01SCS19E240164,ESH.AR-RJ0026,00ARRJ0228,M,1,220500,315000,0,0,0,0,0,63000,315000,252000
01SCS19E240165,AR.PUB-RI017,20ARRI0262,M,1,97500,150000,2,0,30000,1,0,30000,120000,90000
01SCS19E240165,BSC.AR-SC0043,00ARSC0288,S,1,44000,135000,0,0,0,0,0,27000,135000,108000
01SCS19E240165,ESH.AR-SE0005,00ARSE0017,S,1,44500,135000,0,0,0,0,0,27000,135000,108000
01SCS19E240166,BSC.AR-SD0064,00ARSD0340,M,1,125000,315000,0,0,0,0,0,63000,315000,252000
01SCS19E240167,AR.STY-RL001,20ARRL0392,ALL,1,61750,95000,2,0,19000,1,0,19000,76000,57000
01SCS19E240167,AR.STY-SA012,20ARSA0071,ALL,1,55250,85000,2,0,17000,1,0,17000,68000,51000
01SCS19E240168,AR.TUC-SE014,20ARSE0416,M,1,94250,145000,2,0,29000,1,0,29000,116000,87000
01SCS19E240168,BSC.AR-SD0055,00ARSD0288,NON,1,50000,150000,0,0,0,0,0,30000,150000,120000
01SCS19E240169,AR.PUB-SD032,20ARSD0241,XL,1,204750,315000,2,0,63000,1,0,63000,252000,189000
01SCS19E240169,AR.RDC-RK007,20ARRK0479,L,1,97500,150000,2,0,30000,1,0,30000,120000,90000
01SCS19E240170,AR.MPR-SE005,20ARSE0154,M,1,97500,150000,2,0,45000,1,0,26250,105000,78750
01SCS19E240170,ESH.AR-SE0017,00ARSE0114,M,1,44000,135000,0,0,0,0,0,27000,135000,108000
01SCS19E240171,BE.RAK-RX597,00BERX2528,M,1,91000,140000,2,0,28000,1,0,28000,112000,84000
01SCS19E240172,AR.PUB-SE024,20ARSE0092,M,1,159250,245000,2,0,49000,1,0,49000,196000,147000
01SCS19E240173,AR.VCS-RI005,20ARRI0287,M,1,243750,375000,2,0,112500,1,0,65625,262500,196875
01SCS19E240174,AR.ESB-SC004,20ARSC0423,M,1,94250,145000,2,0,29000,1,0,29000,116000,87000
01SCS19E240175,AR.TUC-SE014,20ARSE0417,L,1,94250,145000,2,0,29000,1,0,29000,116000,87000
01SCS19E240176,AR.MKV-SE001,20ARSE0470,30,1,214500,330000,0,0,0,0,0,115500,330000,214500
01SCS19E240177,BSC.AR-RH0017,00ARRH0076,L,1,120000,315000,0,0,0,0,0,63000,315000,252000
01SCS19E240178,AR.SMD-SD005,20ARSD0292,S,1,87750,135000,2,0,27000,1,0,27000,108000,81000
01SCS19E240179,AR.ESB-QJ014,20ARQJ0095,ALL,1,91000,140000,2,0,70000,1,0,17500,70000,52500
01SCS19E240179,AR.PUB-SE010,20ARSE0039,L,1,97500,150000,2,0,30000,1,0,30000,120000,90000
01SCS19E240179,AR.TUC-SD012,20ARSD0467,L,1,94250,145000,2,0,29000,1,0,29000,116000,87000
01SCS19E240180,AR.MKV-SE003,20ARSE0480,30,1,224250,345000,0,0,0,0,0,120750,345000,224250
01SCS19E240180,AR.TUC-SE024,20ARSE0657,32,1,204750,315000,2,0,63000,1,0,63000,252000,189000
01SCS19E240181,AR.YD-RL013,20ARRL0032,XL,1,195000,300000,2,0,90000,1,0,52500,210000,157500
01SCS19E240182,DKS.AR-SE0005,00ARSE0143,30,1,417272,696000,0,0,0,0,0,104400,696000,591600
01SCS19E240183,BE.RAK-RX355,00BERX1305,M,1,91000,140000,2,0,28000,1,0,28000,112000,84000
01SCS19E240184,BE.RAK-SD016,00BESD0076,S,1,91000,140000,2,0,28000,1,0,28000,112000,84000
01SCS19E240185,AR.HMR-SB020,20ARSB0394,36,1,204750,315000,2,0,63000,1,0,63000,252000,189000
01SCS19E240186,AR.MKV-SA006,20ARSA0195,28,1,243750,375000,0,0,0,0,0,131250,375000,243750
01SCS19E240187,BSC.AR-SA0013,00ARSA0039,NON,1,47500,140000,0,0,0,0,0,28000,140000,112000
01SCS19E240188,ESH.AR-SD0021,00ARSD0166,L,1,125000,315000,0,0,0,0,0,63000,315000,252000
01SCS19E240189,ESH.AR-SA0016,00ARSA0115,NON,1,55000,150000,0,0,0,0,0,30000,150000,120000
01SCS19E240190,AR.PUB-RJ038,20ARRJ0501,S,1,97500,150000,2,0,30000,1,0,30000,120000,90000
01SCS19E240190,AR.TUC-SB019,20ARSB0481,M,1,87750,135000,2,0,27000,1,0,27000,108000,81000
01SCS19E240191,ESH.AR-RH0018,00ARRH0101,L,1,94500,135000,0,0,0,0,0,27000,135000,108000
01SCS19E240191,ESH.AR-SA0012,00ARSA0094,M,1,44000,135000,0,0,0,0,0,27000,135000,108000
01SCS19E240192,BE.RAK-SA027,00BESA0111,S,1,104000,160000,2,0,32000,1,0,32000,128000,96000
01SCS19E240193,ESH.AR-SE0038,00ARSE0332,S,1,44500,135000,0,0,0,0,0,27000,135000,108000
01SCS19E240194,AR.BPH-RH010,20ARRH0363,M,1,214500,330000,2,0,165000,1,0,41250,165000,123750
01SCS19E240195,AR.SMD-RI001,20ARRI0220,M,1,87750,135000,2,0,40500,1,0,23625,94500,70875
01SCS19E240196,AR.CPT-SE006,20ARSE0373,M,1,204750,315000,2,0,63000,1,0,63000,252000,189000
01SCS19E240197,AR.CPT-RE013,20ARRE0718,M,1,94250,145000,2,0,29000,1,0,29000,116000,87000
01SCS19E240197,AR.PCT-SE018,20ARSE0684,M,1,87750,135000,2,0,27000,1,0,27000,108000,81000
01SCS19E240198,BSC.AR-SB0011,00ARSB0096,S,1,44500,135000,0,0,0,0,0,27000,135000,108000
01SCS19E240199,AR.MKV-PL032,20ARPL0506,32,1,214500,330000,2,0,165000,1,0,41250,165000,123750
01SCS19E240199,ESH.AR-RI0018,00ARRI0146,NON,1,39000,140000,0,0,0,0,0,28000,140000,112000
01SCS19E240200,AR.CPT-SC007,20ARSC0265,M,1,94250,145000,2,0,29000,1,0,29000,116000,87000
01SCS19E240201,ESH.AR-SE0004,00ARSE0014,M,1,44500,135000,0,0,0,0,0,27000,135000,108000
01SCS19E240201,ESH.AR-SE0011,00ARSE0041,S,1,44500,135000,0,0,0,0,0,27000,135000,108000
01SCS19E240202,AR.MPR-SE030,20ARSE0292,M,1,230750,355000,2,0,71000,1,0,71000,284000,213000
01SCS19E240202,AR.TUC-SE008,20ARSE0391,S,1,204750,315000,2,0,63000,1,0,63000,252000,189000
01SCS19E240203,BSC.AR-SC0038,00ARSC0249,S,1,190000,475000,0,0,0,0,0,95000,475000,380000
01SCS19E240203,ESH.AR-SD0008,00ARSD0061,S,1,44500,135000,0,0,0,0,0,27000,135000,108000
01SCS19E240204,BSC.AR-SC0022,00ARSC0169,S,1,44500,135000,0,0,0,0,0,27000,135000,108000
01SCS19E240205,AR.MKV-RL005,20ARRL0253,34,1,227500,350000,0,0,0,0,0,122500,350000,227500
01SCS19E240205,AR.PUB-RJ042,20ARRJ0519,L,1,97500,150000,2,0,30000,1,0,30000,120000,90000
01SCS19E240205,AR.TUC-RL019,20ARRL0343,ALL,1,87750,135000,2,0,27000,1,0,27000,108000,81000
01SCS19E240206,BSC.AR-RH0030,00ARRH0184,XL,1,37000,155000,0,0,0,0,0,31000,155000,124000
01SCS19E240207,AR.MPR-SE020,20ARSE0204,ALL,1,97500,150000,2,0,45000,1,0,26250,105000,78750
01SCS19E240207,BE.RAK-SC052,00BESC0201,M,1,110500,170000,2,0,34000,1,0,34000,136000,102000
01SCS19E240208,AR.ESB-SE004,20ARSE0252,L,1,94250,145000,2,0,29000,1,0,29000,116000,87000
01SCS19E240208,ESH.AR-SE0027,00ARSE0256,M,1,44500,135000,0,0,0,0,0,27000,135000,108000
01SCS19E240209,ESH.AR-SE0009,00ARSE0034,M,1,44500,135000,0,0,0,0,0,27000,135000,108000
01SCS19E240210,AR.ESB-SE012,20ARSE0283,M,1,198250,305000,2,0,61000,1,0,61000,244000,183000
01SCS19E240210,AR.MKV-SE017,20ARSE0600,M,1,97500,150000,0,0,0,0,0,52500,150000,97500
01SCS19E240210,BSC.AR-SD0039,00ARSD0212,M,1,125000,315000,0,0,0,0,0,63000,315000,252000
01SCS19E240210,ESH.AR-SD0005,00ARSD0050,M,1,44000,135000,0,0,0,0,0,27000,135000,108000
01SCS19E240211,BSC.AR-SD0061,00ARSD0336,NON,1,45000,150000,0,0,0,0,0,30000,150000,120000
01SCS19E240212,AR.TUC-SE025,20ARSE0659,28,1,204750,315000,2,0,63000,1,0,63000,252000,189000
01SCS19E240213,AR.YD-SC001,20ARSC0020,XL,1,195000,300000,2,0,90000,1,0,52500,210000,157500
01SCS19E240214,AR.PUB-SD034,20ARSD0343,XL,1,97500,150000,2,0,30000,1,0,30000,120000,90000
01SCS19E240214,AR.SMD-SD006,20ARSD0298,L,1,87750,135000,2,0,27000,1,0,27000,108000,81000
01SCS19E240215,AR.TUC-SE023,20ARSE0652,30,1,204750,315000,2,0,63000,1,0,63000,252000,189000
01SCS19E240216,AR.VCS-RI005,20ARRI0288,L,1,243750,375000,2,0,112500,1,0,65625,262500,196875
01SCS19E240217,AR.CPT-RE013,20ARRE0718,M,1,94250,145000,2,0,29000,1,0,29000,116000,87000
01SCS19E240218,AR.MDG-RJ001,20ARRJ0546,S,1,94250,145000,2,0,43500,1,0,25375,101500,76125
01SCS19E240218,AR.STY-SE009,20ARSE0127,ALL,1,55250,85000,2,0,17000,1,0,17000,68000,51000
01SCS19E240218,AR.YD-SC001,20ARSC0018,M,1,195000,300000,2,0,90000,1,0,52500,210000,157500
01SCS19E240218,ESH.AR-SD0010,00ARSD0070,M,1,44500,135000,0,0,0,0,0,27000,135000,108000
01SCS19E240219,ESH.AR-SE0030,00ARSE0267,S,1,125000,315000,0,0,0,0,0,63000,315000,252000
01SCS19E240220,BSC.AR-SC0031,00ARSC0207,S,1,44500,135000,0,0,0,0,0,27000,135000,108000
01SCS19E240221,ESH.AR-RJ0013,00ARRJ0176,M,1,94500,135000,0,0,0,0,0,27000,135000,108000
01SCS19E240222,AR.PCT-SE011,20ARSE0670,M,1,211250,325000,2,0,65000,1,0,65000,260000,195000
01SCS19E240223,ESH.AR-SD0028,00ARSD0274,S,1,44500,135000,0,0,0,0,0,27000,135000,108000
01SCS19E240224,AR.FHL-SC005,20ARSC0343,M,1,110500,170000,2,0,34000,1,0,34000,136000,102000
01SCS19E240225,AR.TUC-SE015,20ARSE0420,M,1,94250,145000,2,0,29000,1,0,29000,116000,87000
01SCS19E240225,AR.TUC-SE020,20ARSE0640,M,1,204750,315000,2,0,63000,1,0,63000,252000,189000
01SCS19E240226,ESH.AR-SD0011,00ARSD0074,M,1,125000,315000,0,0,0,0,0,63000,315000,252000
01SCS19E240227,AR.YD-RL017,20ARRL0047,M,1,91000,140000,2,0,70000,1,0,17500,70000,52500
01SCS19E240228,AR.MKV-RB004,20ARRB0036,L,1,263250,405000,0,0,0,0,0,141750,405000,263250
01SCS19E240229,AR.PUB-SB029,20ARSB0448,S,1,97500,150000,2,0,30000,1,0,30000,120000,90000
01SCS19E240230,AR.YRX-RH001,20ARRH0718,ALL,1,172250,265000,2,0,53000,1,0,53000,212000,159000
01SCS19E240231,ESH.AR-SD0041,00ARSD0370,S,1,125000,315000,0,0,0,0,0,63000,315000,252000
01SCS19E240232,BSC.AR-RL0018,00ARRL0109,S,1,125000,315000,0,0,0,0,0,63000,315000,252000
01SCS19E240233,AR.FHL-SC006,20ARSC0348,L,1,110500,170000,2,0,34000,1,0,34000,136000,102000
01SCS19E240233,AR.PUB-SC015,20ARSC0361,M,1,97500,150000,2,0,30000,1,0,30000,120000,90000
01SCS19E240233,AR.TUC-SA002,20ARSA0007,L,1,204750,315000,2,0,63000,1,0,63000,252000,189000
01SCS19E240233,BE.RAK-SB012,00BESB0059,XL,1,201500,310000,2,0,62000,1,0,62000,248000,186000
01SCS19E240233,ESH.AR-SD0010,00ARSD0070,M,1,44500,135000,0,0,0,0,0,27000,135000,108000
01SCS19E240233,ESH.AR-SE0010,00ARSE0038,M,1,44000,135000,0,0,0,0,0,27000,135000,108000
01SCS19E240234,AR.MPR-SE022,20ARSE0207,M,1,243750,375000,2,0,75000,1,0,75000,300000,225000
01SCS19E240235,ESH.AR-SC0028,00ARSC0265,S,1,44500,135000,0,0,0,0,0,27000,135000,108000
01SCS19E240236,ESH.AR-SC0007,00ARSC0061,M,1,125000,350000,0,0,0,0,0,70000,350000,280000
01SCS19E240237,BSC.AR-RJ0020,00ARRJ0115,S,1,44500,135000,0,0,0,0,0,27000,135000,108000
01SCS19E240238,AR.VLD-RK019,20ARRK0353,S,1,91000,140000,2,0,42000,1,0,24500,98000,73500
01SCS19E240238,BSC.AR-RL0020,00ARRL0118,M,1,125000,315000,0,0,0,0,0,63000,315000,252000
01SCS19E240238,BSC.AR-SC0043,00ARSC0289,M,1,44000,135000,0,0,0,0,0,27000,135000,108000
01SCS19E240238,BSC.AR-SD0004,00ARSD0014,M,1,44000,159000,0,0,0,0,0,31800,159000,127200
01SCS19E240239,AR.MKV-RJ005,20ARRJ0161,M,1,91000,140000,0,0,0,0,0,49000,140000,91000
01SCS19E240240,BSC.AR-SD0003,00ARSD0009,S,1,44000,159000,0,0,0,0,0,31800,159000,127200
01SCS19E240240,ESH.AR-SE0036,00ARSE0325,M,1,44500,135000,0,0,0,0,0,27000,135000,108000
01SCS19E240241,AR.MPR-SE035,20ARSE0311,ALL,1,136500,210000,2,0,42000,1,0,42000,168000,126000
01SCS19E240241,AR.TUC-SA002,20ARSA0005,S,1,204750,315000,2,0,63000,1,0,63000,252000,189000
01SCS19E240242,AR.TUC-RL013,20ARRL0337,ALL,1,87750,135000,2,0,27000,1,0,27000,108000,81000
01SCS19E240243,BSC.AR-SE0031,00ARSE0291,S,1,52000,155000,0,0,0,0,0,31000,155000,124000
01SCS19E240243,ESH.AR-SD0032,00ARSD0303,S,1,44500,135000,0,0,0,0,0,27000,135000,108000
01SCS19E240244,BSC.AR-SD0027,00ARSD0156,S,1,125000,315000,0,0,0,0,0,63000,315000,252000
01SCS19E240245,AR.ESB-RH013,20ARRH0482,M,1,87750,135000,2,0,67500,1,0,16875,67500,50625
01SCS19E240246,ESH.AR-SD0026,00ARSD0268,L,1,44500,135000,0,0,0,0,0,27000,135000,108000
01SCS19E240247,AR.YD-SD002,20ARSD0266,L,1,87750,135000,2,0,67500,1,0,16875,67500,50625
01SCS19E240248,AR.MKV-SB008,20ARSB0333,L,1,292500,450000,0,0,0,0,0,157500,450000,292500
01SCS19E240248,AR.TUC-SB017,20ARSB0475,L,1,87750,135000,2,0,27000,1,0,27000,108000,81000
01SCS19E240249,AR.MPR-SE030,20ARSE0294,XL,1,230750,355000,2,0,71000,1,0,71000,284000,213000
01SCS19E240250,AR.ESB-SC003,20ARSC0420,L,1,91000,140000,2,0,28000,1,0,28000,112000,84000
01SCS19E240251,AR.TUC-SE006,20ARSE0385,L,1,204750,315000,2,0,63000,1,0,63000,252000,189000
01SCS19E240252,BSC.AR-SB0010,00ARSB0092,S,1,125000,315000,0,0,0,0,0,63000,315000,252000
01SCS19E240253,AR.ESB-RK002,20ARRK0228,M,1,198250,305000,2,0,61000,1,0,61000,244000,183000
01SCS19E240254,AR.STY-SE001,20ARSE0119,ALL,1,83850,129000,2,0,25800,1,0,25800,103200,77400
01SCS19E240254,ESH.AR-SC0018,00ARSC0144,S,1,44000,135000,0,0,0,0,0,27000,135000,108000
01SCS19E240255,BSC.AR-SA0008,00ARSA0034,NON,1,47500,140000,0,0,0,0,0,28000,140000,112000
01SCS19E240256,AR.CPT-QL011,20ARQL0167,M,1,204750,315000,2,0,63000,1,0,63000,252000,189000
01SCS19E240257,ESH.AR-SD0026,00ARSD0268,L,1,44500,135000,0,0,0,0,0,27000,135000,108000
01SCS19E240258,AR.TUC-SE023,20ARSE0652,30,1,204750,315000,2,0,63000,1,0,63000,252000,189000
01SCS19E240259,BSC.AR-SC0021,00ARSC0148,NON,1,73000,220000,0,0,0,0,0,44000,220000,176000
01SCS19E240260,ESH.AR-RH0016,00ARRH0092,M,1,43000,135000,0,0,0,0,0,27000,135000,108000
01SCS19E240261,AR.SMD-SD012,20ARSD0565,S,1,87750,135000,2,0,27000,1,0,27000,108000,81000
01SCS19E240262,ESH.AR-SD0038,00ARSD0345,L,1,122500,350000,0,0,0,0,0,70000,350000,280000
01SCS19E240263,AR.PCT-SE017,20ARSE0683,L,1,87750,135000,2,0,27000,1,0,27000,108000,81000
01SCS19E240263,ESH.AR-SE0011,00ARSE0043,L,1,44500,135000,0,0,0,0,0,27000,135000,108000
01SCS19E240264,AR.PUB-SC013,20ARSC0353,M,1,97500,150000,2,0,30000,1,0,30000,120000,90000
01SCS19E240264,AR.TUC-SE015,20ARSE0420,M,1,94250,145000,2,0,29000,1,0,29000,116000,87000
01SCS19E240265,ESH.AR-SD0040,00ARSD0367,M,1,122500,350000,0,0,0,0,0,70000,350000,280000
01SCS19E240266,BE.RAK-SA005,00BESA0019,L,1,204750,315000,2,0,63000,1,0,63000,252000,189000
01SCS19E240267,ESH.AR-SC0008,00ARSC0069,M,1,44500,135000,0,0,0,0,0,27000,135000,108000
01SCS19E240267,ESH.AR-SE0017,00ARSE0114,M,1,44000,135000,0,0,0,0,0,27000,135000,108000
01SCS19E240268,AR.CPT-RE010,20ARRE0707,L,1,204750,315000,2,0,63000,1,0,63000,252000,189000
01SCS19E240268,AR.TUC-SE007,20ARSE0388,M,1,204750,315000,2,0,63000,1,0,63000,252000,189000
01SCS19E240269,AR.HMR-SB032,20ARSB0446,32,1,204750,315000,2,0,63000,1,0,63000,252000,189000
01SCS19E240270,AR.MPR-SE030,20ARSE0293,L,1,230750,355000,2,0,71000,1,0,71000,284000,213000
01SCS19E240271,AR.TUC-SE017,20ARSE0428,L,1,146250,225000,2,0,45000,1,0,45000,180000,135000
01SCS19E240272,BE.RAK-SA007,00BESA0030,XL,1,243750,375000,2,0,75000,1,0,75000,300000,225000
01SCS19E240273,AR.ESB-RL012,20ARRL0463,ALL,1,91000,140000,2,0,70000,1,0,17500,70000,52500
01SCS19E240273,AR.TUC-SE011,20ARSE0405,L,1,94250,145000,2,0,29000,1,0,29000,116000,87000
01SCS19E240274,ESH.AR-SA0007,00ARSA0075,S,1,44000,135000,0,0,0,0,0,27000,135000,108000
01SCS19E240274,ESH.AR-SD0032,00ARSD0303,S,1,44500,135000,0,0,0,0,0,27000,135000,108000
01SCS19E240275,ESH.AR-SC0010,00ARSC0083,XL,1,44500,135000,0,0,0,0,0,27000,135000,108000
01SCS19E240276,BSC.AR-SE0007,00ARSE0081,S,1,44500,159000,0,0,0,0,0,31800,159000,127200
01SCS19E240277,AR.CPT-QL011,20ARQL0167,M,1,204750,315000,2,0,63000,1,0,63000,252000,189000
01SCS19E240277,AR.HLW-SE001,20ARSE0526,ALL,1,71500,110000,2,0,22000,1,0,22000,88000,66000
01SCS19E240277,AR.PUB-SD031,20ARSD0215,32,1,211250,325000,2,0,65000,1,0,65000,260000,195000
01SCS19E240277,AR.STY-SE009,20ARSE0127,ALL,1,55250,85000,2,0,17000,1,0,17000,68000,51000
01SCS19E240278,AR.MKV-RJ028,20ARRJ0227,32,1,214500,330000,0,0,0,0,0,115500,330000,214500
01SCS19E240279,AR.BPH-RH010,20ARRH0363,M,1,214500,330000,2,0,165000,1,0,41250,165000,123750
01SCS19E240279,AR.PUB-SB029,20ARSB0449,M,1,97500,150000,2,0,30000,1,0,30000,120000,90000
01SCS19E240280,ESH.AR-SD0021,00ARSD0166,L,1,125000,315000,0,0,0,0,0,63000,315000,252000
01SCS19E240281,AR.ASH-RK003,20ARRK0512,M,1,195000,300000,2,0,90000,1,0,52500,210000,157500
01SCS19E240282,AR.MKV-SA006,20ARSA0196,30,1,243750,375000,0,0,0,0,0,131250,375000,243750
01SCS19E240283,ESH.AR-SE0004,00ARSE0014,M,1,44500,135000,0,0,0,0,0,27000,135000,108000
01SCS19E240284,AR.MPR-SE031,20ARSE0295,S,1,230750,355000,2,0,71000,1,0,71000,284000,213000
01SCS19E240285,BSC.AR-SD0004,00ARSD0014,M,1,44000,159000,0,0,0,0,0,31800,159000,127200
01SCS19E240286,AR.TUC-RI007,20ARRI0353,XL,1,87750,135000,2,0,27000,1,0,27000,108000,81000
01SCS19E240287,AR.PCT-SE017,20ARSE0682,M,1,87750,135000,2,0,27000,1,0,27000,108000,81000
01SCS19E240288,AR.MPR-SE030,20ARSE0292,M,1,230750,355000,2,0,71000,1,0,71000,284000,213000
01SCS19E240289,ESH.AR-SC0028,00ARSC0265,S,1,44500,135000,0,0,0,0,0,27000,135000,108000
01SCS19E240289,ESH.AR-SD0032,00ARSD0303,S,1,44500,135000,0,0,0,0,0,27000,135000,108000
01SCS19E240290,AR.TUC-SE009,20ARSE0398,L,1,204750,315000,2,0,63000,1,0,63000,252000,189000
01SCS19E240291,AR.MKV-RL001,20ARRL0237,L,1,204750,315000,0,0,0,0,0,110250,315000,204750
01SCS19E240292,ESH.AR-SC0009,00ARSC0077,M,1,44500,135000,0,0,0,0,0,27000,135000,108000
01SCS19E240293,BSC.AR-RH0025,00ARRH0161,L,1,115000,350000,0,0,0,0,0,70000,350000,280000
01SCS19E240294,AR.YD-SC001,20ARSC0018,M,1,195000,300000,2,0,90000,1,0,52500,210000,157500
01SCS19E240294,ESH.AR-RH0004,00ARRH0037,S,1,94500,135000,0,0,0,0,0,27000,135000,108000
01SCS19E240295,AR.PCT-SE017,20ARSE0682,M,1,87750,135000,2,0,27000,1,0,27000,108000,81000
01SCS19E240296,AR.SMD-SD006,20ARSD0297,M,1,87750,135000,2,0,27000,1,0,27000,108000,81000
01SCS19E240297,AR.TUC-SE011,20ARSE0405,L,1,94250,145000,2,0,29000,1,0,29000,116000,87000
01SCS19E240297,AR.TUC-SE020,20ARSE0640,M,1,204750,315000,2,0,63000,1,0,63000,252000,189000
01SCS19E240297,AR.YD-SB005,20ARSB0508,S,1,195000,300000,2,0,90000,1,0,52500,210000,157500
01SCS19E240297,ESH.AR-SE0027,00ARSE0256,M,1,44500,135000,0,0,0,0,0,27000,135000,108000
01SCS19E250001,BSC.AR-RH0020,00ARRH0116,M,1,52000,155000,0,0,0,0,0,31000,155000,124000
01SCS19E250002,AR.TUC-RK009,20ARRK0105,ALL,1,87750,135000,2,0,27000,1,0,27000,108000,81000
01SCS19E250003,AR.ESB-RH004,20ARRH0193,ALL,1,91000,140000,2,0,70000,1,0,17500,70000,52500
01SCS19E250003,AR.MPR-SE031,20ARSE0296,M,1,230750,355000,2,0,71000,1,0,71000,284000,213000
01SCS19E250004,AR.HLW-SC004,20ARSC0128,L,1,195000,300000,2,0,90000,1,0,52500,210000,157500
01SCS19E250005,AR.PUB-SE028,20ARSE0107,S,1,204750,315000,2,0,63000,1,0,63000,252000,189000
01SCS19E250006,AR.FHL-SE002,20ARSE0377,ALL,1,78000,120000,2,0,24000,1,0,24000,96000,72000
01SCS19E250007,AR.MPR-SE015,20ARSE0193,S,1,256750,395000,2,0,79000,1,0,79000,316000,237000
01SCS19E250008,AR.ESB-SC011,20ARSC0435,ALL,1,123500,190000,2,0,57000,1,0,33250,133000,99750
01SCS19E250008,ESH.AR-SE0004,00ARSE0015,L,1,44500,135000,0,0,0,0,0,27000,135000,108000
01SCS19E250009,BSC.AR-RL0020,00ARRL0117,S,1,125000,315000,0,0,0,0,0,63000,315000,252000
01SCS19E250010,AR.PUB-SE008,20ARSE0030,M,1,97500,150000,2,0,30000,1,0,30000,120000,90000
01SCS19E250011,AR.FHL-RJ003,20ARRJ0424,S,1,91000,140000,2,0,28000,1,0,28000,112000,84000
01SCS19E250011,AR.FHL-SC004,20ARSC0339,M,1,91000,140000,2,0,28000,1,0,28000,112000,84000
01SCS19E250011,AR.MKV-SE004,20ARSE0485,30,1,214500,330000,0,0,0,0,0,115500,330000,214500
01SCS19E250011,AR.MKV-SE017,20ARSE0601,L,1,97500,150000,0,0,0,0,0,52500,150000,97500
01SCS19E250011,AR.TUC-SD015,20ARSD0478,M,1,145000,145000,2,0,29000,1,0,29000,116000,87000
01SCS19E250011,BSC.AR-SC0003,00ARSC0025,NON,1,73000,220000,0,0,0,0,0,44000,220000,176000
01SCS19E250011,ESH.AR-RD0007,00ARRD0054,NON,1,80500,115000,0,0,0,0,0,23000,115000,92000
01SCS19E250011,ESH.AR-RH0020,00ARRH0108,M,1,94500,135000,0,0,0,0,0,27000,135000,108000
01SCS19E250011,ESH.AR-RJ0019,00ARRJ0206,NON,1,40000,115000,0,0,0,0,0,23000,115000,92000
01SCS19E250012,BSC.AR-SD0046,00ARSD0243,S,1,44500,159000,0,0,0,0,0,31800,159000,127200
01SCS19E250013,AR.STY-SE009,20ARSE0127,ALL,1,55250,85000,2,0,17000,1,0,17000,68000,51000
01SCS19E250014,AR.MKV-RG003,20ARRG0089,ALL,1,78000,120000,0,0,0,0,0,42000,120000,78000
01SCS19E250015,DKS.AR-SE0009,00ARSE0161,30,1,417272,696000,0,0,0,0,0,104400,696000,591600
01SCS19E250016,ESH.AR-SD0021,00ARSD0165,M,1,125000,315000,0,0,0,0,0,63000,315000,252000
01SCS19E250017,BE.RAK-SB010,00BESB0047,M,1,201500,310000,2,0,62000,1,0,62000,248000,186000
01SCS19E250018,BSC.AR-SD0053,00ARSD0284,M,1,44000,159000,0,0,0,0,0,31800,159000,127200
01SCS19E250019,BSC.AR-SB0006,00ARSB0070,S,1,44000,135000,0,0,0,0,0,27000,135000,108000
01SCS19E250020,BSC.AR-SA0007,00ARSA0031,M,1,44500,135000,0,0,0,0,0,27000,135000,108000
01SCS19E250020,BSC.AR-SD0036,00ARSD0199,S,1,44500,159000,0,0,0,0,0,31800,159000,127200
01SCS19E250021,BSC.AR-SD0052,00ARSD0280,M,1,44500,159000,0,0,0,0,0,31800,159000,127200
01SCS19E250021,ESH.AR-SE0029,00ARSE0263,S,1,44500,135000,0,0,0,0,0,27000,135000,108000
01SCS19E250022,BSC.AR-SD0022,00ARSD0128,S,1,44000,159000,0,0,0,0,0,31800,159000,127200
01SCS19E250022,BSC.AR-SE0027,00ARSE0275,S,1,52000,155000,0,0,0,0,0,31000,155000,124000
01SCS19E250022,ESH.AR-SE0036,00ARSE0325,M,1,44500,135000,0,0,0,0,0,27000,135000,108000
01SCS19E250023,AR.TUC-SE019,20ARSE0636,M,1,204750,315000,2,0,63000,1,0,63000,252000,189000
01SCS19E250024,AR.MKV-SD005,20ARSD0236,L,1,172250,265000,0,0,0,0,0,92750,265000,172250
01SCS19E250025,ESH.AR-SC0014,00ARSC0109,M,1,44500,135000,0,0,0,0,0,27000,135000,108000
01SCS19E250026,BSC.AR-SB0006,00ARSB0070,S,1,44000,135000,0,0,0,0,0,27000,135000,108000
01SCS19E250026,BSC.AR-SB0014,00ARSB0110,S,1,44000,135000,0,0,0,0,0,27000,135000,108000
01SCS19E250027,AR.ESB-SB003,20ARSB0102,L,1,100750,155000,2,0,31000,1,0,31000,124000,93000
01SCS19E250028,BSC.AR-SA0007,00ARSA0031,M,1,44500,135000,0,0,0,0,0,27000,135000,108000
01SCS19E250028,BSC.AR-SD0043,00ARSD0232,M,1,44500,159000,0,0,0,0,0,31800,159000,127200
01SCS19E250029,AR.BPH-RB021,20ARRB0524,S,1,214500,330000,2,0,165000,1,0,41250,165000,123750
01SCS19E250029,AR.CPT-SE002,20ARSE0356,S,1,94250,145000,2,0,29000,1,0,29000,116000,87000
01SCS19E250030,BSC.AR-SD0057,00ARSD0293,NON,1,45000,140000,0,0,0,0,0,28000,140000,112000
01SCS19E250030,BSC.AR-SE0036,00ARSE0341,28,1,125000,365000,0,0,0,0,0,73000,365000,292000
01SCS19E250031,AR.PUB-QE031,20ARQE0217,36,1,211250,325000,2,0,65000,1,0,65000,260000,195000
01SCS19E250031,AR.PUB-SD031,20ARSD0217,36,1,211250,325000,2,0,65000,1,0,65000,260000,195000
01SCS19E250032,AR.PUB-SE028,20ARSE0107,S,1,204750,315000,2,0,63000,1,0,63000,252000,189000
01SCS19E250033,AR.VLD-SB001,20ARSB0041,M,1,91000,140000,2,0,42000,1,0,24500,98000,73500
01SCS19E250033,BSC.AR-SD0043,00ARSD0232,M,1,44500,159000,0,0,0,0,0,31800,159000,127200
01SCS19E250034,AR.MKV-SC005,20ARSC0084,L,1,253500,390000,0,0,0,0,0,136500,390000,253500
01SCS19E250034,AR.PCT-SE010,20ARSE0668,M,1,211250,325000,2,0,65000,1,0,65000,260000,195000
01SCS19E250034,AR.PUB-RJ008,20ARRJ0028,ALL,1,97500,150000,2,0,30000,1,0,30000,120000,90000
01SCS19E250034,AR.PUB-SB037,20ARSB0468,ALL,1,81250,125000,2,0,25000,1,0,25000,100000,75000
01SCS19E250034,ESH.AR-RH0006,00ARRH0058,NON,1,45000,150000,0,0,0,0,0,30000,150000,120000
01SCS19E250035,BSC.AR-SA0002,00ARSA0005,S,1,120000,315000,0,0,0,0,0,63000,315000,252000
01SCS19E250036,AR.CPT-SD009,20ARSD0447,L,1,94250,145000,2,0,29000,1,0,29000,116000,87000
01SCS19E250037,AR.TUC-RL019,20ARRL0343,ALL,1,87750,135000,2,0,27000,1,0,27000,108000,81000
01SCS19E250038,BSC.AR-SB0017,00ARSB0136,S,1,44000,135000,0,0,0,0,0,27000,135000,108000
01SCS19E250038,ESH.AR-SD0001,00ARSD0029,S,1,44500,135000,0,0,0,0,0,27000,135000,108000
01SCS19E250039,ESH.AR-SE0027,00ARSE0256,M,1,44500,135000,0,0,0,0,0,27000,135000,108000
01SCS19E250040,AR.TUC-RL012,20ARRL0336,ALL,1,81250,125000,2,0,25000,1,0,25000,100000,75000
01SCS19E250040,ESH.AR-SA0005,00ARSA0067,S,1,44000,135000,0,0,0,0,0,27000,135000,108000
01SCS19E250040,ESH.AR-SE0036,00ARSE0325,M,1,44500,135000,0,0,0,0,0,27000,135000,108000
01SCS19E250041,BSC.AR-RL0026,00ARRL0171,M,1,94500,135000,0,0,0,0,0,27000,135000,108000
01SCS19E250042,AR.SMD-RI006,20ARRI0328,L,1,87750,135000,2,0,40500,1,0,23625,94500,70875
01SCS19E250042,BE.RAK-SC010,00BESC0024,M,1,91000,140000,2,0,28000,1,0,28000,112000,84000
01SCS19E250043,ESH.AR-SC0034,00ARSC0293,M,1,125000,315000,0,0,0,0,0,63000,315000,252000
01SCS19E250044,AR.TUC-SE013,20ARSE0411,S,1,94250,145000,2,0,29000,1,0,29000,116000,87000
01SCS19E250044,ESH.AR-SD0005,00ARSD0050,M,1,44000,135000,0,0,0,0,0,27000,135000,108000
01SCS19E250045,BSC.AR-RH0025,00ARRH0161,L,1,115000,350000,0,0,0,0,0,70000,350000,280000
01SCS19E250046,AR.MPR-SE005,20ARSE0154,M,1,97500,150000,2,0,45000,1,0,26250,105000,78750
01SCS19E250047,AR.REC-SD009,20ARSD0034,M,1,178750,275000,2,0,82500,1,0,48125,192500,144375
01SCS19E250048,BSC.AR-RH0020,00ARRH0116,M,1,52000,155000,0,0,0,0,0,31000,155000,124000
01SCS19E250049,ESH.AR-RH0017,00ARRH0097,L,1,94500,135000,0,0,0,0,0,27000,135000,108000
01SCS19E250049,ESH.AR-RJ0004,00ARRJ0024,M,1,43000,135000,0,0,0,0,0,27000,135000,108000
01SCS19E250050,BSC.AR-SD0043,00ARSD0232,M,1,44500,159000,0,0,0,0,0,31800,159000,127200
01SCS19E250051,AR.TUC-SE023,20ARSE0651,28,1,204750,315000,2,0,63000,1,0,63000,252000,189000
01SCS19E250052,BSC.AR-SC0007,00ARSC0043,M,1,44000,135000,0,0,0,0,0,27000,135000,108000
01SCS19E250053,BSC.AR-SC0009,00ARSC0052,S,1,125000,315000,0,0,0,0,0,63000,315000,252000
01SCS19E250054,BSC.AR-SC0046,00ARSC0298,NON,1,45000,150000,0,0,0,0,0,30000,150000,120000
01SCS19E250054,BSC.AR-SE0031,00ARSE0293,L,1,52000,155000,0,0,0,0,0,31000,155000,124000
01SCS19E250055,BSC.AR-SD0038,00ARSD0209,L,1,125000,315000,0,0,0,0,0,63000,315000,252000
01SCS19E250055,ESH.AR-SE0037,00ARSE0329,M,1,44000,135000,0,0,0,0,0,27000,135000,108000
01SCS19E250056,THR.AR-RK0001,00ARRK0159,L,1,332000,415000,0,0,0,0,0,62250,415000,352750
01SCS19E250057,BSC.AR-SA0007,00ARSA0031,M,1,44500,135000,0,0,0,0,0,27000,135000,108000
01SCS19E250058,AR.CPT-SC012,20ARSC0482,XL,1,204750,315000,2,0,63000,1,0,63000,252000,189000
01SCS19E250058,BSC.AR-SD0053,00ARSD0285,L,1,44000,159000,0,0,0,0,0,31800,159000,127200
01SCS19E250058,ESH.AR-SC0014,00ARSC0111,XL,1,44500,135000,0,0,0,0,0,27000,135000,108000
01SCS19E250059,ESH.AR-RJ0002,00ARRJ0015,S,1,44500,135000,0,0,0,0,0,27000,135000,108000
01SCS19E250059,ESH.AR-SA0004,00ARSA0056,M,1,44500,135000,0,0,0,0,0,27000,135000,108000
01SCS19E250060,BSC.AR-SE0008,00ARSE0085,S,1,44000,159000,0,0,0,0,0,31800,159000,127200
01SCS19E250060,ESH.AR-SE0011,00ARSE0041,S,1,44500,135000,0,0,0,0,0,27000,135000,108000
01SCS19E250061,AR.PUB-SA004,20ARSA0236,M,1,97500,150000,2,0,30000,1,0,30000,120000,90000
01SCS19E250061,BE.RAK-RX615,00BERX2618,M,1,110500,170000,2,0,34000,1,0,34000,136000,102000
01SCS19E250062,AR.PCT-SE014,20ARSE0676,M,1,87750,135000,2,0,27000,1,0,27000,108000,81000
01SCS19E250062,AR.PUB-SE008,20ARSE0030,M,1,97500,150000,2,0,30000,1,0,30000,120000,90000
01SCS19E250063,ESH.AR-SD0040,00ARSD0368,L,1,122500,350000,0,0,0,0,0,70000,350000,280000
01SCS19E250064,ESH.AR-SC0027,00ARSC0262,M,1,125000,315000,0,0,0,0,0,63000,315000,252000
01SCS19E250065,AR.MPR-SE022,20ARSE0206,S,1,243750,375000,2,0,75000,1,0,75000,300000,225000
01SCS19E250066,BSC.AR-RH0003,00ARRH0015,L,1,94500,135000,0,0,0,0,0,27000,135000,108000
01SCS19E250067,BSC.AR-SE0031,00ARSE0291,S,1,52000,155000,0,0,0,0,0,31000,155000,124000
01SCS19E250068,ESH.AR-SC0017,00ARSC0142,L,1,44000,135000,0,0,0,0,0,27000,135000,108000
01SCS19E250069,ESH.AR-SC0010,00ARSC0081,M,1,44500,135000,0,0,0,0,0,27000,135000,108000
01SCS19E250070,AR.CPT-SD005,20ARSD0432,ALL,1,94250,145000,2,0,29000,1,0,29000,116000,87000
01SCS19E250070,AR.PUB-SE004,20ARSE0014,M,1,97500,150000,2,0,30000,1,0,30000,120000,90000
01SCS19E250071,AR.PUB-SE016,20ARSE0064,XL,1,159250,245000,2,0,49000,1,0,49000,196000,147000
01SCS19E250072,AR.MPR-SE019,20ARSE0203,ALL,1,97500,150000,2,0,45000,1,0,26250,105000,78750
01SCS19E250073,AR.CPT-SD009,20ARSD0446,M,1,94250,145000,2,0,29000,1,0,29000,116000,87000
01SCS19E250074,AR.MKV-SE024,20ARSE0619,28,1,136500,210000,0,0,0,0,0,73500,210000,136500
01SCS19E250075,BSC.AR-RJ0020,00ARRJ0116,M,1,44500,135000,0,0,0,0,0,27000,135000,108000
01SCS19E250075,BSC.AR-SD0004,00ARSD0014,M,1,44000,159000,0,0,0,0,0,31800,159000,127200
01SCS19E250076,AR.CPT-RE013,20ARRE0719,L,1,94250,145000,2,0,29000,1,0,29000,116000,87000
01SCS19E250076,AR.PCT-SE013,20ARSE0674,M,1,87750,135000,2,0,27000,1,0,27000,108000,81000
01SCS19E250077,BSC.AR-SE0031,00ARSE0291,S,1,52000,155000,0,0,0,0,0,31000,155000,124000
01SCS19E250078,BSC.AR-SD0022,00ARSD0129,M,1,44000,159000,0,0,0,0,0,31800,159000,127200
01SCS19E250079,AR.BPH-SD005,20ARSD0372,M,1,182000,280000,2,0,140000,1,0,35000,140000,105000
01SCS19E250079,AR.ESB-RI003,20ARRI0040,M,1,97500,150000,2,0,75000,1,0,18750,75000,56250
01SCS19E250080,AR.VRS-SC001,20ARSC0164,L,1,96850,149000,2,0,44700,1,0,26075,104300,78225
01SCS19E250081,ESH.AR-SB0010,00ARSB0040,M,1,44500,135000,0,0,0,0,0,27000,135000,108000
01SCS19E250082,AR.ESB-SE012,20ARSE0283,M,1,198250,305000,2,0,61000,1,0,61000,244000,183000
01SCS19E250083,AR.STY-RK007,20ARRK0529,ALL,1,61750,95000,2,0,19000,1,0,19000,76000,57000
01SCS19E250083,BSC.AR-SD0047,00ARSD0247,NON,1,68000,220000,0,0,0,0,0,44000,220000,176000
01SCS19E250084,BSC.AR-RJ0019,00ARRJ0112,M,1,94500,135000,0,0,0,0,0,27000,135000,108000
01SCS19E250084,BSC.AR-SE0002,00ARSE0061,S,1,44000,159000,0,0,0,0,0,31800,159000,127200
01SCS19E250085,AR.MPR-SE013,20ARSE0185,S,1,110500,170000,2,0,51000,1,0,29750,119000,89250
01SCS19E250086,AR.CPT-QL011,20ARQL0168,L,1,204750,315000,2,0,63000,1,0,63000,252000,189000
01SCS19E250086,AR.YD-RL003,20ARRL0019,ALL,1,91000,140000,2,0,70000,1,0,17500,70000,52500
01SCS19E250087,AR.PUB-SE021,20ARSE0080,M,1,159250,245000,2,0,49000,1,0,49000,196000,147000
01SCS19E250087,BSC.AR-RH0003,00ARRH0015,L,1,94500,135000,0,0,0,0,0,27000,135000,108000
01SCS19E250088,AR.GTW-SA002,20ARSA0301,L,1,107250,165000,2,0,49500,1,0,28875,115500,86625
01SCS19E250089,AR.CPT-SC007,20ARSC0266,L,1,94250,145000,2,0,29000,1,0,29000,116000,87000
01SCS19E250089,AR.MDG-SC003,20ARSC0158,M,1,94250,145000,2,0,43500,1,0,25375,101500,76125
01SCS19E250089,AR.PUB-SE012,20ARSE0047,L,1,97500,150000,2,0,30000,1,0,30000,120000,90000
01SCS19E250089,AR.TUC-SB002,20ARSB0028,M,1,204750,315000,2,0,63000,1,0,63000,252000,189000
01SCS19E250089,BSC.AR-SE0027,00ARSE0275,S,1,52000,155000,0,0,0,0,0,31000,155000,124000
01SCS19E250090,AR.PCT-SE011,20ARSE0670,M,1,211250,325000,2,0,65000,1,0,65000,260000,195000
01SCS19E250090,AR.PUB-SD016,20ARSD0130,M,1,97500,150000,2,0,30000,1,0,30000,120000,90000
01SCS19E250091,ESH.AR-RI0014,00ARRI0142,NON,1,98000,140000,0,0,0,0,0,28000,140000,112000
01SCS19E250092,AR.BPH-RB021,20ARSD0356,L,1,214500,330000,2,0,165000,1,0,41250,165000,123750
01SCS19E250092,AR.BPH-SD005,20ARSD0373,L,1,182000,280000,2,0,140000,1,0,35000,140000,105000
01SCS19E250092,AR.ESB-RB002,20ARRB0336,M,1,84500,130000,2,0,65000,1,0,16250,65000,48750
01SCS19E250093,BSC.AR-RH0018,00ARRH0080,L,1,120000,315000,0,0,0,0,0,63000,315000,252000
01SCS19E250094,AR.MPR-SE005,20ARSE0155,L,1,97500,150000,2,0,45000,1,0,26250,105000,78750
01SCS19E250095,AR.TUC-SD011,20ARSD0462,M,1,94250,145000,2,0,29000,1,0,29000,116000,87000
01SCS19E250095,BSC.AR-SD0043,00ARSD0232,M,1,44500,159000,0,0,0,0,0,31800,159000,127200
01SCS19E250095,ESH.AR-SD0016,00ARSD0095,M,1,106400,350000,0,0,0,0,0,70000,350000,280000
01SCS19E250096,BSC.AR-SD0064,00ARSD0340,M,1,125000,315000,0,0,0,0,0,63000,315000,252000
01SCS19E250097,AR.CPT-SE002,20ARSE0357,M,1,94250,145000,2,0,29000,1,0,29000,116000,87000
01SCS19E250098,ESH.AR-SE0001,00ARSE0001,S,1,44000,135000,0,0,0,0,0,27000,135000,108000
01SCS19E250098,ESH.AR-SE0004,00ARSE0013,S,1,44500,135000,0,0,0,0,0,27000,135000,108000
01SCS19E250099,BSC.AR-SD0039,00ARSD0211,S,1,125000,315000,0,0,0,0,0,63000,315000,252000
01SCS19E250100,BE.RAK-SC017,00BESC0058,S,1,201500,310000,2,0,62000,1,0,62000,248000,186000
01SCS19E250101,ESH.AR-RJ0014,00ARRJ0181,L,1,44500,135000,0,0,0,0,0,27000,135000,108000
01SCS19E250101,ESH.AR-SE0011,00ARSE0042,M,1,44500,135000,0,0,0,0,0,27000,135000,108000
01SCS19E250102,ARN.AR-RK0001,00ARRK0220,L,1,43000,140000,0,0,0,0,0,42000,140000,98000
01SCS19E250102,ESH.AR-SE0029,00ARSE0265,L,1,44500,135000,0,0,0,0,0,27000,135000,108000
01SCS19E250103,AR.MPR-SE007,20ARSE0162,M,1,97500,150000,2,0,45000,1,0,26250,105000,78750
01SCS19E250104,AR.ESB-RE015,20ARRE0380,L,1,87750,135000,2,0,67500,1,0,16875,67500,50625
01SCS19E250105,AR.MPR-SE008,20ARSE0166,M,1,97500,150000,2,0,45000,1,0,26250,105000,78750
01SCS19E250106,ESH.AR-SB0005,00ARSB0015,S,1,44000,135000,0,0,0,0,0,27000,135000,108000
01SCS19E250106,ESH.AR-SD0005,00ARSD0050,M,1,44000,135000,0,0,0,0,0,27000,135000,108000
01SCS19E250107,BSC.AR-RJ0029,00ARRJ0168,M,1,120000,315000,0,0,0,0,0,63000,315000,252000
01SCS19E250108,AR.CLB-SB001,20ARSB0172,ALL,1,185250,285000,2,0,57000,1,0,57000,228000,171000
01SCS19E250109,BSC.AR-SD0002,00ARSD0005,S,1,44000,159000,0,0,0,0,0,31800,159000,127200
01SCS19E250109,BSC.AR-SD0032,00ARSD0183,S,1,44500,159000,0,0,0,0,0,31800,159000,127200
01SCS19E250110,ESH.AR-SD0040,00ARSD0368,L,1,122500,350000,0,0,0,0,0,70000,350000,280000
01SCS19E250111,ESH.AR-RH0006,00ARRH0058,NON,1,45000,150000,0,0,0,0,0,30000,150000,120000
01SCS19E250112,BSC.AR-SD0064,00ARSD0339,S,1,125000,315000,0,0,0,0,0,63000,315000,252000
01SCS19E250112,ESH.AR-SE0001,00ARSE0001,S,1,44000,135000,0,0,0,0,0,27000,135000,108000
01SCS19E250113,AR.ASH-RK003,20ARRK0512,M,1,195000,300000,2,0,90000,1,0,52500,210000,157500
01SCS19E250113,AR.MKV-SD012,20ARSD0422,30,1,204750,315000,2,0,157500,1,0,39375,157500,118125
01SCS19E250114,ESH.AR-SC0037,00ARSC0302,NON,1,40000,140000,0,0,0,0,0,28000,140000,112000
01SCS19E250115,ESH.AR-SB0028,00ARSB0173,L,1,44000,135000,0,0,0,0,0,27000,135000,108000
01SCS19E250116,ESH.AR-SC0008,00ARSC0069,M,1,44500,135000,0,0,0,0,0,27000,135000,108000
01SCS19E250117,BSC.AR-SE0033,00ARSE0318,34,1,125400,365000,0,0,0,0,0,73000,365000,292000
01SCS19E250118,BSC.AR-RI0006,00ARRI0020,L,1,43000,135000,0,0,0,0,0,27000,135000,108000
01SCS19E250118,BSC.AR-RI0018,00ARRI0069,XL,1,94500,135000,0,0,0,0,0,27000,135000,108000
01SCS19E250118,BSC.AR-SD0022,00ARSD0129,M,1,44000,159000,0,0,0,0,0,31800,159000,127200
01SCS19E250119,AR.CPT-RI004,20ARRI0053,M,1,94250,145000,2,0,29000,1,0,29000,116000,87000
01SCS19E250119,AR.RDC-RK010,20ARRK0494,L,1,97500,150000,2,0,30000,1,0,30000,120000,90000
01SCS19E250119,ESH.AR-SE0037,00ARSE0330,L,1,44000,135000,0,0,0,0,0,27000,135000,108000
01SCS19E250120,ESH.AR-SC0021,00ARSC0158,M,1,44000,135000,0,0,0,0,0,27000,135000,108000
01SCS19E250121,AR.TUC-SE023,20ARSE0653,32,1,204750,315000,2,0,63000,1,0,63000,252000,189000
01SCS19E250122,AR.MPR-SE035,20ARSE0311,ALL,1,136500,210000,2,0,42000,1,0,42000,168000,126000
01SCS19E250123,BSC.AR-SD0023,00ARSD0134,L,1,44000,159000,0,0,0,0,0,31800,159000,127200
01SCS19E250123,ESH.AR-SE0037,00ARSE0330,L,1,44000,135000,0,0,0,0,0,27000,135000,108000
01SCS19E250124,BSC.AR-SD0039,00ARSD0213,L,1,125000,315000,0,0,0,0,0,63000,315000,252000
01SCS19E250125,BSC.AR-SD0046,00ARSD0243,S,1,44500,159000,0,0,0,0,0,31800,159000,127200
01SCS19E250125,ESH.AR-SA0018,00ARSA0120,S,1,44000,135000,0,0,0,0,0,27000,135000,108000
01SCS19E250125,ESH.AR-SB0031,00ARSB0204,S,1,44500,135000,0,0,0,0,0,27000,135000,108000
01SCS19E250125,ESH.AR-SE0001,00ARSE0001,S,1,44000,135000,0,0,0,0,0,27000,135000,108000
01SCS19E250125,ESH.AR-SE0036,00ARSE0325,M,1,44500,135000,0,0,0,0,0,27000,135000,108000
01SCS19E250126,AR.TRF-RJ013,20ARRJ0097,ALL,1,91000,140000,2,0,42000,1,0,24500,98000,73500
01SCS19E250127,AR.CLK-SA005,20ARSA0054,ALL,1,91000,140000,2,0,28000,1,0,28000,112000,84000
01SCS19E250128,ESH.AR-SE0033,00ARSE0303,S,1,52000,155000,0,0,0,0,0,31000,155000,124000
01SCS19E250129,BSC.AR-RH0020,00ARRH0116,M,1,52000,155000,0,0,0,0,0,31000,155000,124000
01SCS19E250130,AR.PUB-RL005,20ARRL0124,M,1,97500,150000,2,0,30000,1,0,30000,120000,90000
01SCS19E250130,AR.SMD-SD012,20ARSD0566,M,1,87750,135000,2,0,27000,1,0,27000,108000,81000
01SCS19E250130,AR.SMD-SD018,20ARSD0580,ALL,1,97500,150000,2,0,30000,1,0,30000,120000,90000
01SCS19E250131,BSC.AR-SA0021,00ARSA0108,XL,1,44000,135000,0,0,0,0,0,27000,135000,108000
01SCS19E250131,ESH.AR-SC0015,00ARSC0123,XL,1,44000,135000,0,0,0,0,0,27000,135000,108000
01SCS19E250132,AR.CPS-SC002,20ARSC0002,ALL,1,130000,200000,2,0,60000,1,0,35000,140000,105000
01SCS19E250133,BSC.AR-RL0018,00ARRL0112,XL,1,125000,315000,0,0,0,0,0,63000,315000,252000
01SCS19E250134,AR.PUB-RG007,20ARRG0045,XL,1,97500,150000,2,0,30000,1,0,30000,120000,90000
01SCS19E250135,BSC.AR-SB0003,00ARSB0044,M,1,125000,315000,0,0,0,0,0,63000,315000,252000
01SCS19E250136,ESH.AR-SD0012,00ARSD0079,34,1,145000,375000,0,0,0,0,0,75000,375000,300000
01SCS19E250137,BSC.AR-RJ0007,00ARRJ0063,S,1,430000,135000,0,0,0,0,0,27000,135000,108000
01SCS19E250137,BSC.AR-SE0027,00ARSE0275,S,1,52000,155000,0,0,0,0,0,31000,155000,124000
01SCS19E250138,AR.ESB-RK002,20ARRK0227,S,1,198250,305000,2,0,61000,1,0,61000,244000,183000
01SCS19E250139,AR.MPR-SE019,20ARSE0203,ALL,1,97500,150000,2,0,45000,1,0,26250,105000,78750
01SCS19E250140,AR.GTW-SA002,20ARSA0301,L,1,107250,165000,2,0,49500,1,0,28875,115500,86625
01SCS19E250140,AR.MKV-SE009,20ARSE0511,32,1,227500,350000,0,0,0,0,0,122500,350000,227500
01SCS19E250140,AR.MPR-SE001,20ARSE0139,L,1,97500,150000,2,0,45000,1,0,26250,105000,78750
01SCS19E250140,AR.MPR-SE005,20ARSE0154,M,1,97500,150000,2,0,45000,1,0,26250,105000,78750
01SCS19E250140,AR.MPR-SE008,20ARSE0166,M,1,97500,150000,2,0,45000,1,0,26250,105000,78750
01SCS19E250140,AR.PCT-SE014,20ARSE0676,M,1,87750,135000,2,0,27000,1,0,27000,108000,81000
01SCS19E250140,AR.REC-SD013,20ARSD0050,L,1,120250,185000,2,0,55500,1,0,32375,129500,97125
01SCS19E250141,AR.MPR-SE001,20ARSE0138,M,1,97500,150000,2,0,45000,1,0,26250,105000,78750
01SCS19E250142,ESH.AR-SB0030,00ARSB0201,M,1,44000,135000,0,0,0,0,0,27000,135000,108000
01SCS19E250143,ARN.AR-RK0005,00ARRK0236,32,1,110000,350000,0,0,0,0,0,105000,350000,245000
01SCS19E250144,ESH.AR-SD0018,00ARSD0136,S,1,125000,315000,0,0,0,0,0,63000,315000,252000
01SCS19E250145,BSC.AR-SC0048,00ARSC0304,S,1,44500,159000,0,0,0,0,0,31800,159000,127200
01SCS19E250146,DKS.AR-SE0006,00ARSE0146,28,1,417272,696000,0,0,0,0,0,104400,696000,591600
01SCS19E250147,AR.TUC-SA024,20ARSA0151,M,1,87750,135000,2,0,27000,1,0,27000,108000,81000
01SCS19E250148,BSC.AR-RK0016,00ARRK0111,L,1,43000,135000,0,0,0,0,0,27000,135000,108000
01SCS19E250148,BSC.AR-SB0008,00ARSB0079,M,1,44500,135000,0,0,0,0,0,27000,135000,108000
01SCS19E250148,BSC.AR-SD0038,00ARSD0209,L,1,125000,315000,0,0,0,0,0,63000,315000,252000
01SCS19E250149,AR.PUB-SE002,20ARSE0007,L,1,97500,150000,2,0,30000,1,0,30000,120000,90000
01SCS19E250150,ESH.AR-SE0037,00ARSE0330,L,1,44000,135000,0,0,0,0,0,27000,135000,108000
01SCS19E250151,AR.PUB-SB026,20ARSB0137,M,1,97500,150000,2,0,30000,1,0,30000,120000,90000
01SCS19E250152,BSC.AR-SB0004,00ARSB0048,M,1,44000,135000,0,0,0,0,0,27000,135000,108000
01SCS19E250153,AR.MPR-SE016,20ARSE0199,L,1,243750,375000,2,0,75000,1,0,75000,300000,225000
01SCS19E250154,AR.TUC-SE019,20ARSE0635,S,1,204750,315000,2,0,63000,1,0,63000,252000,189000
01SCS19E250155,ESH.AR-SB0005,00ARSB0015,S,1,44000,135000,0,0,0,0,0,27000,135000,108000
01SCS19E250156,AR.MPR-SE020,20ARSE0204,ALL,1,97500,150000,2,0,45000,1,0,26250,105000,78750
01SCS19E250157,BSC.AR-SE0008,00ARSE0087,L,1,44000,159000,0,0,0,0,0,31800,159000,127200
01SCS19E250157,ESH.AR-RJ0010,00ARRJ0049,L,1,94500,135000,0,0,0,0,0,27000,135000,108000
01SCS19E250157,ESH.AR-SC0034,00ARSC0294,L,1,125000,315000,0,0,0,0,0,63000,315000,252000
01SCS19E250158,ESH.AR-SB0003,00ARSB0008,M,1,44000,135000,0,0,0,0,0,27000,135000,108000
01SCS19E250158,ESH.AR-SB0022,00ARSB0124,M,1,44000,135000,0,0,0,0,0,27000,135000,108000
01SCS19E250159,AR.ESB-RK001,20ARRK0225,L,1,201500,310000,2,0,62000,1,0,62000,248000,186000
01SCS19E250160,ESH.AR-SD0034,00ARSD0311,S,1,44000,135000,0,0,0,0,0,27000,135000,108000
01SCS19E250161,BSC.AR-SA0014,00ARSA0040,NON,1,47500,140000,0,0,0,0,0,28000,140000,112000
01SCS19E250162,AR.ESB-SE011,20ARSE0281,XL,1,227500,350000,2,0,70000,1,0,70000,280000,210000
01SCS19E250162,AR.VRS-SC010,20ARSC0199,XL,1,96850,149000,2,0,44700,1,0,26075,104300,78225
01SCS19E250163,AR.SMD-SD012,20ARSD0566,M,1,87750,135000,2,0,27000,1,0,27000,108000,81000
01SCS19E250163,ESH.AR-SE0025,00ARSE0248,M,1,44500,135000,0,0,0,0,0,27000,135000,108000
01SCS19E250164,BSC.AR-SE0014,00ARSE0179,S,1,44000,159000,0,0,0,0,0,31800,159000,127200
01SCS19E250165,AR.CPT-SD012,20ARSD0459,L,1,94250,145000,2,0,29000,1,0,29000,116000,87000
01SCS19E250166,AR.CPT-RH008,20ARRH0868,S,1,204750,315000,2,0,63000,1,0,63000,252000,189000
01SCS19E250166,AR.SMD-SD011,20ARSD0317,34,1,211250,325000,2,0,65000,1,0,65000,260000,195000
01SCS19E250167,AR.ESB-RI003,20ARRI0040,M,1,97500,150000,2,0,75000,1,0,18750,75000,56250
01SCS19E250168,AR.TUC-SD023,20ARSD0511,L,1,204750,315000,2,0,63000,1,0,63000,252000,189000
01SCS19E250168,BSC.AR-SE0007,00ARSE0081,S,1,44500,159000,0,0,0,0,0,31800,159000,127200
01SCS19E250169,AR.MKV-RL005,20ARRL0250,28,1,227500,350000,0,0,0,0,0,122500,350000,227500
01SCS19E250169,ESH.AR-SC0013,00ARSC0104,S,1,44500,135000,0,0,0,0,0,27000,135000,108000
01SCS19E250170,AR.MPR-SE006,20ARSE0159,L,1,97500,150000,2,0,45000,1,0,26250,105000,78750
01SCS19E250171,ESH.AR-SB0010,00ARSB0039,S,1,44500,135000,0,0,0,0,0,27000,135000,108000
01SCS19E250172,BSC.AR-SD0039,00ARSD0211,S,1,125000,315000,0,0,0,0,0,63000,315000,252000
01SCS19E250173,AR.MKV-SD005,20ARSD0235,M,1,172250,265000,0,0,0,0,0,92750,265000,172250
01SCS19E250174,AR.RDC-RK006,20ARRK0472,S,1,136500,210000,2,0,42000,1,0,42000,168000,126000
01SCS19E250174,AR.YD-SB006,20ARSB0513,M,1,195000,300000,2,0,150000,1,0,37500,150000,112500
01SCS19E250175,AR.MPR-SE003,20ARSE0147,L,1,97500,150000,2,0,45000,1,0,26250,105000,78750
01SCS19E250175,BSC.AR-SE0009,00ARSE0091,L,1,44500,159000,0,0,0,0,0,31800,159000,127200
01SCS19E250176,BSC.AR-SB0004,00ARSB0050,XL,1,44000,135000,0,0,0,0,0,27000,135000,108000
01SCS19E250177,AR.MPR-SE037,20ARSE0313,ALL,1,130000,200000,2,0,40000,1,0,40000,160000,120000
01SCS19E250178,BSC.AR-RI0026,00ARRI0135,NON,1,98000,140000,0,0,0,0,0,28000,140000,112000
01SCS19E250178,ESH.AR-RI0020,00ARRI0148,NON,1,39000,140000,0,0,0,0,0,28000,140000,112000
01SCS19E250179,AR.PCT-SE016,20ARSE0680,M,1,87750,135000,2,0,27000,1,0,27000,108000,81000
01SCS19E250180,AR.MPR-SE008,20ARSE0167,L,1,97500,150000,2,0,45000,1,0,26250,105000,78750
01SCS19E250181,AR.FHL-RL002,20ARRL0183,ALL,1,55250,85000,2,0,17000,1,0,17000,68000,51000
01SCS19E250182,AR.STY-SE016,20ARSE0582,ALL,1,55250,85000,2,0,17000,1,0,17000,68000,51000
01SCS19E250183,ESH.AR-SC0016,00ARSC0136,S,1,44000,135000,0,0,0,0,0,27000,135000,108000
01SCS19E250184,AR.PCT-SE020,20ARSE0688,M,1,87750,135000,2,0,27000,1,0,27000,108000,81000
01SCS19E250185,BSC.AR-SD0044,00ARSD0236,M,1,44500,159000,0,0,0,0,0,31800,159000,127200
01SCS19E250186,ESH.AR-SA0012,00ARSA0095,L,1,44000,135000,0,0,0,0,0,27000,135000,108000
01SCS19E250186,ESH.AR-SC0033,00ARSC0286,L,1,44000,135000,0,0,0,0,0,27000,135000,108000
01SCS19E250186,THR.AR-RK0003,00ARRK0168,XL,1,332000,415000,0,0,0,0,0,62250,415000,352750
01SCS19E250187,BSC.AR-SC0050,00ARSC0315,XL,1,44000,159000,0,0,0,0,0,31800,159000,127200
01SCS19E250187,ESH.AR-SC0004,00ARSC0022,M,1,44500,135000,0,0,0,0,0,27000,135000,108000
01SCS19E250188,BSC.AR-SD0057,00ARSD0293,NON,1,45000,140000,0,0,0,0,0,28000,140000,112000
01SCS19E250189,AR.MKV-SE002,20ARSE0475,30,1,214500,330000,0,0,0,0,0,115500,330000,214500
01SCS19E250189,AR.MKV-SE004,20ARSE0485,30,1,214500,330000,0,0,0,0,0,115500,330000,214500
01SCS19E250190,AR.CPT-RI008,20ARRI0070,L,1,94250,145000,2,0,29000,1,0,29000,116000,87000
01SCS19E250191,AR.FHL-SA003,20ARSA0084,ALL,1,87750,135000,2,0,27000,1,0,27000,108000,81000
01SCS19E250192,BSC.AR-SC0046,00ARSC0298,NON,1,45000,150000,0,0,0,0,0,30000,150000,120000
01SCS19E250192,ESH.AR-SE0001,00ARSE0001,S,1,44000,135000,0,0,0,0,0,27000,135000,108000
01SCS19E250193,ESH.AR-RK0004,00ARRK0013,S,1,120000,315000,0,0,0,0,0,63000,315000,252000
01SCS19E250194,AR.CPT-RK007,20ARRK0025,L,1,204750,315000,2,0,63000,1,0,63000,252000,189000
01SCS19E250195,AR.MER-RH002,20ARRH0223,M,1,204750,315000,2,0,94500,1,0,55125,220500,165375
01SCS19E250196,AR.PCT-SE010,20ARSE0668,M,1,211250,325000,2,0,65000,1,0,65000,260000,195000
01SCS19E250197,AR.MPR-SE018,20ARSE0202,ALL,1,110500,170000,2,0,51000,1,0,29750,119000,89250
01SCS19E250198,BSC.AR-RK0020,00ARRK0127,L,1,94500,135000,0,0,0,0,0,27000,135000,108000
01SCS19E250199,AR.CPT-RE013,20ARRE0719,L,1,94250,145000,2,0,29000,1,0,29000,116000,87000
01SCS19E250199,AR.MPR-SE016,20ARSE0199,L,1,243750,375000,2,0,75000,1,0,75000,300000,225000
01SCS19E250199,AR.PUB-RI016,20ARRI0259,L,1,97500,150000,2,0,30000,1,0,30000,120000,90000
01SCS19E250199,AR.PUB-RL001,20ARRL0113,ALL,1,97500,150000,2,0,30000,1,0,30000,120000,90000
01SCS19E250199,AR.SMD-SC001,20ARSC0449,M,1,97500,150000,2,0,30000,1,0,30000,120000,90000
01SCS19E250199,ESH.AR-RJ0002,00ARRJ0016,M,1,94500,135000,0,0,0,0,0,27000,135000,108000
01SCS19E250199,ESH.AR-SD0024,00ARSD0260,L,1,44500,135000,0,0,0,0,0,27000,135000,108000
01SCS19E250200,BSC.AR-SA0002,00ARSA0005,S,1,120000,315000,0,0,0,0,0,63000,315000,252000
01SCS19E250200,BSC.AR-SE0005,00ARSE0073,S,1,44000,159000,0,0,0,0,0,31800,159000,127200
01SCS19E250201,AR.MPR-SE004,20ARSE0149,S,1,97500,150000,2,0,45000,1,0,26250,105000,78750
01SCS19E250202,BSC.AR-SD0052,00ARSD0280,M,1,44500,159000,0,0,0,0,0,31800,159000,127200
01SCS19E250203,AR.MPR-SE019,20ARSE0203,ALL,1,97500,150000,2,0,45000,1,0,26250,105000,78750
01SCS19E250204,AR.TUC-SB002,20ARSB0028,M,1,204750,315000,2,0,63000,1,0,63000,252000,189000
01SCS19E250204,ESH.AR-SE0001,00ARSE0002,M,1,44000,135000,0,0,0,0,0,27000,135000,108000
01SCS19E250204,ESH.AR-SE0036,00ARSE0325,M,1,44500,135000,0,0,0,0,0,27000,135000,108000
01SCS19E250205,AR.CPT-SE005,20ARSE0368,S,1,204750,315000,2,0,63000,1,0,63000,252000,189000
01SCS19E250206,AR.STY-SE007,20ARSE0125,ALL,1,55250,85000,2,0,17000,1,0,17000,68000,51000
01SCS19E250207,AR.MPR-SE009,20ARSE0169,S,1,97500,150000,2,0,45000,1,0,26250,105000,78750
01SCS19E250208,AR.CPT-SD010,20ARSD0452,XL,1,94250,145000,2,0,29000,1,0,29000,116000,87000
01SCS19E250209,AR.MPR-SE001,20ARSE0139,L,1,97500,150000,2,0,45000,1,0,26250,105000,78750
01SCS19E250210,AR.ESB-RE010,20ARRE0366,XL,1,87750,135000,2,0,67500,1,0,16875,67500,50625
01SCS19E250211,AR.SMD-RI002,20ARRI0223,S,1,87750,135000,2,0,40500,1,0,23625,94500,70875
01SCS19E250212,BSC.AR-SB0003,00ARSB0045,L,1,125000,315000,0,0,0,0,0,63000,315000,252000
01SCS19E250213,BSC.AR-SD0064,00ARSD0340,M,1,125000,315000,0,0,0,0,0,63000,315000,252000
01SCS19E250214,AR.PCT-SE015,20ARSE0679,L,1,87750,135000,2,0,27000,1,0,27000,108000,81000
01SCS19E250214,AR.PCT-SE018,20ARSE0684,M,1,87750,135000,2,0,27000,1,0,27000,108000,81000
01SCS19E250215,BSC.AR-RK0016,00ARRK0111,L,1,43000,135000,0,0,0,0,0,27000,135000,108000
01SCS19E250216,AR.TUC-SE012,20ARSE0410,XL,1,94250,145000,2,0,29000,1,0,29000,116000,87000
01SCS19E250217,AR.TUC-SE023,20ARSE0653,32,1,204750,315000,2,0,63000,1,0,63000,252000,189000
01SCS19E250218,ESH.AR-SE0037,00ARSE0328,S,1,44000,135000,0,0,0,0,0,27000,135000,108000
01SCS19E250219,AR.ESB-SD006,20ARSD0117,M,1,204750,315000,2,0,63000,1,0,63000,252000,189000
01SCS19E250220,AR.MPR-SE037,20ARSE0313,ALL,1,130000,200000,2,0,40000,1,0,40000,160000,120000
01SCS19E250221,AR.MER-RH003,20ARRH0226,ALL,1,84500,130000,2,0,39000,1,0,22750,91000,68250
01SCS19E250222,AR.SMD-QD004,20ARQD0098,XL,1,84500,130000,2,0,39000,1,0,22750,91000,68250
01SCS19E250223,ESH.AR-SE0031,00ARSE0271,S,1,125000,315000,0,0,0,0,0,63000,315000,252000
01SCS19E250224,AR.SLS-SE016,20ARSE0335,32,1,552500,650000,0,0,0,0,0,97500,650000,552500
01SCS19E250225,AR.TUC-SB002,20ARSB0028,M,1,204750,315000,2,0,63000,1,0,63000,252000,189000
01SCS19E250225,BSC.AR-SC0024,00ARSC0179,L,1,125000,315000,0,0,0,0,0,63000,315000,252000
01SCS19E250226,AR.MDS-RF001,20ARRF0075,M,1,389350,599000,2,0,119800,1,0,119800,479200,359400
01SCS19E250227,ESH.AR-SD0040,00ARSD0366,S,1,122500,350000,0,0,0,0,0,70000,350000,280000
01SCS19E250228,ESH.AR-SD0009,00ARSD0067,L,1,44500,135000,0,0,0,0,0,27000,135000,108000
01SCS19E250229,AR.PUB-RE051,20ARRE0595,M,1,204750,315000,2,0,63000,1,0,63000,252000,189000
01SCS19E250230,AR.PUB-SE024,20ARSE0092,M,1,159250,245000,2,0,49000,1,0,49000,196000,147000
01SCS19E250231,BSC.AR-SC0031,00ARSC0207,S,1,44500,135000,0,0,0,0,0,27000,135000,108000
01SCS19E250231,BSC.AR-SD0066,00ARSD0355,S,1,44500,159000,0,0,0,0,0,31800,159000,127200
01SCS19E250232,AR.MPR-SE003,20ARSE0148,XL,1,97500,150000,2,0,45000,1,0,26250,105000,78750
01SCS19E250232,AR.PUB-SB011,20ARSB0017,32,1,211250,325000,2,0,65000,1,0,65000,260000,195000
01SCS19E250232,AR.SMD-RD002,20ARRD0132,XL,1,87750,135000,2,0,40500,1,0,23625,94500,70875
01SCS19E250233,AR.ESB-SE004,20ARSE0253,XL,1,94250,145000,2,0,29000,1,0,29000,116000,87000
01SCS19E250234,BE.RAK-SD016,00BESD0077,M,1,91000,140000,2,0,28000,1,0,28000,112000,84000
01SCS19E250234,ESH.AR-SC0011,00ARSC0085,M,1,44000,135000,0,0,0,0,0,27000,135000,108000
01SCS19E250235,BSC.AR-SA0023,00ARSA0114,NON,1,47500,140000,0,0,0,0,0,28000,140000,112000
01SCS19E250236,AR.MPR-SE004,20ARSE0149,S,1,97500,150000,2,0,45000,1,0,26250,105000,78750
01SCS19E250237,ESH.AR-SD0001,00ARSD0030,M,1,44500,135000,0,0,0,0,0,27000,135000,108000
01SCS19E250237,ESH.AR-SE0009,00ARSE0034,M,1,44500,135000,0,0,0,0,0,27000,135000,108000
01SCS19E250238,ESH.AR-RJ0002,00ARRJ0016,M,1,94500,135000,0,0,0,0,0,27000,135000,108000
01SCS19E250238,ESH.AR-SC0008,00ARSC0069,M,1,44500,135000,0,0,0,0,0,27000,135000,108000
01SCS19E250239,AR.HLW-SE021,20ARSE0572,L,1,217750,335000,2,0,67000,1,0,67000,268000,201000
01SCS19E250239,AR.SMD-RE004,20ARRE0132,ALL,1,97500,150000,2,0,45000,1,0,26250,105000,78750
01SCS19E250239,AR.TUC-RG005,20ARRG0156,ALL,1,87750,135000,2,0,27000,1,0,27000,108000,81000
01SCS19E250240,BE.RAK-SC010,00BESC0023,S,1,91000,140000,2,0,28000,1,0,28000,112000,84000
01SCS19E250241,AR.MKV-SB011,20ARSB0540,M,1,91000,140000,0,0,0,0,0,49000,140000,91000
01SCS19E250241,ESH.AR-SE0007,00ARSE0026,M,1,44500,135000,0,0,0,0,0,27000,135000,108000
01SCS19E250242,AR.CPT-QL011,20ARQL0166,S,1,204750,315000,2,0,63000,1,0,63000,252000,189000
01SCS19E250242,AR.CPT-SE006,20ARSE0372,S,1,204750,315000,2,0,63000,1,0,63000,252000,189000
01SCS19E250243,AR.CPT-SC006,20ARSC0261,M,1,94250,145000,2,0,29000,1,0,29000,116000,87000
01SCS19E250244,AR.CLK-SA005,20ARSA0054,ALL,1,91000,140000,2,0,28000,1,0,28000,112000,84000
01SCS19E250245,BE.RAK-SA027,00BESA0113,L,1,104000,160000,2,0,32000,1,0,32000,128000,96000
01SCS19E250246,AR.ESB-RI003,20ARRI0040,M,1,97500,150000,2,0,75000,1,0,18750,75000,56250
01SCS19E250246,AR.YD-RL008,20ARRL0024,ALL,1,87750,135000,2,0,67500,1,0,16875,67500,50625
01SCS19E250246,ESH.AR-SD0032,00ARSD0304,M,1,44500,135000,0,0,0,0,0,27000,135000,108000
01SCS19E250247,AR.ESB-SE006,20ARSE0259,M,1,94250,145000,2,0,29000,1,0,29000,116000,87000
01SCS19E250248,AR.HLW-SC003,20ARSC0125,L,1,208000,320000,2,0,96000,1,0,56000,224000,168000
01SCS19E250249,AR.CLK-SA006,20ARSA0055,ALL,1,110500,170000,2,0,34000,1,0,34000,136000,102000
01SCS19E250250,AR.ESB-SC020,20ARSC0469,ALL,1,68250,105000,2,0,52500,1,0,13125,52500,39375
01SCS19E250251,AR.PUB-SE026,20ARSE0100,M,1,204750,315000,2,0,63000,1,0,63000,252000,189000
01SCS19E250252,BE.RAK-RX193,00BERX0480,42,1,130000,200000,2,0,40000,1,0,40000,160000,120000
01SCS19E250253,AR.ESB-SE005,20ARSE0254,S,1,94250,145000,2,0,29000,1,0,29000,116000,87000
01SCS19E250254,BSC.AR-RH0020,00ARRH0117,L,1,52000,155000,0,0,0,0,0,31000,155000,124000
01SCS19E250255,AR.HLW-SE021,20ARSE0572,L,1,217750,335000,2,0,67000,1,0,67000,268000,201000
01SCS19E250256,AR.HLW-SE006,20ARSE0538,M,1,100750,155000,2,0,31000,1,0,31000,124000,93000
01SCS19E250256,ESH.AR-SE0001,00ARSE0002,M,1,44000,135000,0,0,0,0,0,27000,135000,108000
01SCS19E250257,BSC.AR-SC0025,00ARSC0182,M,1,125000,315000,2,0,94500,1,0,44100,220500,176400
01SCS19E250257,BSC.AR-SD0022,00ARSD0129,M,1,44000,159000,2,0,47700,1,0,22260,111300,89040
01SCS19E250258,BSC.AR-SB0015,00ARSB0128,M,1,125000,315000,2,0,94500,1,0,44100,220500,176400
01SCS19E250259,ESH.AR-SE0037,00ARSE0328,S,1,44000,135000,2,0,40500,1,0,18900,94500,75600
01SCS19E250260,ESH.AR-SE0010,00ARSE0037,S,1,44000,135000,2,0,40500,1,0,18900,94500,75600
01SCS19E250261,ESH.AR-SE0017,00ARSE0115,L,1,44000,135000,2,0,40500,1,0,18900,94500,75600
01SCS19E250262,BSC.AR-RI0003,00ARRI0008,L,1,43000,135000,2,0,40500,1,0,18900,94500,75600
01SCS19E250262,BSC.AR-SA0002,00ARSA0007,L,1,120000,315000,2,0,94500,1,0,44100,220500,176400
01SCS19E250262,BSC.AR-SD0008,00ARSD0036,XL,1,44500,159000,2,0,47700,1,0,22260,111300,89040
01SCS19E250263,BSC.AR-SD0058,00ARSD0294,NON,1,50000,150000,2,0,45000,1,0,21000,105000,84000
01SCS19E250263,ESH.AR-SC0017,00ARSC0141,M,1,44000,135000,2,0,40500,1,0,18900,94500,75600
01SCS19E250263,ESH.AR-SC0033,00ARSC0285,M,1,44000,135000,2,0,40500,1,0,18900,94500,75600
01SCS19E250264,BSC.AR-SA0018,00ARSA0061,L,1,44000,135000,2,0,40500,1,0,18900,94500,75600
01SCS19E250264,BSC.AR-SD0045,00ARSD0241,L,1,44500,159000,2,0,47700,1,0,22260,111300,89040
01SCS19E250265,BSC.AR-SB0008,00ARSB0080,L,1,44500,135000,2,0,40500,1,0,18900,94500,75600
01SCS19E250266,AR.MKV-SE015,20ARSE0591,S,1,22750,350000,0,0,0,0,0,122500,350000,227500
01SCS19E250267,AR.SMD-RI002,20ARRI0225,L,1,87750,135000,2,0,40500,1,0,23625,94500,70875
01SCS19E250268,ESH.AR-SE0010,00ARSE0039,L,1,44000,135000,2,0,40500,1,0,18900,94500,75600
01SCS19E250269,BSC.AR-SA0007,00ARSA0032,L,1,94500,135000,2,0,40500,1,0,18900,94500,75600
01SCS19E250270,BSC.AR-SC0022,00ARSC0170,M,1,44500,135000,2,0,40500,1,0,18900,94500,75600
01SCS19E250271,BSC.AR-SD0003,00ARSD0009,S,1,44000,159000,2,0,47700,1,0,22260,111300,89040
01SCS19E250272,BSC.AR-SB0005,00ARSB0061,NON,1,47500,140000,2,0,42000,1,0,19600,98000,78400
01SCS19E250273,ESH.AR-SD0029,00ARSD0278,NON,1,58000,175000,2,0,52500,1,0,24500,122500,98000
01SCS19E250274,AR.MPR-SE031,20ARSE0297,L,1,230750,355000,2,0,71000,1,0,71000,284000,213000
01SCS19E250275,BSC.AR-SD0063,00ARSD0338,NON,1,60000,180000,2,0,54000,1,0,25200,126000,100800
01SCS19E250276,AR.PCT-SE002,20ARSE0338,M,1,87750,135000,2,0,27000,1,0,27000,108000,81000
01SCS19E250276,AR.SMD-RJ001,20ARRJ0456,M,1,87750,135000,2,0,27000,1,0,27000,108000,81000
01SCS19E250276,AR.TUC-SE013,20ARSE0412,M,1,94250,145000,2,0,29000,1,0,29000,116000,87000
01SCS19E250277,ESH.AR-SB0032,00ARSB0210,L,1,125000,315000,2,0,94500,1,0,44100,220500,176400
01SCS19E250278,BSC.AR-SC0001,00ARSC0014,M,1,125000,315000,2,0,94500,1,0,44100,220500,176400
01SCS19E250279,BSC.AR-SD0028,00ARSD0160,S,1,125000,315000,2,0,94500,1,0,44100,220500,176400
01SCS19E250280,AR.PCT-SE013,20ARSE0674,M,1,87750,135000,2,0,27000,1,0,27000,108000,81000
01SCS19E250281,BSC.AR-SE0036,00ARSE0341,28,1,125000,365000,2,0,109500,1,0,51100,255500,204400
01SCS19E250282,AR.MPR-SB010,20ARSB0270,S,1,97500,150000,2,0,45000,1,0,26250,105000,78750
01SCS19E250283,AR.STY-SE012,20ARSE0578,ALL,1,55250,85000,2,0,17000,1,0,17000,68000,51000
01SCS19E250284,ESH.AR-SC0028,00ARSC0267,L,1,44500,135000,2,0,40500,1,0,18900,94500,75600
01SCS19E250285,BSC.AR-RH0017,00ARRH0076,L,1,120000,315000,2,0,94500,1,0,44100,220500,176400
01SCS19E250286,AR.ASH-RJ001,20ARRJ0118,30,1,273000,420000,2,0,210000,1,0,52500,210000,157500
01SCS19E250287,AR.PCT-SE011,20ARSE0670,M,1,211250,325000,2,0,65000,1,0,65000,260000,195000
01SCS19E250288,BSC.AR-SD0052,00ARSD0281,L,1,44500,159000,2,0,47700,1,0,22260,111300,89040
01SCS19E250288,BSC.AR-SD0054,00ARSD0287,NON,1,50000,150000,2,0,45000,1,0,21000,105000,84000
01SCS19E250289,AR.PUB-SE009,20ARSE0034,M,1,97500,150000,2,0,30000,1,0,30000,120000,90000
01SCS19E250290,BSC.AR-SD0055,00ARSD0288,NON,1,50000,150000,2,0,45000,1,0,21000,105000,84000
01SCS19E250290,ESH.AR-SD0011,00ARSD0073,S,1,125000,315000,2,0,94500,1,0,44100,220500,176400
01SCS19E250290,ESH.AR-SE0013,00ARSE0050,M,1,44500,135000,2,0,40500,1,0,18900,94500,75600
01SCS19E250291,AR.MYA-SC003,20ARSC0045,32,1,220350,339000,2,0,101700,1,0,59325,237300,177975
01SCS19E250292,ESH.AR-SD0027,00ARSD0270,S,1,44000,135000,2,0,40500,1,0,18900,94500,75600
01SCS19E250293,ESH.AR-SC0034,00ARSC0293,M,1,125000,315000,2,0,94500,1,0,44100,220500,176400
01SCS19E250294,BSC.AR-SE0005,00ARSE0073,S,1,44000,159000,2,0,47700,1,0,22260,111300,89040
01SCS19E250295,AR.PCT-SE020,20ARSE0688,M,1,87750,135000,2,0,27000,1,0,27000,108000,81000
01SCS19E250296,AR.SMD-SD005,20ARSD0294,L,2,87750,135000,2,0,27000,1,0,27000,216000,162000
01SCS19E250297,AR.PUB-RH002,20ARRH0002,ALL,1,97500,150000,2,0,30000,1,0,30000,120000,90000
01SCS19E250297,AR.PUB-SE028,20ARSE0110,XL,1,204750,315000,2,0,63000,1,0,63000,252000,189000
01SCS19E250298,AR.PUB-SE004,20ARSE0015,L,1,97500,150000,2,0,30000,1,0,30000,120000,90000
01SCS19E250299,ESH.AR-SE0003,00ARSE0009,S,1,44500,135000,2,0,40500,1,0,18900,94500,75600
01SCS19E250300,ESH.AR-SD0026,00ARSD0268,L,1,44500,135000,2,0,40500,1,0,18900,94500,75600
01SCS19E250301,AR.RDC-RK007,20ARRK0479,L,1,97500,150000,2,0,30000,1,0,30000,120000,90000
01SCS19E250302,AR.HLW-SE006,20ARSE0538,M,1,100750,155000,2,0,31000,1,0,31000,124000,93000
01SCS19E250302,AR.MKV-SB011,20ARSB0539,S,1,91000,140000,0,0,0,0,0,49000,140000,91000
01SCS19E250303,AR.PUB-SE026,20ARSE0100,M,1,204750,315000,2,0,63000,1,0,63000,252000,189000
01SCS19E250304,ESH.AR-SD0025,00ARSD0262,S,1,44000,135000,2,0,40500,1,0,18900,94500,75600
01SCS19E250305,AR.HLW-SE006,20ARSE0539,L,1,100750,155000,2,0,31000,1,0,31000,124000,93000
01SCS19E250306,ESH.AR-RK0011,00ARRK0046,M,1,44500,135000,2,0,40500,1,0,18900,94500,75600
01SCS19E250306,ESH.AR-SE0029,00ARSE0263,S,1,44500,135000,2,0,40500,1,0,18900,94500,75600
01SCS19E250307,ESH.AR-SC0013,00ARSC0105,M,1,44500,135000,2,0,40500,1,0,18900,94500,75600
01SCS19E250307,ESH.AR-SE0037,00ARSE0328,S,1,44000,135000,2,0,40500,1,0,18900,94500,75600
01SCS19E250308,AR.MKV-SE019,20ARSE0606,M,1,97500,150000,0,0,0,0,0,52500,150000,97500
01SCS19E250308,BSC.AR-SB0003,00ARSB0045,L,1,125000,315000,2,0,94500,1,0,44100,220500,176400
01SCS19E250308,ESH.AR-SD0004,00ARSD0048,XL,1,44500,135000,2,0,40500,1,0,18900,94500,75600
01SCS19E250309,AR.TUC-SB014,20ARSB0206,XL,1,94250,145000,2,0,29000,1,0,29000,116000,87000
01SCS19E250309,BSC.AR-SD0008,00ARSD0036,XL,1,44500,159000,2,0,47700,1,0,22260,111300,89040
01SCS19E250310,BSC.AR-SE0031,00ARSE0292,M,1,52000,155000,2,0,46500,1,0,21700,108500,86800
01SCS19E250311,BSC.AR-RH0009,00ARRH0053,NON,1,98000,140000,2,0,42000,1,0,19600,98000,78400
01SCS19E250312,AR.STY-RK003,20ARRK0525,ALL,1,61750,95000,2,0,19000,1,0,19000,76000,57000
01SCS19E250312,ESH.AR-SE0009,00ARSE0034,M,1,44500,135000,2,0,40500,1,0,18900,94500,75600
01SCS19E250313,ESH.AR-SE0001,00ARSE0001,S,1,44000,135000,2,0,40500,1,0,18900,94500,75600
01SCS19E250314,ESH.AR-SE0027,00ARSE0258,XL,1,44500,135000,2,0,40500,1,0,18900,94500,75600
01SCS19E250315,ESH.AR-SB0021,00ARSB0120,M,1,44500,135000,2,0,40500,1,0,18900,94500,75600
01SCS19E250316,AR.ESB-SE008,20ARSE0267,M,1,100750,155000,2,0,31000,1,0,31000,124000,93000
01SCS19E250317,BSC.AR-RK0009,00ARRK0082,M,1,52000,155000,2,0,46500,1,0,21700,108500,86800
01SCS19E250318,AR.PUB-SB011,20ARSB0015,28,1,211250,325000,2,0,65000,1,0,65000,260000,195000
01SCS19E250319,ESH.AR-SC0008,00ARSC0069,M,1,44500,135000,2,0,40500,1,0,18900,94500,75600
01SCS19E250320,BSC.AR-SB0008,00ARSB0080,L,1,44500,135000,2,0,40500,1,0,18900,94500,75600
01SCS19E250321,AR.PUB-SD035,20ARSD0345,M,1,204750,315000,2,0,63000,1,0,63000,252000,189000
01SCS19E250322,ESH.AR-SE0031,00ARSE0273,L,1,125000,315000,2,0,94500,1,0,44100,220500,176400
01SCS19E250323,AR.BPH-RH033,20ARRH0809,S,1,220350,339000,2,0,169500,1,0,42375,169500,127125
01SCS19E250324,ESH.AR-SD0032,00ARSD0304,M,1,44500,135000,2,0,40500,1,0,18900,94500,75600
01SCS19E250325,ESH.AR-SB0016,00ARSB0067,M,1,125000,315000,2,0,94500,1,0,44100,220500,176400
01SCS19E250326,ESH.AR-SC0011,00ARSC0085,M,1,44000,135000,2,0,40500,1,0,18900,94500,75600
01SCS19E250327,BSC.AR-SE0031,00ARSE0292,M,1,52000,155000,2,0,46500,1,0,21700,108500,86800
01SCS19E250328,ESH.AR-SD0021,00ARSD0165,M,1,125000,315000,2,0,94500,1,0,44100,220500,176400
01SCS19E250329,BSC.AR-SC0029,00ARSC0199,S,1,125000,315000,2,0,94500,1,0,44100,220500,176400
01SCS19E250330,BSC.AR-SE0001,00ARSE0057,S,1,44500,159000,2,0,47700,1,0,22260,111300,89040
01SCS19E250331,AR.HLW-SA006,20ARSA0093,ALL,1,71500,110000,2,0,22000,1,0,22000,88000,66000
01SCS19E250332,BSC.AR-RJ0007,00ARRJ0064,M,1,430000,135000,2,0,40500,1,0,18900,94500,75600
01SCS19E250333,AR.MER-RH003,20ARRH0226,ALL,1,84500,130000,2,0,39000,1,0,22750,91000,68250
01SCS19E250333,AR.REC-SD010,20ARSD0039,L,1,178750,275000,2,0,82500,1,0,48125,192500,144375
01SCS19E250334,BSC.AR-RL0025,00ARRL0168,L,1,94500,135000,2,0,40500,1,0,18900,94500,75600
01SCS19E250334,ESH.AR-SC0019,00ARSC0149,S,1,125000,315000,2,0,94500,1,0,44100,220500,176400
01SCS19E250335,BE.RAK-RL029,00BERL0102,S,1,259350,399000,2,0,79800,1,0,79800,319200,239400
01SCS19E250336,BSC.AR-SC0023,00ARSC0174,M,1,44500,135000,2,0,40500,1,0,18900,94500,75600
01SCS19E250337,BSC.AR-RL0018,00ARRL0112,XL,1,125000,315000,2,0,94500,1,0,44100,220500,176400
01SCS19E250338,ESH.AR-SC0009,00ARSC0077,M,1,44500,135000,2,0,40500,1,0,18900,94500,75600
01SCS19E250339,ESH.AR-SE0001,00ARSE0001,S,1,44000,135000,2,0,40500,1,0,18900,94500,75600
01SCS19E250340,BSC.AR-SA0019,00ARSA0063,S,1,44000,135000,2,0,40500,1,0,18900,94500,75600
01SCS19E250341,BSC.AR-SA0018,00ARSA0059,S,1,44000,135000,2,0,40500,1,0,18900,94500,75600
01SCS19E250342,ESH.AR-SD0021,00ARSD0164,S,1,125000,315000,2,0,94500,1,0,44100,220500,176400
01SCS19E250343,ESH.AR-SD0011,00ARSD0075,L,1,125000,315000,2,0,94500,1,0,44100,220500,176400
01SCS19E250344,BSC.AR-SE0037,00ARSE0346,S,1,44000,159000,2,0,47700,1,0,22260,111300,89040
01SCS19E250345,ESH.AR-SB0026,00ARSB0158,NON,1,35300,120000,2,0,36000,1,0,16800,84000,67200
01SCS19E250346,AR.PCT-RJ002,20ARRJ0281,M,1,211250,325000,2,0,97500,1,0,56875,227500,170625
01SCS19E250347,AR.CPT-SD011,20ARSD0455,L,1,94250,145000,2,0,29000,1,0,29000,116000,87000
01SCS19E250348,AR.VCS-SC006,20ARSC0392,S,1,214500,330000,2,0,99000,1,0,57750,231000,173250
01SCS19E250349,AR.PCT-SE016,20ARSE0681,L,1,87750,135000,2,0,27000,1,0,27000,108000,81000
01SCS19E250350,BSC.AR-SC0009,00ARSC0052,S,1,125000,315000,2,0,94500,1,0,44100,220500,176400
01SCS19E250351,AR.MDS-QL016,20ARQL0070,M,1,104000,160000,2,0,32000,1,0,32000,128000,96000
01SCS19E250352,BSC.AR-RH0017,00ARRH0076,L,1,120000,315000,2,0,94500,1,0,44100,220500,176400
01SCS19E250353,ESH.AR-SE0001,00ARSE0002,M,1,44000,135000,2,0,40500,1,0,18900,94500,75600
01SCS19E250354,AR.PUB-SD005,20ARSD0091,ALL,1,97500,150000,2,0,30000,1,0,30000,120000,90000
01SCS19E250355,ESH.AR-SE0029,00ARSE0263,S,1,44500,135000,2,0,40500,1,0,18900,94500,75600
01SCS19E250356,BSC.AR-SA0017,00ARSA0053,L,1,125000,315000,2,0,94500,1,0,44100,220500,176400
01SCS19E250357,AR.MKV-RJ029,20ARRJ0445,XL,1,165750,255000,0,0,0,0,0,89250,255000,165750
01SCS19E250357,BSC.AR-RJ0009,00ARRJ0073,L,1,94500,135000,2,0,40500,1,0,18900,94500,75600
01SCS19E250358,BSC.AR-SD0006,00ARSD0021,S,1,44000,159000,2,0,47700,1,0,22260,111300,89040
01SCS19E250359,AR.SMD-SD009,20ARSD0309,XL,1,243750,375000,2,0,112500,1,0,65625,262500,196875
01SCS19E250360,AR.MPR-SE031,20ARSE0297,L,1,230750,355000,2,0,71000,1,0,71000,284000,213000
01SCS19E250361,AR.MPR-SE011,20ARSE0179,L,1,97500,150000,2,0,45000,1,0,26250,105000,78750
01SCS19E250362,BSC.AR-SD0016,00ARSD0120,L,1,122000,375000,2,0,112500,1,0,52500,262500,210000
01SCS19E250363,ESH.AR-SE0030,00ARSE0268,M,1,125000,315000,2,0,94500,1,0,44100,220500,176400
01SCS19E250364,BSC.AR-RI0024,00ARRI0133,NON,1,43000,140000,2,0,42000,1,0,19600,98000,78400
01SCS19E250365,BSC.AR-SA0014,00ARSA0040,NON,1,47500,140000,2,0,42000,1,0,19600,98000,78400
01SCS19E250365,DKS.AR-SE0008,00ARSE0159,36,1,41727,696000,2,0,69600,1,0,93960,626400,532440
01SCS19E250366,AR.ESB-RK002,20ARRK0230,XL,1,198250,305000,2,0,61000,1,0,61000,244000,183000
01SCS19E250367,ESH.AR-SC0037,00ARSC0302,NON,1,40000,140000,2,0,42000,1,0,19600,98000,78400
01SCS19E250368,BSC.AR-RJ0014,00ARRJ0092,M,1,43000,135000,2,0,40500,1,0,18900,94500,75600
01SCS19E250369,AR.MKV-SE021,20ARSE0612,M,1,97500,150000,0,0,0,0,0,52500,150000,97500
01SCS19E250370,AR.TUC-SE006,20ARSE0385,L,1,204750,315000,2,0,63000,1,0,63000,252000,189000
01SCS19E250371,AR.PUB-RJ032,20ARRJ0395,XL,1,97500,150000,2,0,30000,1,0,30000,120000,90000
01SCS19E250372,AR.CPT-RE009,20ARRE0703,L,1,204750,315000,2,0,63000,1,0,63000,252000,189000
01SCS19E250373,BSC.AR-SC0046,00ARSC0298,NON,1,45000,150000,2,0,45000,1,0,21000,105000,84000
01SCS19E250374,BSC.AR-RJ0013,00ARRJ0089,L,1,94500,135000,2,0,40500,1,0,18900,94500,75600
01SCS19E250375,ESH.AR-SE0027,00ARSE0257,L,1,44500,135000,2,0,40500,1,0,18900,94500,75600
01SCS19E250376,AR.VRS-RB003,20ARRB0188,ALL,1,109850,169000,2,0,50700,1,0,29575,118300,88725
01SCS19E250377,BSC.AR-SD0052,00ARSD0282,XL,1,44500,159000,2,0,47700,1,0,22260,111300,89040
01SCS19E250378,AR.PUB-RH010,20ARRH0025,M,1,97500,150000,2,0,30000,1,0,30000,120000,90000
01SCS19E250378,BSC.AR-SE0031,00ARSE0292,M,1,52000,155000,2,0,46500,1,0,21700,108500,86800
01SCS19E250379,BSC.AR-SD0058,00ARSD0294,NON,1,50000,150000,2,0,45000,1,0,21000,105000,84000
01SCS19E250380,ESH.AR-SB0010,00ARSB0040,M,1,44500,135000,2,0,40500,1,0,18900,94500,75600
01SCS19E250381,BSC.AR-SD0006,00ARSD0022,M,1,44000,159000,2,0,47700,1,0,22260,111300,89040
01SCS19E250381,ESH.AR-RJ0011,00ARRJ0052,M,1,94500,135000,2,0,40500,1,0,18900,94500,75600
01SCS19E250382,BSC.AR-SC0011,00ARSC0064,S,1,44000,159000,2,0,47700,1,0,22260,111300,89040
01SCS19E250383,THR.AR-RG0006,00ARRG0052,L,1,415000,415000,2,0,41500,1,0,56025,373500,317475
01SCS19E250384,BSC.AR-SD0044,00ARSD0237,L,1,44500,159000,2,0,47700,1,0,22260,111300,89040
01SCS19E250385,ESH.AR-SE0038,00ARSE0333,M,1,44500,135000,2,0,40500,1,0,18900,94500,75600
01SCS19E250386,AR.MPR-SE008,20ARSE0166,M,1,97500,150000,2,0,45000,1,0,26250,105000,78750
01SCS19E250387,AR.CPT-SC006,20ARSC0261,M,1,94250,145000,2,0,29000,1,0,29000,116000,87000
01SCS19E250388,ESH.AR-SE0001,00ARSE0003,L,1,44000,135000,2,0,40500,1,0,18900,94500,75600
01SCS19E250389,AR.MKV-SE014,20ARSE0587,S,1,22750,350000,0,0,0,0,0,122500,350000,227500
01SCS19E250390,AR.MPR-SE032,20ARSE0300,M,1,230750,355000,2,0,71000,1,0,71000,284000,213000
01SCS19E250391,BSC.AR-SD0039,00ARSD0212,M,1,125000,315000,2,0,94500,1,0,44100,220500,176400
01SCS19E250392,ESH.AR-SE0031,00ARSE0271,S,1,125000,315000,2,0,94500,1,0,44100,220500,176400
01SCS19E250393,AR.TUC-SE023,20ARSE0653,32,1,204750,315000,2,0,63000,1,0,63000,252000,189000
01SCS19E250394,AR.CPT-RK007,20ARRK0025,L,1,204750,315000,2,0,63000,1,0,63000,252000,189000
01SCS19E250394,AR.CPT-SD006,20ARSD0433,S,1,200850,309000,2,0,61800,1,0,61800,247200,185400
01SCS19E250395,BSC.AR-RL0020,00ARRL0117,S,1,125000,315000,2,0,94500,1,0,44100,220500,176400
01SCS19E250395,BSC.AR-SC0029,00ARSC0199,S,1,125000,315000,2,0,94500,1,0,44100,220500,176400
01SCS19E250396,AR.TUC-SB008,20ARSB0036,ALL,1,61750,95000,2,0,19000,1,0,19000,76000,57000
01SCS19E250397,AR.MPR-SE037,20ARSE0313,ALL,1,130000,200000,2,0,40000,1,0,40000,160000,120000
01SCS19E250398,BSC.AR-SD0058,00ARSD0294,NON,1,50000,150000,2,0,45000,1,0,21000,105000,84000
01SCS19E250399,THR.AR-QK0007,00ARRE0221,NON,1,415000,415000,2,0,41500,1,0,56025,373500,317475
01SCS19E250400,BSC.AR-SD0055,00ARSD0288,NON,1,50000,150000,2,0,45000,1,0,21000,105000,84000
01SCS19E250401,BSC.AR-SD0061,00ARSD0336,NON,1,45000,150000,2,0,45000,1,0,21000,105000,84000
01SCS19E250402,BSC.AR-SB0015,00ARSB0127,S,1,125000,315000,2,0,94500,1,0,44100,220500,176400
01SCS19E250402,ESH.AR-SB0032,00ARSB0208,S,1,125000,315000,2,0,94500,1,0,44100,220500,176400
01SCS19E250403,ESH.AR-SA0001,00ARSA0014,30,1,122500,175000,2,0,52500,1,0,24500,122500,98000
01SCS19E250404,BSC.AR-SE0027,00ARSE0276,M,1,52000,155000,2,0,46500,1,0,21700,108500,86800
01SCS19E250404,BSC.AR-SE0031,00ARSE0292,M,1,52000,155000,2,0,46500,1,0,21700,108500,86800
01SCS19E250405,ESH.AR-RI0001,00ARRI0070,S,1,43000,135000,2,0,40500,1,0,18900,94500,75600
01SCS19E250406,BSC.AR-SD0042,00ARSD0227,S,1,44500,159000,2,0,47700,1,0,22260,111300,89040
01SCS19E250407,AR.PCT-SE011,20ARSE0671,L,1,211250,325000,2,0,65000,1,0,65000,260000,195000
01SCS19E250408,BSC.AR-SD0056,00ARSD0290,M,1,125000,315000,2,0,94500,1,0,44100,220500,176400
01SCS19E250409,AR.CLK-SA002,20ARSA0051,ALL,1,84500,130000,2,0,26000,1,0,26000,104000,78000
01SCS19E250410,BSC.AR-SD0022,00ARSD0128,S,1,44000,159000,2,0,47700,1,0,22260,111300,89040
01SCS19E250411,BSC.AR-SE0031,00ARSE0292,M,1,52000,155000,2,0,46500,1,0,21700,108500,86800
01SCS19E250412,ESH.AR-SD0030,00ARSD0295,S,1,44500,135000,2,0,40500,1,0,18900,94500,75600
01SCS19E250413,AR.HLW-SE014,20ARSE0561,L,1,100750,155000,2,0,31000,1,0,31000,124000,93000
01SCS19E250413,AR.SMD-RI001,20ARRI0220,M,1,87750,135000,2,0,40500,1,0,23625,94500,70875
01SCS19E250414,AR.MPR-SE037,20ARSE0313,ALL,1,130000,200000,2,0,40000,1,0,40000,160000,120000
01SCS19E250415,BSC.AR-SC0034,00ARSC0229,M,1,125000,315000,2,0,94500,1,0,44100,220500,176400
01SCS19E250416,AR.MPR-SE014,20ARSE0189,S,1,237250,365000,2,0,73000,1,0,73000,292000,219000
01SCS19E250417,BSC.AR-SD0052,00ARSD0281,L,1,44500,159000,2,0,47700,1,0,22260,111300,89040
01SCS19E250418,BSC.AR-SC0009,00ARSC0052,S,1,125000,315000,2,0,94500,1,0,44100,220500,176400
01SCS19E250419,BSC.AR-SE0005,00ARSE0073,S,1,44000,159000,2,0,47700,1,0,22260,111300,89040
01SCS19E250420,ESH.AR-SB0007,00ARSB0028,M,1,44000,135000,2,0,40500,1,0,18900,94500,75600
01SCS19E250421,ESH.AR-SB0022,00ARSB0123,S,1,44000,135000,2,0,40500,1,0,18900,94500,75600
01SCS19E250422,AR.MPR-SE023,20ARSE0210,S,1,230750,355000,2,0,71000,1,0,71000,284000,213000
01SCS19E250423,AR.REC-SD009,20ARSD0034,M,1,178750,275000,2,0,82500,1,0,48125,192500,144375
01SCS19E250424,ESH.AR-SA0005,00ARSA0068,M,1,44000,135000,2,0,40500,1,0,18900,94500,75600
01SCS19E250424,ESH.AR-SD0007,00ARSD0058,M,1,44500,135000,2,0,40500,1,0,18900,94500,75600
01SCS19E250424,ESH.AR-SE0028,00ARSE0260,M,1,44000,135000,2,0,40500,1,0,18900,94500,75600
01SCS19E250425,BSC.AR-SC0043,00ARSC0289,M,1,44000,135000,2,0,40500,1,0,18900,94500,75600
01SCS19E250426,BSC.AR-SC0014,00ARSC0097,M,1,44000,159000,2,0,47700,1,0,22260,111300,89040
01SCS19E250427,BSC.AR-SC0006,00ARSC0038,S,1,44000,135000,2,0,40500,1,0,18900,94500,75600
01SCS19E250428,ESH.AR-SC0004,00ARSC0021,S,1,44500,135000,2,0,40500,1,0,18900,94500,75600
01SCS19E250429,AR.ESB-RE007,20ARRE0357,XL,1,87750,135000,2,0,67500,1,0,16875,67500,50625
01SCS19E250430,ESH.AR-SD0032,00ARSD0303,S,1,44500,135000,2,0,40500,1,0,18900,94500,75600
01SCS19E250431,BSC.AR-SC0007,00ARSC0043,M,1,44000,135000,2,0,40500,1,0,18900,94500,75600
01SCS19E250432,BSC.AR-SB0017,00ARSB0137,M,1,44000,135000,2,0,40500,1,0,18900,94500,75600
01SCS19E250433,AR.CPT-SE004,20ARSE0367,XL,1,204750,315000,2,0,63000,1,0,63000,252000,189000
01SCS19E250434,AR.CPT-RL006,20ARRL0092,L,1,94250,145000,2,0,29000,1,0,29000,116000,87000
01SCS19E250434,BSC.AR-SD0058,00ARSD0294,NON,1,50000,150000,2,0,45000,1,0,21000,105000,84000
01SCS19E250435,BSC.AR-SD0039,00ARSD0211,S,1,125000,315000,2,0,94500,1,0,44100,220500,176400
01SCS19E250436,ESH.AR-SE0007,00ARSE0025,S,1,44500,135000,2,0,40500,1,0,18900,94500,75600
01SCS19E250437,DKS.AR-SE0004,00ARSE0140,30,1,417272,696000,2,0,69600,1,0,93960,626400,532440
01SCS19E250438,BSC.AR-SC0015,00ARSC0102,L,1,44000,159000,2,0,47700,1,0,22260,111300,89040
01SCS19E250439,BSC.AR-SC0029,00ARSC0199,S,1,125000,315000,2,0,94500,1,0,44100,220500,176400
01SCS19E250440,BSC.AR-SC0005,00ARSC0035,M,1,44500,159000,2,0,47700,1,0,22260,111300,89040
01SCS19E250441,AR.ESB-RE008,20ARRE0358,M,2,94250,145000,2,0,72500,1,0,18125,145000,108750
01SCS19E250441,AR.ESB-SC015,20ARSC0443,M,1,87750,135000,2,0,27000,1,0,27000,108000,81000
01SCS19E250442,AR.SMD-RI008,20ARRI0333,ALL,1,143000,220000,2,0,44000,1,0,44000,176000,132000
01SCS19E250443,AR.MPR-SB002,20ARSB0239,M,1,243750,375000,2,0,75000,1,0,75000,300000,225000
01SCS19E250444,ESH.AR-SB0007,00ARSB0028,M,1,44000,135000,2,0,40500,1,0,18900,94500,75600
01SCS19E250445,BSC.AR-SD0016,00ARSD0119,M,1,122000,375000,2,0,112500,1,0,52500,262500,210000
01SCS19E250446,BSC.AR-SD0016,00ARSD0118,S,1,122000,375000,2,0,112500,1,0,52500,262500,210000
01SCS19E250447,BSC.AR-RH0025,00ARRH0161,L,1,115000,350000,2,0,105000,1,0,49000,245000,196000
01SCS19E250448,ESH.AR-SE0010,00ARSE0037,S,2,44000,135000,2,0,40500,1,0,18900,189000,151200
01SCS19E250449,BSC.AR-RI0031,00ARRI0140,NON,1,43000,140000,2,0,42000,1,0,19600,98000,78400
01SCS19E250450,BSC.AR-SD0046,00ARSD0244,M,1,44500,159000,2,0,47700,1,0,22260,111300,89040
01SCS19E250450,ESH.AR-SE0027,00ARSE0257,L,1,44500,135000,2,0,40500,1,0,18900,94500,75600
01SCS19E250451,BSC.AR-RJ0013,00ARRJ0089,L,1,94500,135000,2,0,40500,1,0,18900,94500,75600
01SCS19E250451,BSC.AR-SD0002,00ARSD0005,S,1,44000,159000,2,0,47700,1,0,22260,111300,89040
01SCS19E250452,AR.PCT-SE020,20ARSE0689,L,1,87750,135000,2,0,27000,1,0,27000,108000,81000
01SCS19E250453,AR.VRS-RB003,20ARRB0188,ALL,1,109850,169000,2,0,50700,1,0,29575,118300,88725
01SCS19E250454,BSC.AR-SA0002,00ARSA0005,S,1,120000,315000,2,0,94500,1,0,44100,220500,176400
01SCS19E250455,BSC.AR-SD0055,00ARSD0288,NON,1,50000,150000,2,0,45000,1,0,21000,105000,84000
01SCS19E250456,BSC.AR-RL0019,00ARRL0115,L,1,125000,315000,2,0,94500,1,0,44100,220500,176400
01SCS19E250457,ESH.AR-SE0001,00ARSE0003,L,1,44000,135000,2,0,40500,1,0,18900,94500,75600
01SCS19E250457,ESH.AR-SE0017,00ARSE0115,L,1,44000,135000,2,0,40500,1,0,18900,94500,75600
01SCS19E250458,BSC.AR-SD0042,00ARSD0228,M,1,44500,159000,2,0,47700,1,0,22260,111300,89040
01SCS19E250459,ESH.AR-SD0038,00ARSD0345,L,1,122500,350000,2,0,105000,1,0,49000,245000,196000
01SCS19E250460,AR.BPH-SD001,20ARSD0358,M,1,103350,159000,2,0,47700,1,0,27825,111300,83475
01SCS19E250460,ESH.AR-SC0028,00ARSC0266,M,1,44500,135000,2,0,40500,1,0,18900,94500,75600
01SCS19E250461,ESH.AR-SE0037,00ARSE0328,S,1,44000,135000,2,0,40500,1,0,18900,94500,75600
01SCS19E250462,ESH.AR-SB0021,00ARSB0120,M,1,44500,135000,2,0,40500,1,0,18900,94500,75600
01SCS19E250462,ESH.AR-SB0022,00ARSB0125,L,1,44000,135000,2,0,40500,1,0,18900,94500,75600
01SCS19E250462,ESH.AR-SC0009,00ARSC0077,M,1,44500,135000,2,0,40500,1,0,18900,94500,75600
01SCS19E250463,BSC.AR-SD0020,00ARSD0125,NON,1,55000,150000,2,0,45000,1,0,21000,105000,84000
01SCS19E250463,ESH.AR-SC0035,00ARSC0300,NON,1,55000,140000,2,0,42000,1,0,19600,98000,78400
01SCS19E250464,BE.RAK-SC030,00BESC0121,S,1,211250,325000,2,0,65000,1,0,65000,260000,195000
01SCS19E250465,BSC.AR-SB0007,00ARSB0075,M,1,44500,135000,2,0,40500,1,0,18900,94500,75600
01SCS19E250465,BSC.AR-SC0049,00ARSC0308,S,1,44500,159000,2,0,47700,1,0,22260,111300,89040
01SCS19E250466,AR.SMD-SD013,20ARSD0570,M,1,87750,135000,2,0,27000,1,0,27000,108000,81000
01SCS19E250467,BSC.AR-SD0022,00ARSD0128,S,1,44000,159000,2,0,47700,1,0,22260,111300,89040
01SCS19E250468,AR.CPT-QL011,20ARQL0167,M,1,204750,315000,2,0,63000,1,0,63000,252000,189000
01SCS19E250469,AR.STY-SE012,20ARSE0578,ALL,1,55250,85000,2,0,17000,1,0,17000,68000,51000
01SCS19E250470,BSC.AR-SA0005,00ARSA0022,S,1,44000,135000,2,0,40500,1,0,18900,94500,75600
01SCS19E250471,AR.MKV-SC012,20ARSC0110,ALL,1,97500,150000,0,0,0,0,0,52500,150000,97500
01SCS19E250472,AR.TUC-SE020,20ARSE0641,L,1,204750,315000,2,0,63000,1,0,63000,252000,189000
01SCS19E250473,ESH.AR-SC0008,00ARSC0069,M,1,44500,135000,2,0,40500,1,0,18900,94500,75600
01SCS19E250474,AR.TUC-SB014,20ARSB0205,L,1,94250,145000,2,0,29000,1,0,29000,116000,87000
01SCS19E250475,AR.TUC-SE010,20ARSE0401,L,1,94250,145000,2,0,29000,1,0,29000,116000,87000
01SCS19E250476,BSC.AR-SE0037,00ARSE0346,S,1,44000,159000,2,0,47700,1,0,22260,111300,89040
01SCS19E250476,ESH.AR-SC0011,00ARSC0084,S,1,44000,135000,2,0,40500,1,0,18900,94500,75600
01SCS19E250476,ESH.AR-SE0029,00ARSE0263,S,1,44500,135000,2,0,40500,1,0,18900,94500,75600
01SCS19E250477,BSC.AR-SC0015,00ARSC0102,L,1,44000,159000,2,0,47700,1,0,22260,111300,89040
01SCS19E250478,ESH.AR-SD0018,00ARSD0137,M,1,125000,315000,2,0,94500,1,0,44100,220500,176400
01SCS19E250479,ESH.AR-SC0010,00ARSC0081,M,1,44500,135000,2,0,40500,1,0,18900,94500,75600
01SCS19E250480,ESH.AR-SE0001,00ARSE0003,L,1,44000,135000,2,0,40500,1,0,18900,94500,75600
01SCS19E250481,ESH.AR-SC0019,00ARSC0150,M,1,125000,315000,2,0,94500,1,0,44100,220500,176400
01SCS19E250482,BSC.AR-SD0027,00ARSD0157,M,1,125000,315000,2,0,94500,1,0,44100,220500,176400
01SCS19E250483,ESH.AR-RK0004,00ARRK0015,L,1,120000,315000,2,0,94500,1,0,44100,220500,176400
01SCS19E250484,AR.CPT-RK007,20ARRK0024,M,1,204750,315000,2,0,63000,1,0,63000,252000,189000
01SCS19E250485,ESH.AR-SB0016,00ARSB0067,M,1,125000,315000,2,0,94500,1,0,44100,220500,176400
01SCS19E250486,ESH.AR-SD0012,00ARSD0078,32,1,145000,375000,2,0,112500,1,0,52500,262500,210000
01SCS19E250487,BSC.AR-SB0002,00ARSB0022,XL,1,44500,135000,2,0,40500,1,0,18900,94500,75600
01SCS19E250488,AR.MPR-SE017,20ARSE0201,ALL,1,97500,150000,2,0,45000,1,0,26250,105000,78750
01SCS19E250489,AR.MER-QJ005,20ARQJ0409,ALL,1,84500,130000,2,0,39000,1,0,22750,91000,68250
01SCS19E250490,AR.CLK-RH001,20ARRH0736,ALL,1,91000,140000,2,0,28000,1,0,28000,112000,84000
01SCS19E250490,AR.CLK-RH002,20ARRH0737,ALL,1,91000,140000,2,0,28000,1,0,28000,112000,84000
01SCS19E250491,ESH.AR-RJ0028,00ARRJ0236,NON,1,45000,135000,2,0,40500,1,0,18900,94500,75600
01SCS19E250492,BSC.AR-RL0019,00ARRL0115,L,1,125000,315000,2,0,94500,1,0,44100,220500,176400
01SCS19E250493,ESH.AR-SD0032,00ARSD0304,M,1,44500,135000,2,0,40500,1,0,18900,94500,75600
01SCS19E250494,AR.PCT-SE011,20ARSE0671,L,1,211250,325000,2,0,65000,1,0,65000,260000,195000
01SCS19E250494,AR.PUB-RG008,20ARRG0048,L,1,97500,150000,2,0,30000,1,0,30000,120000,90000
01SCS19E250494,AR.REC-SD011,20ARSD0042,M,1,107250,165000,2,0,49500,1,0,28875,115500,86625
01SCS19E250495,AR.TUC-SB012,20ARSB0196,M,1,204750,315000,2,0,63000,1,0,63000,252000,189000
01SCS19E250496,ESH.AR-SD0007,00ARSD0058,M,1,44500,135000,2,0,40500,1,0,18900,94500,75600
01SCS19E250497,DKS.AR-SE0006,00ARSE0149,34,1,417272,696000,2,0,69600,1,0,93960,626400,532440
01SCS19E250497,DKS.AR-SE0007,00ARSE0152,30,1,417272,696000,2,0,69600,1,0,93960,626400,532440
01SCS19E250498,AR.TUC-SE009,20ARSE0398,L,1,204750,315000,2,0,63000,1,0,63000,252000,189000
01SCS19E250499,ESH.AR-SE0007,00ARSE0026,M,1,44500,135000,2,0,40500,1,0,18900,94500,75600
01SCS19E250500,ESH.AR-SB0029,00ARSB0196,S,1,125000,315000,2,0,94500,1,0,44100,220500,176400
01SCS19E250501,ESH.AR-SE0038,00ARSE0332,S,1,44500,135000,2,0,40500,1,0,18900,94500,75600
01SCS19E250502,AR.CPT-RI004,20ARRI0053,M,1,94250,145000,2,0,29000,1,0,29000,116000,87000
01SCS19E250503,ESH.AR-SD0025,00ARSD0262,S,1,44000,135000,2,0,40500,1,0,18900,94500,75600
01SCS19E250504,AR.CPT-RH009,20ARRH0873,M,1,204750,315000,2,0,63000,1,0,63000,252000,189000
01SCS19E250504,AR.MKV-SE021,20ARSE0612,M,1,97500,150000,0,0,0,0,0,52500,150000,97500
01SCS19E250505,BSC.AR-RL0018,00ARRL0110,M,1,125000,315000,2,0,94500,1,0,44100,220500,176400
01SCS19E250506,BSC.AR-RJ0018,00ARRJ0109,L,1,94500,135000,2,0,40500,1,0,18900,94500,75600
01SCS19E250506,ESH.AR-SC0026,00ARSC0237,M,1,44500,135000,2,0,40500,1,0,18900,94500,75600
01SCS19E250507,AR.PCT-SE011,20ARSE0671,L,1,211250,325000,2,0,65000,1,0,65000,260000,195000
01SCS19E250508,AR.MPR-SE019,20ARSE0203,ALL,1,97500,150000,2,0,45000,1,0,26250,105000,78750
01SCS19E250509,AR.TUC-SE006,20ARSE0386,XL,1,204750,315000,2,0,63000,1,0,63000,252000,189000
01SCS19E250510,AR.MPR-SE022,20ARSE0207,M,1,243750,375000,2,0,75000,1,0,75000,300000,225000
01SCS19E250511,ESH.AR-SD0021,00ARSD0164,S,1,125000,315000,2,0,94500,1,0,44100,220500,176400
01SCS19E250512,AR.ESB-SD002,20ARSD0100,S,1,74750,115000,2,0,23000,1,0,23000,92000,69000
01SCS19E250513,AR.ESB-RB014,20ARRB0372,ALL,1,91000,140000,2,0,70000,1,0,17500,70000,52500
01SCS19E250513,BSC.AR-SD0022,00ARSD0129,M,1,44000,159000,2,0,47700,1,0,22260,111300,89040
01SCS19E250513,ESH.AR-SD0031,00ARSD0300,M,1,44000,135000,2,0,40500,1,0,18900,94500,75600
01SCS19E250514,ESH.AR-SD0041,00ARSD0372,L,1,125000,315000,2,0,94500,1,0,44100,220500,176400
01SCS19E250515,BSC.AR-SA0002,00ARSA0005,S,1,120000,315000,2,0,94500,1,0,44100,220500,176400
01SCS19E250516,AR.HLW-SE006,20ARSE0538,M,1,100750,155000,2,0,31000,1,0,31000,124000,93000
01SCS19E250517,AR.MKV-SE008,20ARSE0506,32,1,227500,350000,0,0,0,0,0,122500,350000,227500
01SCS19E250518,AR.BPH-SA003,20ARSA0248,ALL,1,159000,159000,2,0,47700,1,0,27825,111300,83475
01SCS19E250519,AR.ESB-SC001,20ARSC0307,XL,1,204750,315000,2,0,63000,1,0,63000,252000,189000
01SCS19E250520,AR.VLD-SA007,20ARSA0185,ALL,1,120250,185000,2,0,55500,1,0,32375,129500,97125
01SCS19E250521,ESH.AR-SD0021,00ARSD0166,L,1,125000,315000,2,0,94500,1,0,44100,220500,176400
01SCS19E250522,AR.MPR-SE031,20ARSE0297,L,1,230750,355000,2,0,71000,1,0,71000,284000,213000
01SCS19E250523,AR.ESB-SC004,20ARSC0422,S,1,94250,145000,2,0,29000,1,0,29000,116000,87000
01SCS19E250524,ESH.AR-SE0025,00ARSE0247,S,1,44500,135000,2,0,40500,1,0,18900,94500,75600
01SCS19E250525,BSC.AR-SD0038,00ARSD0208,M,1,125000,315000,2,0,94500,1,0,44100,220500,176400
01SCS19E250525,ESH.AR-SC0002,00ARSC0006,M,1,44500,135000,2,0,40500,1,0,18900,94500,75600
01SCS19E250525,ESH.AR-SD0007,00ARSD0057,S,1,44500,135000,2,0,40500,1,0,18900,94500,75600
01SCS19E250525,ESH.AR-SE0019,00ARSE0122,M,1,44000,135000,2,0,40500,1,0,18900,94500,75600
01SCS19E250525,ESH.AR-SE0038,00ARSE0333,M,1,44500,135000,2,0,40500,1,0,18900,94500,75600
01SCS19E250526,ESH.AR-SE0001,00ARSE0003,L,1,44000,135000,2,0,40500,1,0,18900,94500,75600
01SCS19E250527,BSC.AR-SD0056,00ARSD0289,S,1,125000,315000,2,0,94500,1,0,44100,220500,176400
01SCS19E250528,ESH.AR-RJ0019,00ARRJ0206,NON,1,40000,115000,2,0,34500,1,0,16100,80500,64400
01SCS19E250529,ESH.AR-RE0022,00ARRE0237,NON,1,20000,75000,2,0,22500,1,0,10500,52500,42000
01SCS19E250529,ESH.AR-RK0004,00ARRK0015,L,1,120000,315000,2,0,94500,1,0,44100,220500,176400
01SCS19E250530,AR.PUB-RI018,20ARRI0266,M,1,97500,150000,2,0,30000,1,0,30000,120000,90000
01SCS19E250530,AR.STY-SE012,20ARSE0578,ALL,1,55250,85000,2,0,17000,1,0,17000,68000,51000
01SCS19E250530,BSC.AR-SD0046,00ARSD0243,S,1,44500,159000,2,0,47700,1,0,22260,111300,89040
01SCS19E250531,AR.MDG-SC002,20ARSC0156,L,1,94250,145000,2,0,43500,1,0,25375,101500,76125
01SCS19E250531,AR.PUB-SB033,20ARSB0464,ALL,1,97500,150000,2,0,30000,1,0,30000,120000,90000
01SCS19E250531,AR.SMD-RI007,20ARRI0332,XL,1,87750,135000,2,0,40500,1,0,23625,94500,70875
01SCS19E250532,AR.SMD-SD011,20ARSD0316,32,1,211250,325000,2,0,65000,1,0,65000,260000,195000
01SCS19E250533,BSC.AR-RJ0009,00ARRJ0074,XL,1,94500,135000,2,0,40500,1,0,18900,94500,75600
01SCS19E250534,BE.RAK-SB036,00BESB0112,XL,1,91000,140000,2,0,28000,1,0,28000,112000,84000
01SCS19E250535,AR.CPT-RE009,20ARRE0703,L,1,204750,315000,2,0,63000,1,0,63000,252000,189000
01SCS19E250536,AR.PUB-SE026,20ARSE0100,M,1,204750,315000,2,0,63000,1,0,63000,252000,189000
01SCS19E250537,AR.CPT-RK007,20ARRK0024,M,1,204750,315000,2,0,63000,1,0,63000,252000,189000
01SCS19E250538,BSC.AR-SE0002,00ARSE0063,L,1,44000,159000,2,0,47700,1,0,22260,111300,89040
01SCS19E250538,BSC.AR-SE0005,00ARSE0074,M,1,44000,159000,2,0,47700,1,0,22260,111300,89040
01SCS19E250538,ESH.AR-RJ0010,00ARRJ0047,S,1,94500,135000,2,0,40500,1,0,18900,94500,75600
01SCS19E250538,ESH.AR-SD0041,00ARSD0371,M,1,125000,315000,2,0,94500,1,0,44100,220500,176400
01SCS19E250539,AR.SMD-RE004,20ARRE0132,ALL,1,97500,150000,2,0,45000,1,0,26250,105000,78750
01SCS19E250539,ESH.AR-SD0029,00ARSD0278,NON,1,58000,175000,2,0,52500,1,0,24500,122500,98000
01SCS19E250540,ESH.AR-SA0009,00ARSA0087,S,1,122500,350000,2,0,105000,1,0,49000,245000,196000
01SCS19E250541,BSC.AR-RL0018,00ARRL0110,M,1,125000,315000,2,0,94500,1,0,44100,220500,176400
01SCS19E250541,BSC.AR-SE0036,00ARSE0341,28,1,125000,365000,2,0,109500,1,0,51100,255500,204400
01SCS19E250541,BSC.AR-SE0037,00ARSE0347,M,1,44000,159000,2,0,47700,1,0,22260,111300,89040
01SCS19E250542,AR.TUC-SB012,20ARSB0196,M,1,204750,315000,2,0,63000,1,0,63000,252000,189000
01SCS19E250542,ESH.AR-SC0004,00ARSC0022,M,1,44500,135000,2,0,40500,1,0,18900,94500,75600
01SCS19E250543,ESH.AR-SD0018,00ARSD0137,M,1,125000,315000,2,0,94500,1,0,44100,220500,176400
01SCS19E250544,BSC.AR-SD0007,00ARSD0028,XL,1,44500,159000,2,0,47700,1,0,22260,111300,89040
01SCS19E250545,ESH.AR-SD0030,00ARSD0295,S,1,44500,135000,2,0,40500,1,0,18900,94500,75600
01SCS19E250546,AR.MKV-SE019,20ARSE0605,S,1,97500,150000,0,0,0,0,0,52500,150000,97500
01SCS19E250546,AR.PUB-SE021,20ARSE0080,M,1,159250,245000,2,0,49000,1,0,49000,196000,147000
01SCS19E250546,BSC.AR-SD0055,00ARSD0288,NON,1,50000,150000,2,0,45000,1,0,21000,105000,84000
01SCS19E250547,AR.STY-SE008,20ARSE0126,ALL,1,55250,85000,2,0,17000,1,0,17000,68000,51000
01SCS19E250547,ESH.AR-SD0009,00ARSD0067,L,1,44500,135000,2,0,40500,1,0,18900,94500,75600
01SCS19E250547,ESH.AR-SD0038,00ARSD0345,L,1,122500,350000,2,0,105000,1,0,49000,245000,196000
01SCS19E250548,AR.MKV-SB010,20ARSB0537,L,1,97500,150000,0,0,0,0,0,52500,150000,97500
01SCS19E250549,AR.PUB-SE024,20ARSE0093,L,1,159250,245000,2,0,49000,1,0,49000,196000,147000
01SCS19E250550,BSC.AR-SD0054,00ARSD0287,NON,1,50000,150000,2,0,45000,1,0,21000,105000,84000
01SCS19E250551,AR.TUC-SE007,20ARSE0388,M,1,204750,315000,2,0,63000,1,0,63000,252000,189000
01SCS19E250552,BSC.AR-RJ0034,00ARRJ0232,M,1,220500,315000,2,0,94500,1,0,44100,220500,176400
01SCS19E250553,BSC.AR-SE0031,00ARSE0292,M,1,52000,155000,2,0,46500,1,0,21700,108500,86800
01SCS19E250554,BE.RAK-SC040,00BESC0172,S,1,91000,140000,2,0,28000,1,0,28000,112000,84000
01SCS19E250555,AR.HLW-SC012,20ARSC0149,M,1,100750,155000,2,0,46500,1,0,27125,108500,81375
01SCS19E250556,AR.STY-SE012,20ARSE0578,ALL,1,55250,85000,2,0,17000,1,0,17000,68000,51000
01SCS19E250557,BSC.AR-SD0016,00ARSD0118,S,1,122000,375000,2,0,112500,1,0,52500,262500,210000
01SCS19E250558,ESH.AR-SC0004,00ARSC0021,S,1,44500,135000,2,0,40500,1,0,18900,94500,75600
01SCS19E250558,ESH.AR-SC0032,00ARSC0280,S,1,44500,135000,2,0,40500,1,0,18900,94500,75600
01SCS19E250558,ESH.AR-SD0024,00ARSD0261,XL,1,44500,135000,2,0,40500,1,0,18900,94500,75600
01SCS19E250559,ESH.AR-SC0018,00ARSC0144,S,1,44000,135000,2,0,40500,1,0,18900,94500,75600
01SCS19E250559,ESH.AR-SE0037,00ARSE0329,M,1,44000,135000,2,0,40500,1,0,18900,94500,75600
01SCS19E250560,AR.CPT-SD009,20ARSD0447,L,1,94250,145000,2,0,29000,1,0,29000,116000,87000
01SCS19E250560,AR.CPT-SD011,20ARSD0455,L,1,94250,145000,2,0,29000,1,0,29000,116000,87000
01SCS19E250561,ESH.AR-SB0011,00ARSB0052,M,1,125000,315000,2,0,94500,1,0,44100,220500,176400
01SCS19E250562,ESH.AR-SB0021,00ARSB0121,L,1,44500,135000,2,0,40500,1,0,18900,94500,75600
01SCS19E250562,ESH.AR-SB0022,00ARSB0125,L,1,44000,135000,2,0,40500,1,0,18900,94500,75600
01SCS19E250562,ESH.AR-SC0021,00ARSC0159,L,1,44000,135000,2,0,40500,1,0,18900,94500,75600
01SCS19E250562,ESH.AR-SD0007,00ARSD0059,L,1,44500,135000,2,0,40500,1,0,18900,94500,75600
01SCS19E250563,ARN.AR-SD0001,00ARSD0221,L,1,44500,150000,0,0,0,0,0,45000,150000,105000
01SCS19E250563,ESH.AR-SC0028,00ARSC0267,L,1,44500,135000,2,0,40500,1,0,18900,94500,75600
01SCS19E250564,AR.PUB-SB022,20ARSB0122,L,1,97500,150000,2,0,30000,1,0,30000,120000,90000
01SCS19E250565,AR.PUB-RE051,20ARRE0597,XL,1,204750,315000,2,0,63000,1,0,63000,252000,189000
01SCS19E250566,BSC.AR-SE0001,00ARSE0058,M,1,44500,159000,2,0,47700,1,0,22260,111300,89040
01SCS19E250567,AR.STY-SA002,20ARSA0061,ALL,1,61750,95000,2,0,19000,1,0,19000,76000,57000
01SCS19E250567,ESH.AR-SE0009,00ARSE0033,S,1,44500,135000,2,0,40500,1,0,18900,94500,75600
01SCS19E250568,BSC.AR-SE0035,00ARSE0336,28,1,125000,365000,2,0,109500,1,0,51100,255500,204400
01SCS19E250569,BSC.AR-SD0039,00ARSD0211,S,1,125000,315000,2,0,94500,1,0,44100,220500,176400
01SCS19E250570,AR.SMD-QD001,20ARQD0024,L,1,84500,130000,2,0,39000,1,0,22750,91000,68250
01SCS19E250571,ESH.AR-SC0012,00ARSC0088,S,1,44000,135000,2,0,40500,1,0,18900,94500,75600
01SCS19E250572,AR.CPT-SE003,20ARSE0360,S,1,94250,145000,2,0,29000,1,0,29000,116000,87000
01SCS19E250572,ESH.AR-SD0043,00ARSD0394,S,1,125000,315000,2,0,94500,1,0,44100,220500,176400
01SCS19E250573,BSC.AR-SD0054,00ARSD0287,NON,1,50000,150000,2,0,45000,1,0,21000,105000,84000
01SCS19E250574,ESH.AR-SC0004,00ARSC0021,S,1,44500,135000,2,0,40500,1,0,18900,94500,75600
01SCS19E250574,ESH.AR-SC0004,00ARSC0023,L,1,44500,135000,2,0,40500,1,0,18900,94500,75600
01SCS19E250575,AR.ESB-SA002,20ARSA0208,M,1,204750,315000,2,0,63000,1,0,63000,252000,189000
01SCS19E250575,ARN.AR-RK0002,00ARRK0224,L,1,43000,140000,0,0,0,0,0,42000,140000,98000
01SCS19E250576,ESH.AR-SC0001,00ARSC0003,L,1,125000,315000,2,0,94500,1,0,44100,220500,176400
01SCS19E250577,BSC.AR-SE0027,00ARSE0276,M,1,52000,155000,2,0,46500,1,0,21700,108500,86800
01SCS19E250578,ESH.AR-SC0007,00ARSC0060,S,1,125000,350000,2,0,105000,1,0,49000,245000,196000
01SCS19E250578,ESH.AR-SD0021,00ARSD0164,S,1,125000,315000,2,0,94500,1,0,44100,220500,176400
01SCS19E250579,AR.MPR-SE032,20ARSE0300,M,1,230750,355000,2,0,71000,1,0,71000,284000,213000
01SCS19E250580,AR.MKV-SE017,20ARSE0600,M,1,97500,150000,0,0,0,0,0,52500,150000,97500
01SCS19E250581,AR.PUB-SE027,20ARSE0104,M,1,204750,315000,2,0,63000,1,0,63000,252000,189000
01SCS19E250582,AR.PUB-SD033,20ARSD0243,M,1,204750,315000,2,0,63000,1,0,63000,252000,189000
01SCS19E250583,BSC.AR-RJ0013,00ARRJ0089,L,1,94500,135000,2,0,40500,1,0,18900,94500,75600
01SCS19E250584,ESH.AR-SB0027,00ARSB0161,L,1,44000,135000,2,0,40500,1,0,18900,94500,75600
01SCS19E250585,BSC.AR-SE0001,00ARSE0057,S,1,44500,159000,2,0,47700,1,0,22260,111300,89040
01SCS19E250586,AR.PCT-SE011,20ARSE0670,M,1,211250,325000,2,0,65000,1,0,65000,260000,195000
01SCS19E250587,ESH.AR-RK0017,00ARRK0193,NON,1,43000,150000,2,0,45000,1,0,21000,105000,84000
01SCS19E250588,ESH.AR-SB0022,00ARSB0124,M,1,44000,135000,2,0,40500,1,0,18900,94500,75600
01SCS19E250589,ESH.AR-SC0021,00ARSC0159,L,1,44000,135000,2,0,40500,1,0,18900,94500,75600
01SCS19E250590,AR.MKV-RC024,20ARRC0596,ALL,1,78000,120000,0,0,0,0,0,42000,120000,78000
01SCS19E250590,ESH.AR-SB0026,00ARSB0158,NON,1,35300,120000,2,0,36000,1,0,16800,84000,67200
01SCS19E250591,BSC.AR-SD0042,00ARSD0227,S,1,44500,159000,2,0,47700,1,0,22260,111300,89040
01SCS19E250592,AR.PCT-SE010,20ARSE0668,M,1,211250,325000,2,0,65000,1,0,65000,260000,195000
01SCS19E250593,AR.TUC-SE024,20ARSE0657,32,1,204750,315000,2,0,63000,1,0,63000,252000,189000
01SCS19E250594,ESH.AR-SC0015,00ARSC0121,M,1,44000,135000,2,0,40500,1,0,18900,94500,75600
01SCS19E250594,ESH.AR-SE0001,00ARSE0002,M,1,44000,135000,2,0,40500,1,0,18900,94500,75600
01SCS19E250595,BSC.AR-SD0041,00ARSD0225,L,1,44500,159000,2,0,47700,1,0,22260,111300,89040
01SCS19E250596,ESH.AR-SC0026,00ARSC0236,S,1,44500,135000,2,0,40500,1,0,18900,94500,75600
01SCS19E250597,AR.STY-SE002,20ARSE0120,ALL,1,55250,85000,2,0,17000,1,0,17000,68000,51000
01SCS19E250598,AR.MKV-RE003,20ARRE0083,30,1,117000,180000,2,0,90000,1,0,22500,90000,67500
01SCS19E250599,BSC.AR-SD0046,00ARSD0243,S,1,44500,159000,2,0,47700,1,0,22260,111300,89040
01SCS19E250600,AR.GTW-SC003,20ARSC0031,L,1,204750,315000,2,0,94500,1,0,55125,220500,165375
01SCS19E250601,AR.MPR-SE033,20ARSE0304,M,1,230750,355000,2,0,71000,1,0,71000,284000,213000
01SCS19E250602,AR.MPR-SE032,20ARSE0300,M,1,230750,355000,2,0,71000,1,0,71000,284000,213000
01SCS19E250603,AR.PUB-SE029,20ARSE0113,L,1,224250,345000,2,0,69000,1,0,69000,276000,207000
01SCS19E250604,AR.HMR-SB024,20ARSB0410,30,1,211250,325000,2,0,65000,1,0,65000,260000,195000
01SCS19E250605,BSC.AR-SC0007,00ARSC0043,M,1,44000,135000,2,0,40500,1,0,18900,94500,75600
01SCS19E250606,AR.CPT-RH009,20ARRH0875,XL,1,204750,315000,2,0,63000,1,0,63000,252000,189000
01SCS19E250607,BSC.AR-SC0034,00ARSC0228,S,1,125000,315000,2,0,94500,1,0,44100,220500,176400
01SCS19E250608,AR.KNR-RK007,20ARRK0274,M,1,152750,235000,2,0,70500,1,0,41125,164500,123375
01SCS19E250608,AR.MKV-SE003,20ARSE0479,28,1,224250,345000,0,0,0,0,0,120750,345000,224250
01SCS19E250609,AR.MKV-RJ005,20ARRJ0160,S,1,91000,140000,0,0,0,0,0,49000,140000,91000
01SCS19E250609,AR.PUB-SB037,20ARSB0468,ALL,1,81250,125000,2,0,25000,1,0,25000,100000,75000
01SCS19E250610,ESH.AR-SE0028,00ARSE0260,M,1,44000,135000,2,0,40500,1,0,18900,94500,75600
01SCS19E250611,AR.SMD-RI006,20ARRI0328,L,1,87750,135000,2,0,40500,1,0,23625,94500,70875
01SCS19E250612,BE.RAK-SC017,00BESC0060,L,1,201500,310000,2,0,62000,1,0,62000,248000,186000
01SCS19E250613,THR.AR-QG0008,00ARQG0036,L,1,332000,415000,2,0,41500,1,0,56025,373500,317475
01SCS19E250614,ESH.AR-SD0018,00ARSD0137,M,1,125000,315000,2,0,94500,1,0,44100,220500,176400
01SCS19E250615,AR.MKV-SE014,20ARSE0587,S,1,22750,350000,0,0,0,0,0,122500,350000,227500
01SCS19E250616,BSC.AR-RK0021,00ARRK0204,M,1,145000,395000,2,0,118500,1,0,55300,276500,221200
01SCS19E250617,BSC.AR-SA0007,00ARSA0033,XL,1,94500,135000,2,0,40500,1,0,18900,94500,75600
01SCS19E250617,BSC.AR-SD0028,00ARSD0163,XL,1,125000,315000,2,0,94500,1,0,44100,220500,176400
01SCS19E250618,ESH.AR-SC0009,00ARSC0077,M,1,44500,135000,2,0,40500,1,0,18900,94500,75600
01SCS19E250618,ESH.AR-SE0001,00ARSE0002,M,1,44000,135000,2,0,40500,1,0,18900,94500,75600
01SCS19E250619,ARN.AR-SB0002,00ARSB0087,NON,1,149400,249000,0,0,0,0,0,74700,249000,174300
01SCS19E250620,AR.ESB-SE008,20ARSE0268,L,1,100750,155000,2,0,31000,1,0,31000,124000,93000
01SCS19E250621,BSC.AR-SD0049,00ARSD0249,NON,1,45000,135000,2,0,40500,1,0,18900,94500,75600
01SCS19E250622,AR.CLB-SB004,20ARSB0175,ALL,1,185250,285000,2,0,57000,1,0,57000,228000,171000
01SCS19E250623,AR.MPR-SE007,20ARSE0161,S,1,97500,150000,2,0,45000,1,0,26250,105000,78750
01SCS19E250623,AR.MPR-SE010,20ARSE0173,S,1,97500,150000,2,0,45000,1,0,26250,105000,78750
01SCS19E250624,ESH.AR-SE0004,00ARSE0013,S,1,44500,135000,2,0,40500,1,0,18900,94500,75600
01SCS19E250625,AR.TUC-SE019,20ARSE0635,S,1,204750,315000,2,0,63000,1,0,63000,252000,189000
01SCS19E250626,BSC.AR-SC0043,00ARSC0290,L,1,44000,135000,2,0,40500,1,0,18900,94500,75600
01SCS19E250627,ESH.AR-SC0032,00ARSC0281,M,1,44500,135000,2,0,40500,1,0,18900,94500,75600
01SCS19E250628,AR.MPR-SE004,20ARSE0150,M,1,97500,150000,2,0,45000,1,0,26250,105000,78750
01SCS19E250628,ESH.AR-SB0026,00ARSB0158,NON,1,35300,120000,2,0,36000,1,0,16800,84000,67200
01SCS19E250629,AR.PUB-SE010,20ARSE0040,XL,1,97500,150000,2,0,30000,1,0,30000,120000,90000
01SCS19E250629,ESH.AR-RJ0006,00ARRJ0033,L,1,44500,135000,2,0,40500,1,0,18900,94500,75600
01SCS19E250630,AR.HLW-SE013,20ARSE0559,M,1,100750,155000,2,0,31000,1,0,31000,124000,93000
01SCS19E250630,AR.PCT-SE020,20ARSE0688,M,1,87750,135000,2,0,27000,1,0,27000,108000,81000
01SCS19E250630,ESH.AR-RH0020,00ARRH0108,M,1,94500,135000,2,0,40500,1,0,18900,94500,75600
01SCS19E250630,ESH.AR-SE0036,00ARSE0326,L,1,44500,135000,2,0,40500,1,0,18900,94500,75600
01SCS19E250631,AR.CPT-QL011,20ARQL0166,S,1,204750,315000,2,0,63000,1,0,63000,252000,189000
01SCS19E250632,BSC.AR-SD0054,00ARSD0287,NON,1,50000,150000,2,0,45000,1,0,21000,105000,84000
01SCS19E250633,AR.MPR-SE006,20ARSE0159,L,1,97500,150000,2,0,45000,1,0,26250,105000,78750
01SCS19E250634,BSC.AR-SD0022,00ARSD0128,S,1,44000,159000,2,0,47700,1,0,22260,111300,89040
01SCS19E250635,AR.TUC-SB001,20ARSB0026,XL,1,204750,315000,2,0,63000,1,0,63000,252000,189000
01SCS19E250636,AR.SMD-RH002,20ARRH0071,M,1,211250,325000,2,0,97500,1,0,56875,227500,170625
01SCS19E250637,AR.CPT-RH012,20ARRH0887,XL,1,94250,145000,2,0,29000,1,0,29000,116000,87000
01SCS19E250637,BSC.AR-RK0002,00ARRK0056,XL,1,94500,135000,2,0,40500,1,0,18900,94500,75600
01SCS19E250637,BSC.AR-SA0015,00ARSA0046,XL,1,44500,135000,2,0,40500,1,0,18900,94500,75600
01SCS19E250637,ESH.AR-SD0009,00ARSD0068,XL,1,44500,135000,2,0,40500,1,0,18900,94500,75600
01SCS19E250637,ESH.AR-SD0018,00ARSD0139,XL,1,125000,315000,2,0,94500,1,0,44100,220500,176400
01SCS19E250638,BSC.AR-RJ0014,00ARRJ0092,M,1,43000,135000,2,0,40500,1,0,18900,94500,75600
01SCS19E250638,ESH.AR-SE0011,00ARSE0042,M,1,44500,135000,2,0,40500,1,0,18900,94500,75600
01SCS19E250639,AR.MDS-RL004,20ARRL0366,S,1,117000,180000,2,0,36000,1,0,36000,144000,108000
01SCS19E250639,BSC.AR-SA0002,00ARSA0005,S,1,120000,315000,2,0,94500,1,0,44100,220500,176400
01SCS19E250639,ESH.AR-SA0012,00ARSA0093,S,1,44000,135000,2,0,40500,1,0,18900,94500,75600
01SCS19E250640,AR.PCT-SE014,20ARSE0676,M,1,87750,135000,2,0,27000,1,0,27000,108000,81000
01SCS19E250641,ESH.AR-RJ0002,00ARRJ0016,M,1,94500,135000,2,0,40500,1,0,18900,94500,75600
01SCS19E250642,AR.MPR-SE004,20ARSE0150,M,1,97500,150000,2,0,45000,1,0,26250,105000,78750
01SCS19E250643,ESH.AR-SC0012,00ARSC0091,XL,1,44000,135000,2,0,40500,1,0,18900,94500,75600
01SCS19E250644,ESH.AR-SD0032,00ARSD0306,XL,1,44500,135000,2,0,40500,1,0,18900,94500,75600
01SCS19E250645,BSC.AR-SD0004,00ARSD0014,M,1,44000,159000,2,0,47700,1,0,22260,111300,89040
01SCS19E250645,BSC.AR-SE0001,00ARSE0058,M,1,44500,159000,2,0,47700,1,0,22260,111300,89040
01SCS19E250646,ESH.AR-SE0003,00ARSE0009,S,1,44500,135000,2,0,40500,1,0,18900,94500,75600
01SCS19E250647,AR.STY-SE004,20ARSE0122,ALL,1,55250,85000,2,0,17000,1,0,17000,68000,51000
01SCS19E250647,AR.STY-SE007,20ARSE0125,ALL,1,55250,85000,2,0,17000,1,0,17000,68000,51000
01SCS19E250647,AR.STY-SE008,20ARSE0126,ALL,1,55250,85000,2,0,17000,1,0,17000,68000,51000
01SCS19E250648,AR.CPT-RK007,20ARRK0024,M,1,204750,315000,2,0,63000,1,0,63000,252000,189000
01SCS19E250649,ESH.AR-SB0032,00ARSB0208,S,1,125000,315000,2,0,94500,1,0,44100,220500,176400
01SCS19E250650,AR.STY-SE007,20ARSE0125,ALL,1,55250,85000,2,0,17000,1,0,17000,68000,51000
01SCS19E250651,AR.MKV-QA005,20ARQA0027,30,1,214500,330000,2,0,165000,1,0,41250,165000,123750
01SCS19E250652,BSC.AR-SD0049,00ARSD0249,NON,1,45000,135000,2,0,40500,1,0,18900,94500,75600
01SCS19E250652,ESH.AR-RJ0001,00ARRJ0012,M,1,44500,135000,2,0,40500,1,0,18900,94500,75600
01SCS19E250652,ESH.AR-SE0029,00ARSE0264,M,1,44500,135000,2,0,40500,1,0,18900,94500,75600
01SCS19E250653,ESH.AR-SD0003,00ARSD0044,XL,1,44000,135000,2,0,40500,1,0,18900,94500,75600
01SCS19E250654,AR.REC-SD020,20ARSD0060,34,1,208000,320000,2,0,96000,1,0,56000,224000,168000
01SCS19E250655,BSC.AR-RH0025,00ARRH0161,L,1,115000,350000,2,0,105000,1,0,49000,245000,196000
01SCS19E250656,AR.ESB-RE008,20ARRE0359,L,1,94250,145000,2,0,72500,1,0,18125,72500,54375
01SCS19E250657,AR.TUC-SE005,20ARSE0380,M,1,204750,315000,2,0,63000,1,0,63000,252000,189000
01SCS19E250658,AR.BPH-SD001,20ARSD0359,L,1,103350,159000,2,0,47700,1,0,27825,111300,83475
01SCS19E250658,AR.MKV-RJ006,20ARRJ0166,M,1,91000,140000,0,0,0,0,0,49000,140000,91000
01SCS19E250658,AR.SMD-SD002,20ARSD0283,M,1,97500,150000,2,0,45000,1,0,26250,105000,78750
01SCS19E250659,ESH.AR-SE0037,00ARSE0329,M,1,44000,135000,2,0,40500,1,0,18900,94500,75600
01SCS19E250660,AR.TUC-RL022,20ARRL0346,ALL,1,87750,135000,2,0,27000,1,0,27000,108000,81000
01SCS19E250661,ESH.AR-SB0010,00ARSB0039,S,1,44500,135000,2,0,40500,1,0,18900,94500,75600
01SCS19E250661,ESH.AR-SD0028,00ARSD0274,S,1,44500,135000,2,0,40500,1,0,18900,94500,75600
01SCS19E250662,BSC.AR-SA0022,00ARSA0113,NON,1,47500,140000,2,0,42000,1,0,19600,98000,78400
01SCS19E250663,ESH.AR-SC0038,00ARSC0303,NON,1,45000,140000,2,0,42000,1,0,19600,98000,78400
01SCS19E250664,BSC.AR-SC0029,00ARSC0199,S,1,125000,315000,2,0,94500,1,0,44100,220500,176400
01SCS19E250665,BSC.AR-RL0020,00ARRL0117,S,1,125000,315000,2,0,94500,1,0,44100,220500,176400
01SCS19E250666,BSC.AR-SD0058,00ARSD0294,NON,1,50000,150000,2,0,45000,1,0,21000,105000,84000
01SCS19E250667,AR.TUC-SE020,20ARSE0641,L,1,204750,315000,2,0,63000,1,0,63000,252000,189000
01SCS19E250668,AR.MPR-SE022,20ARSE0206,S,1,243750,375000,2,0,75000,1,0,75000,300000,225000
01SCS19E250669,BSC.AR-SC0028,00ARSC0195,S,1,125000,315000,2,0,94500,1,0,44100,220500,176400
01SCS19E250670,AR.STY-SE012,20ARSE0578,ALL,1,55250,85000,2,0,17000,1,0,17000,68000,51000
01SCS19E250671,ESH.AR-SE0001,00ARSE0003,L,1,44000,135000,2,0,40500,1,0,18900,94500,75600
01SCS19E250671,ESH.AR-SE0003,00ARSE0011,L,1,44500,135000,2,0,40500,1,0,18900,94500,75600
01SCS19E250672,AR.HLW-SE017,20ARSE0564,ALL,1,87750,135000,2,0,27000,1,0,27000,108000,81000
01SCS19E250673,AR.TUC-RI012,20ARRI0371,M,1,87750,135000,2,0,27000,1,0,27000,108000,81000
01SCS19E250674,BSC.AR-SA0008,00ARSA0034,NON,1,47500,140000,2,0,42000,1,0,19600,98000,78400
01SCS19E250675,ESH.AR-SB0032,00ARSB0208,S,1,125000,315000,2,0,94500,1,0,44100,220500,176400
01SCS19E250676,ESH.AR-SD0032,00ARSD0305,L,1,44500,135000,2,0,40500,1,0,18900,94500,75600
01SCS19E250677,AR.CPT-SC002,20ARSC0244,28,1,227500,350000,2,0,70000,1,0,70000,280000,210000
01SCS19E250678,ESH.AR-RJ0001,00ARRJ0012,M,1,44500,135000,2,0,40500,1,0,18900,94500,75600
01SCS19E250679,AR.BPH-RH002,20ARRH0336,L,1,195000,300000,2,0,150000,1,0,37500,150000,112500
01SCS19E250680,ESH.AR-SD0018,00ARSD0137,M,1,125000,315000,2,0,94500,1,0,44100,220500,176400
01SCS19E250681,AR.TUC-SB014,20ARSB0205,L,1,94250,145000,2,0,29000,1,0,29000,116000,87000
01SCS19E250681,DKS.AR-SE0011,00ARSE0172,32,1,417272,696000,2,0,69600,1,0,93960,626400,532440
01SCS19E250682,AR.MKV-SE017,20ARSE0599,S,1,97500,150000,0,0,0,0,0,52500,150000,97500
01SCS19E250683,AR.TUC-SE017,20ARSE0428,L,1,146250,225000,2,0,45000,1,0,45000,180000,135000
01SCS19E250684,ESH.AR-SB0031,00ARSB0204,S,1,44500,135000,2,0,40500,1,0,18900,94500,75600
01SCS19E250685,AR.PCT-SE007,20ARSE0348,M,1,87750,135000,2,0,27000,1,0,27000,108000,81000
01SCS19E250686,AR.MPR-SE032,20ARSE0300,M,1,230750,355000,2,0,71000,1,0,71000,284000,213000
01SCS19E250687,AR.SLT-RB030,20ARRB0687,ALL,1,332000,415000,2,0,41500,1,0,74700,373500,298800
01SCS19E250688,AR.HLW-SA013,20ARSA0105,M,1,120250,185000,2,0,55500,1,0,32375,129500,97125
01SCS19E250688,AR.PUB-SE005,20ARSE0018,M,1,97500,150000,2,0,30000,1,0,30000,120000,90000
01SCS19E250688,AR.TUC-SD015,20ARSD0478,M,1,145000,145000,2,0,29000,1,0,29000,116000,87000
01SCS19E250689,AR.ESB-SE003,20ARSE0246,S,1,204750,315000,2,0,63000,1,0,63000,252000,189000
01SCS19E250690,AR.ESB-RL004,20ARRL0014,M,1,100750,155000,2,0,31000,1,0,31000,124000,93000
01SCS19E250691,AR.CPT-SD008,20ARSD0443,L,1,204750,315000,2,0,63000,1,0,63000,252000,189000
01SCS19E250691,BSC.AR-SA0005,00ARSA0022,S,1,44000,135000,2,0,40500,1,0,18900,94500,75600
01SCS19E250692,BSC.AR-SD0002,00ARSD0005,S,1,44000,159000,2,0,47700,1,0,22260,111300,89040
01SCS19E250693,BSC.AR-SD0040,00ARSD0215,S,1,44500,159000,2,0,47700,1,0,22260,111300,89040
01SCS19E250694,BSC.AR-SD0028,00ARSD0161,M,1,125000,315000,2,0,94500,1,0,44100,220500,176400
01SCS19E250695,AR.TUC-SE010,20ARSE0399,S,1,94250,145000,2,0,29000,1,0,29000,116000,87000
01SCS19E250696,ESH.AR-SB0015,00ARSB0064,L,1,125000,315000,2,0,94500,1,0,44100,220500,176400
01SCS19E250697,ESH.AR-SE0031,00ARSE0271,S,1,125000,315000,2,0,94500,1,0,44100,220500,176400
01SCS19E250698,ESH.AR-SC0001,00ARSC0001,S,1,125000,315000,2,0,94500,1,0,44100,220500,176400
01SCS19E250699,AR.REC-SD028,20ARSD0075,ALL,1,32500,50000,2,0,15000,1,0,8750,35000,26250
01SCS19E250699,BE.RAK-SC006,00BESC0015,ALL,1,42250,65000,2,0,13000,1,0,13000,52000,39000
01SCS19E250700,AR.ESB-SC001,20ARSC0305,M,1,204750,315000,2,0,63000,1,0,63000,252000,189000
01SCS19E250701,BSC.AR-SD0063,00ARSD0338,NON,1,60000,180000,2,0,54000,1,0,25200,126000,100800
01SCS19E250702,BSC.AR-SA0008,00ARSA0034,NON,1,47500,140000,2,0,42000,1,0,19600,98000,78400
01SCS19E250703,AR.CPT-SB002,20ARSB0501,M,1,94250,145000,2,0,29000,1,0,29000,116000,87000
01SCS19E250704,BSC.AR-SE0001,00ARSE0057,S,1,44500,159000,2,0,47700,1,0,22260,111300,89040
01SCS19E250705,ESH.AR-SC0003,00ARSC0009,S,1,125000,350000,2,0,105000,1,0,49000,245000,196000
01SCS19E250705,ESH.AR-SE0025,00ARSE0247,S,1,44500,135000,2,0,40500,1,0,18900,94500,75600
01SCS19E250706,AR.CPT-SE001,20ARSE0352,S,1,94250,145000,2,0,29000,1,0,29000,116000,87000
01SCS19E250707,ESH.AR-SB0007,00ARSB0028,M,1,44000,135000,2,0,40500,1,0,18900,94500,75600
01SCS19E250707,ESH.AR-SC0034,00ARSC0292,S,1,125000,315000,2,0,94500,1,0,44100,220500,176400
01SCS19E250708,AR.CPT-SE002,20ARSE0356,S,1,94250,145000,2,0,29000,1,0,29000,116000,87000
01SCS19E250708,AR.MPR-SE006,20ARSE0157,S,1,97500,150000,2,0,45000,1,0,26250,105000,78750
01SCS19E250709,ESH.AR-SD0019,00ARSD0141,M,1,125000,315000,2,0,94500,1,0,44100,220500,176400
01SCS19E250710,BSC.AR-SC0048,00ARSC0305,M,1,44500,159000,2,0,47700,1,0,22260,111300,89040
01SCS19E250711,AR.MPR-SE030,20ARSE0292,M,1,230750,355000,2,0,71000,1,0,71000,284000,213000
01SCS19E250712,AR.CPT-QL011,20ARQL0169,XL,1,204750,315000,2,0,63000,1,0,63000,252000,189000
01SCS19E250713,BSC.AR-SD0052,00ARSD0280,M,1,44500,159000,2,0,47700,1,0,22260,111300,89040
01SCS19E250714,BSC.AR-SB0018,00ARSB0141,M,1,44500,135000,2,0,40500,1,0,18900,94500,75600
01SCS19E250714,BSC.AR-SC0022,00ARSC0170,M,1,44500,135000,2,0,40500,1,0,18900,94500,75600
01SCS19E250715,BSC.AR-RL0028,00ARRL0179,M,1,44500,135000,2,0,40500,1,0,18900,94500,75600
01SCS19E250715,ESH.AR-SD0028,00ARSD0275,M,1,44500,135000,2,0,40500,1,0,18900,94500,75600
01SCS19E250716,ESH.AR-SA0001,00ARSA0014,30,1,122500,175000,2,0,52500,1,0,24500,122500,98000
01SCS19E250717,ESH.AR-SD0010,00ARSD0071,L,1,44500,135000,2,0,40500,1,0,18900,94500,75600
01SCS19E250718,AR.PUB-SD025,20ARSD0198,M,1,97500,150000,2,0,30000,1,0,30000,120000,90000
01SCS19E250719,ESH.AR-SD0001,00ARSD0030,M,1,44500,135000,2,0,40500,1,0,18900,94500,75600
01SCS19E250719,ESH.AR-SE0038,00ARSE0333,M,1,44500,135000,2,0,40500,1,0,18900,94500,75600
01SCS19E250720,BSC.AR-SD0028,00ARSD0161,M,1,125000,315000,2,0,94500,1,0,44100,220500,176400
01SCS19E250721,AR.TUC-SB019,20ARSB0481,M,1,87750,135000,2,0,27000,1,0,27000,108000,81000
01SCS19E250722,AR.TUC-SB017,20ARSB0474,M,1,87750,135000,2,0,27000,1,0,27000,108000,81000
01SCS19E250723,AR.MKV-RL005,20ARRL0251,30,1,227500,350000,0,0,0,0,0,122500,350000,227500
01SCS19E250724,BSC.AR-RL0019,00ARRL0115,L,1,125000,315000,2,0,94500,1,0,44100,220500,176400
01SCS19E250725,ESH.AR-SD0039,00ARSD0347,S,1,122500,350000,2,0,105000,1,0,49000,245000,196000
01SCS19E250726,BSC.AR-SE0007,00ARSE0082,M,1,44500,159000,2,0,47700,1,0,22260,111300,89040
01SCS19E250727,ESH.AR-SD0011,00ARSD0074,M,1,125000,315000,2,0,94500,1,0,44100,220500,176400
01SCS19E250728,BSC.AR-RL0028,00ARRL0178,S,1,44500,135000,2,0,40500,1,0,18900,94500,75600
01SCS19E250728,BSC.AR-SD0046,00ARSD0244,M,1,44500,159000,2,0,47700,1,0,22260,111300,89040
01SCS19E250729,BSC.AR-SD0060,00ARSD0332,NON,1,45000,140000,2,0,42000,1,0,19600,98000,78400
01SCS19E250729,BSC.AR-SE0005,00ARSE0074,M,1,44000,159000,2,0,47700,1,0,22260,111300,89040
01SCS19E250730,ESH.AR-SE0017,00ARSE0114,M,1,44000,135000,2,0,40500,1,0,18900,94500,75600
01SCS19E250731,ESH.AR-RI0009,00ARRI0102,S,1,94500,135000,2,0,40500,1,0,18900,94500,75600
01SCS19E250732,BSC.AR-RI0015,00ARRI0056,L,1,43000,135000,2,0,40500,1,0,18900,94500,75600
01SCS19E250733,AR.MPR-SE037,20ARSE0313,ALL,1,130000,200000,2,0,40000,1,0,40000,160000,120000
01SCS19E250734,BSC.AR-SC0029,00ARSC0199,S,1,125000,315000,2,0,94500,1,0,44100,220500,176400
01SCS19E250735,AR.CPT-SD005,20ARSD0432,ALL,1,94250,145000,2,0,29000,1,0,29000,116000,87000
01SCS19E250736,BSC.AR-SD0004,00ARSD0014,M,1,44000,159000,2,0,47700,1,0,22260,111300,89040
01SCS19E250737,ESH.AR-SE0004,00ARSE0013,S,1,44500,135000,2,0,40500,1,0,18900,94500,75600
01SCS19E250738,ESH.AR-SE0013,00ARSE0049,S,1,44500,135000,2,0,40500,1,0,18900,94500,75600
01SCS19E250739,THR.AR-RK0006,00ARRK0178,XL,1,824000,1030000,2,0,103000,1,0,139050,927000,787950
01SCS19E250740,AR.VCS-RI005,20ARRI0289,XL,1,243750,375000,2,0,112500,1,0,65625,262500,196875
01SCS19E250741,AR.PCT-SE013,20ARSE0674,M,1,87750,135000,2,0,27000,1,0,27000,108000,81000
01SCS19E250742,AR.MKV-SE017,20ARSE0600,M,1,97500,150000,0,0,0,0,0,52500,150000,97500
01SCS19E250742,AR.MKV-SE019,20ARSE0605,S,1,97500,150000,0,0,0,0,0,52500,150000,97500
01SCS19E250742,BSC.AR-SD0055,00ARSD0288,NON,1,50000,150000,2,0,45000,1,0,21000,105000,84000
01SCS19E250743,AR.CPT-RE009,20ARRE0704,XL,1,204750,315000,2,0,63000,1,0,63000,252000,189000
01SCS19E250744,AR.TUC-SD002,20ARSD0145,M,1,204750,315000,2,0,63000,1,0,63000,252000,189000
01SCS19E250745,ESH.AR-SD0003,00ARSD0042,M,1,44000,135000,2,0,40500,1,0,18900,94500,75600
01SCS19E250746,AR.TUC-SE022,20ARSE0650,XL,1,152750,235000,2,0,47000,1,0,47000,188000,141000
01SCS19E250747,BSC.AR-SD0051,00ARSD0255,M,1,44000,159000,2,0,47700,1,0,22260,111300,89040
01SCS19E250748,AR.MPR-SE022,20ARSE0207,M,1,243750,375000,2,0,75000,1,0,75000,300000,225000
01SCS19E250749,AR.REC-SD004,20ARSD0013,S,1,107250,165000,2,0,49500,1,0,28875,115500,86625
01SCS19E250750,AR.MPR-SE006,20ARSE0157,S,1,97500,150000,2,0,45000,1,0,26250,105000,78750
01SCS19E250751,BE.RAK-SC030,00BESC0122,M,1,211250,325000,2,0,65000,1,0,65000,260000,195000
01SCS19E250752,AR.TUC-SE024,20ARSE0658,34,1,204750,315000,2,0,63000,1,0,63000,252000,189000
01SCS19E250753,ESH.AR-SC0010,00ARSC0082,L,1,44500,135000,2,0,40500,1,0,18900,94500,75600
01SCS19E250753,ESH.AR-SE0005,00ARSE0019,L,1,44500,135000,2,0,40500,1,0,18900,94500,75600
01SCS19E250754,BSC.AR-SB0015,00ARSB0127,S,1,125000,315000,2,0,94500,1,0,44100,220500,176400
01SCS19E250755,AR.MPR-SE033,20ARSE0304,M,1,230750,355000,2,0,71000,1,0,71000,284000,213000
01SCS19E250756,ESH.AR-SC0022,00ARSC0162,M,1,125000,315000,2,0,94500,1,0,44100,220500,176400
01SCS19E250757,ESH.AR-SC0032,00ARSC0280,S,1,44500,135000,2,0,40500,1,0,18900,94500,75600
01SCS19E250757,ESH.AR-SE0029,00ARSE0264,M,1,44500,135000,2,0,40500,1,0,18900,94500,75600
01SCS19E250758,AR.MKV-SE014,20ARSE0588,M,1,22750,350000,0,0,0,0,0,122500,350000,227500
01SCS19E250759,BSC.AR-RJ0014,00ARRJ0093,L,1,94500,135000,2,0,40500,1,0,18900,94500,75600
01SCS19E250760,ESH.AR-SB0015,00ARSB0062,S,1,125000,315000,2,0,94500,1,0,44100,220500,176400
01SCS19E250761,BSC.AR-RI0024,00ARRI0133,NON,1,43000,140000,2,0,42000,1,0,19600,98000,78400
01SCS19E250762,ESH.AR-RJ0003,00ARRJ0019,S,1,43000,135000,2,0,40500,1,0,18900,94500,75600
01SCS19E250763,BSC.AR-SD0041,00ARSD0223,S,1,44500,159000,2,0,47700,1,0,22260,111300,89040
01SCS19E250764,AR.ESB-RE024,20ARRE0404,ALL,1,94250,145000,2,0,43500,1,0,25375,101500,76125
01SCS19E250765,AR.MPR-SE007,20ARSE0161,S,1,97500,150000,2,0,45000,1,0,26250,105000,78750
01SCS19E250766,AR.PCT-SE010,20ARSE0668,M,1,211250,325000,2,0,65000,1,0,65000,260000,195000
01SCS19E250767,AR.MKV-SE017,20ARSE0599,S,1,97500,150000,0,0,0,0,0,52500,150000,97500
01SCS19E250768,ESH.AR-SA0004,00ARSA0057,L,1,44500,135000,2,0,40500,1,0,18900,94500,75600
01SCS19E250769,AR.MPR-SE035,20ARSE0311,ALL,1,136500,210000,2,0,42000,1,0,42000,168000,126000
01SCS19E250770,ESH.AR-SD0010,00ARSD0071,L,1,44500,135000,2,0,40500,1,0,18900,94500,75600
01SCS19E250770,ESH.AR-SE0028,00ARSE0261,L,1,44000,135000,2,0,40500,1,0,18900,94500,75600
01SCS19E250771,BSC.AR-SA0017,00ARSA0051,S,1,125000,315000,2,0,94500,1,0,44100,220500,176400
01SCS19E250772,ESH.AR-SA0012,00ARSA0093,S,1,44000,135000,2,0,40500,1,0,18900,94500,75600
01SCS19E250772,ESH.AR-SC0013,00ARSC0104,S,1,44500,135000,2,0,40500,1,0,18900,94500,75600
01SCS19E250773,AR.MKV-SE011,20ARSE0521,32,1,227500,350000,0,0,0,0,0,122500,350000,227500
01SCS19E250774,BSC.AR-SD0028,00ARSD0161,M,1,125000,315000,2,0,94500,1,0,44100,220500,176400
01SCS19E250775,AR.HLW-SE022,20ARSE0575,L,1,100750,155000,2,0,31000,1,0,31000,124000,93000
01SCS19E250775,BSC.AR-SD0004,00ARSD0014,M,1,44000,159000,2,0,47700,1,0,22260,111300,89040
01SCS19E250776,ESH.AR-SD0026,00ARSD0268,L,1,44500,135000,2,0,40500,1,0,18900,94500,75600
01SCS19E250777,BSC.AR-SC0001,00ARSC0015,L,1,125000,315000,2,0,94500,1,0,44100,220500,176400
01SCS19E250778,AR.MER-RA001,20ARRA0338,ALL,1,84500,130000,2,0,39000,1,0,22750,91000,68250
01SCS19E250779,AR.MPR-SE018,20ARSE0202,ALL,1,110500,170000,2,0,51000,1,0,29750,119000,89250
01SCS19E250780,AR.MPR-SE019,20ARSE0203,ALL,1,97500,150000,2,0,45000,1,0,26250,105000,78750
01SCS19E250781,AR.STY-RK003,20ARRK0525,ALL,1,61750,95000,2,0,19000,1,0,19000,76000,57000
01SCS19E250781,AR.YD-RL006,20ARRL0022,ALL,1,87750,135000,2,0,67500,1,0,16875,67500,50625
01SCS19E250782,AR.STY-RL001,20ARRL0392,ALL,1,61750,95000,2,0,19000,1,0,19000,76000,57000
01SCS19E250783,BSC.AR-SD0018,00ARSD0123,NON,1,45000,150000,2,0,45000,1,0,21000,105000,84000
01SCS19E250784,ESH.AR-SB0021,00ARSB0120,M,1,44500,135000,2,0,40500,1,0,18900,94500,75600
01SCS19E250785,AR.ESB-SC016,20ARSC0457,M,1,91000,140000,2,0,28000,1,0,28000,112000,84000
01SCS19E250785,AR.MDS-QL016,20ARQL0069,S,1,104000,160000,2,0,32000,1,0,32000,128000,96000
01SCS19E250786,AR.CPT-SD010,20ARSD0450,M,1,94250,145000,2,0,29000,1,0,29000,116000,87000
01SCS19E250786,ESH.AR-RH0015,00ARRH0088,M,1,43000,135000,2,0,40500,1,0,18900,94500,75600
01SCS19E250787,AR.SMD-SD011,20ARSD0316,32,1,211250,325000,2,0,65000,1,0,65000,260000,195000
01SCS19E250788,AR.MKV-SE008,20ARSE0504,28,1,227500,350000,0,0,0,0,0,122500,350000,227500
01SCS19E250789,BSC.AR-SD0030,00ARSD0174,S,1,44500,159000,2,0,47700,1,0,22260,111300,89040
01SCS19E250789,BSC.AR-SE0002,00ARSE0062,M,1,44000,159000,2,0,47700,1,0,22260,111300,89040
01SCS19E250790,AR.YRX-RH001,20ARRH0718,ALL,1,172250,265000,2,0,53000,1,0,53000,212000,159000
01SCS19E250791,AR.GTW-SC003,20ARSC0029,S,1,204750,315000,2,0,94500,1,0,55125,220500,165375
01SCS19E250792,AR.TUC-SD018,20ARSD0490,M,1,94250,145000,2,0,29000,1,0,29000,116000,87000
01SCS19E250793,AR.PUB-SD031,20ARSD0214,30,1,211250,325000,2,0,65000,1,0,65000,260000,195000
01SCS19E250794,BSC.AR-SA0023,00ARSA0114,NON,1,47500,140000,2,0,42000,1,0,19600,98000,78400
01SCS19E250795,BSC.AR-RE0027,00ARRE0302,NON,1,35000,120000,2,0,36000,1,0,16800,84000,67200
01SCS19E250795,ESH.AR-SD0004,00ARSD0047,L,1,44500,135000,2,0,40500,1,0,18900,94500,75600
01SCS19E250795,ESH.AR-SD0027,00ARSD0270,S,1,44000,135000,2,0,40500,1,0,18900,94500,75600
01SCS19E250796,BSC.AR-SD0027,00ARSD0157,M,1,125000,315000,2,0,94500,1,0,44100,220500,176400
01SCS19E250797,BSC.AR-SA0001,00ARSA0003,L,1,120000,315000,2,0,94500,1,0,44100,220500,176400
01SCS19E250798,ESH.AR-RJ0001,00ARRJ0013,L,1,44500,135000,2,0,40500,1,0,18900,94500,75600
01SCS19E250799,ESH.AR-SC0017,00ARSC0141,M,1,44000,135000,2,0,40500,1,0,18900,94500,75600
01SCS19E250799,ESH.AR-SE0011,00ARSE0042,M,1,44500,135000,2,0,40500,1,0,18900,94500,75600
01SCS19E250800,AR.HLW-SE006,20ARSE0537,S,1,100750,155000,2,0,31000,1,0,31000,124000,93000
01SCS19E250801,AR.PCT-SE018,20ARSE0684,M,1,87750,135000,2,0,27000,1,0,27000,108000,81000
01SCS19E250802,ESH.AR-SC0026,00ARSC0237,M,1,44500,135000,2,0,40500,1,0,18900,94500,75600
01SCS19E250803,AR.CPT-SC009,20ARSC0275,XL,1,94250,145000,2,0,29000,1,0,29000,116000,87000
01SCS19E250804,AR.PCT-SE011,20ARSE0671,L,1,211250,325000,2,0,65000,1,0,65000,260000,195000
01SCS19E250805,BSC.AR-SB0004,00ARSB0049,L,1,44000,135000,2,0,40500,1,0,18900,94500,75600
01SCS19E250806,ESH.AR-SE0004,00ARSE0014,M,1,44500,135000,2,0,40500,1,0,18900,94500,75600
01SCS19E250806,ESH.AR-SE0037,00ARSE0329,M,1,44000,135000,2,0,40500,1,0,18900,94500,75600
01SCS19E250807,AR.ESB-SD006,20ARSD0116,S,1,204750,315000,2,0,63000,1,0,63000,252000,189000
01SCS19E250807,BE.RAK-SC030,00BESC0124,XL,1,211250,325000,2,0,65000,1,0,65000,260000,195000
01SCS19E250808,AR.TUC-SC004,20ARSC0058,32,1,204750,315000,2,0,63000,1,0,63000,252000,189000
01SCS19E250809,ESH.AR-SC0023,00ARSC0167,L,1,125000,315000,2,0,94500,1,0,44100,220500,176400
01SCS19E250810,BE.RAK-SB002,00BESB0009,XL,1,217750,335000,2,0,67000,1,0,67000,268000,201000
01SCS19E250810,BSC.AR-SE0035,00ARSE0340,36,1,125000,365000,2,0,109500,1,0,51100,255500,204400
01SCS19E250811,ESH.AR-SC0032,00ARSC0280,S,1,44500,135000,2,0,40500,1,0,18900,94500,75600
01SCS19E250812,AR.VLD-RK008,20ARRK0327,ALL,1,91000,140000,2,0,42000,1,0,24500,98000,73500
01SCS19E250813,BSC.AR-SC0023,00ARSC0175,L,1,44500,135000,2,0,40500,1,0,18900,94500,75600
01SCS19E250814,ESH.AR-SD0011,00ARSD0073,S,1,125000,315000,2,0,94500,1,0,44100,220500,176400
01SCS19E250815,BSC.AR-SC0036,00ARSC0243,34,1,135000,375000,2,0,112500,1,0,52500,262500,210000
01SCS19E250816,AR.PUB-SD025,20ARSD0198,M,1,97500,150000,2,0,30000,1,0,30000,120000,90000
01SCS19E250817,ESH.AR-SD0026,00ARSD0269,XL,1,44500,135000,2,0,40500,1,0,18900,94500,75600
01SCS19E250818,AR.MPR-SE035,20ARSE0311,ALL,1,136500,210000,2,0,42000,1,0,42000,168000,126000
01SCS19E250819,AR.BPH-RB010,20ARRB0462,M,1,103350,159000,2,0,47700,1,0,27825,111300,83475
01SCS19E250820,ESH.AR-SD0011,00ARSD0073,S,1,125000,315000,2,0,94500,1,0,44100,220500,176400
01SCS19E250821,BSC.AR-SA0002,00ARSA0005,S,1,120000,315000,2,0,94500,1,0,44100,220500,176400
01SCS19E250822,AR.MKV-SA009,20ARSA0280,L,1,227500,350000,0,0,0,0,0,122500,350000,227500
01SCS19E250823,ESH.AR-RJ0023,00ARRJ0218,NON,1,18000,75000,2,0,22500,1,0,10500,52500,42000
01SCS19E250824,ESH.AR-SD0030,00ARSD0295,S,1,44500,135000,2,0,40500,1,0,18900,94500,75600
01SCS19E250825,ESH.AR-SE0011,00ARSE0042,M,1,44500,135000,2,0,40500,1,0,18900,94500,75600
01SCS19E250826,AR.SMD-QH002,20ARQH0428,XL,1,87750,135000,2,0,40500,1,0,23625,94500,70875
01SCS19E250827,AR.MPR-SE025,20ARSE0219,M,1,230750,355000,2,0,71000,1,0,71000,284000,213000
01SCS19E250828,AR.MKV-RJ017,20ARRJ0200,ALL,1,107250,165000,0,0,0,0,0,57750,165000,107250
01SCS19E250828,BE.RAK-RL039,00BERL0145,ALL,1,97500,150000,2,0,30000,1,0,30000,120000,90000
01SCS19E250829,ESH.AR-SD0040,00ARSD0366,S,1,122500,350000,2,0,105000,1,0,49000,245000,196000
01SCS19E250830,AR.REC-SD005,20ARSD0018,M,1,107250,165000,2,0,49500,1,0,28875,115500,86625
01SCS19E250831,AR.YD-RL015,20ARRL0039,M,1,91000,140000,2,0,70000,1,0,17500,70000,52500
01SCS19E250831,BE.RAK-SC041,00BESC0178,M,1,91000,140000,2,0,28000,1,0,28000,112000,84000
01SCS19E250831,BSC.AR-SE0002,00ARSE0062,M,1,44000,159000,2,0,47700,1,0,22260,111300,89040
01SCS19E250832,THR.AR-RB0008,00ARRB0204,L,1,415000,415000,2,0,41500,1,0,56025,373500,317475
01SCS19E250833,BE.RAK-SC026,00BESC0103,L,1,201500,310000,2,0,62000,1,0,62000,248000,186000
01SCS19E250834,BSC.AR-SD0047,00ARSD0247,NON,1,68000,220000,2,0,66000,1,0,30800,154000,123200
01SCS19E250835,ESH.AR-SE0029,00ARSE0264,M,1,44500,135000,2,0,40500,1,0,18900,94500,75600
01SCS19E250836,BE.RAK-RX370,00BERX1384,XL,1,91000,140000,2,0,28000,1,0,28000,112000,84000
01SCS19E250837,BSC.AR-SC0023,00ARSC0174,M,1,44500,135000,2,0,40500,1,0,18900,94500,75600
01SCS19E250837,BSC.AR-SD0030,00ARSD0174,S,1,44500,159000,2,0,47700,1,0,22260,111300,89040
01SCS19E250837,ESH.AR-SE0037,00ARSE0329,M,1,44000,135000,2,0,40500,1,0,18900,94500,75600
01SCS19E250838,AR.MPR-SE025,20ARSE0220,L,1,230750,355000,2,0,71000,1,0,71000,284000,213000
01SCS19E250839,ESH.AR-SD0026,00ARSD0267,M,1,44500,135000,2,0,40500,1,0,18900,94500,75600
01SCS19E250840,ESH.AR-SD0027,00ARSD0272,L,1,44000,135000,2,0,40500,1,0,18900,94500,75600
01SCS19E250841,AR.PCT-SE016,20ARSE0680,M,1,87750,135000,2,0,27000,1,0,27000,108000,81000
01SCS19E250841,ESH.AR-SC0036,00ARSC0301,NON,1,55000,140000,2,0,42000,1,0,19600,98000,78400
01SCS19E250842,ESH.AR-SE0027,00ARSE0257,L,1,44500,135000,2,0,40500,1,0,18900,94500,75600
01SCS19E250843,AR.MPR-SE007,20ARSE0161,S,1,97500,150000,2,0,45000,1,0,26250,105000,78750
01SCS19E250844,AR.SMD-SA001,20ARSA0220,M,1,87750,135000,2,0,27000,1,0,27000,108000,81000
01SCS19E250844,BE.RAK-SC040,00BESC0174,L,1,91000,140000,2,0,28000,1,0,28000,112000,84000
01SCS19E250845,ESH.AR-SD0026,00ARSD0266,S,1,44500,135000,2,0,40500,1,0,18900,94500,75600
01SCS19E250846,AR.MKV-RJ005,20ARRJ0160,S,1,91000,140000,0,0,0,0,0,49000,140000,91000
01SCS19E250847,BSC.AR-SE0033,00ARSE0315,28,1,125400,365000,2,0,109500,1,0,51100,255500,204400
01SCS19E250847,ESH.AR-SB0031,00ARSB0207,XL,1,44500,135000,2,0,40500,1,0,18900,94500,75600
01SCS19E250847,ESH.AR-SC0008,00ARSC0071,XL,1,44500,135000,2,0,40500,1,0,18900,94500,75600
01SCS19E250847,ESH.AR-SE0001,00ARSE0002,M,1,44000,135000,2,0,40500,1,0,18900,94500,75600
01SCS19E250848,BSC.AR-SA0007,00ARSA0032,L,1,94500,135000,2,0,40500,1,0,18900,94500,75600
01SCS19E250848,BSC.AR-SD0051,00ARSD0256,L,1,44000,159000,2,0,47700,1,0,22260,111300,89040
01SCS19E250848,BSC.AR-SE0005,00ARSE0074,M,1,44000,159000,2,0,47700,1,0,22260,111300,89040
01SCS19E250849,ARN.AR-SD0001,00ARSD0221,L,1,44500,150000,0,0,0,0,0,45000,150000,105000
01SCS19E250850,AR.MKV-RB013,20ARRB0071,32,1,117000,180000,2,0,90000,1,0,22500,90000,67500
01SCS19E250850,BSC.AR-SD0043,00ARSD0233,L,1,44500,159000,2,0,47700,1,0,22260,111300,89040
01SCS19E250851,ESH.AR-SC0017,00ARSC0141,M,1,44000,135000,2,0,40500,1,0,18900,94500,75600
01SCS19E250852,AR.MPR-SE013,20ARSE0187,L,1,110500,170000,2,0,51000,1,0,29750,119000,89250
01SCS19E250853,ESH.AR-SD0026,00ARSD0269,XL,1,44500,135000,2,0,40500,1,0,18900,94500,75600
01SCS19E250854,AR.PUB-RJ042,20ARRJ0517,S,1,97500,150000,2,0,30000,1,0,30000,120000,90000
01SCS19E250855,ESH.AR-SA0012,00ARSA0093,S,1,44000,135000,2,0,40500,1,0,18900,94500,75600
01SCS19E250856,DKS.AR-SE0005,00ARSE0145,36,1,417272,696000,2,0,69600,1,0,93960,626400,532440
01SCS19E250856,DKS.AR-SE0007,00ARSE0151,28,1,417272,696000,2,0,69600,1,0,93960,626400,532440
01SCS19E250857,AR.MPR-SE014,20ARSE0189,S,1,237250,365000,2,0,73000,1,0,73000,292000,219000
01SCS19E250858,BE.RAK-SA026,00BESA0108,L,1,91000,140000,2,0,28000,1,0,28000,112000,84000
01SCS19E250859,ESH.AR-SC0003,00ARSC0009,S,1,125000,350000,2,0,105000,1,0,49000,245000,196000
01SCS19E250860,ESH.AR-SC0013,00ARSC0104,S,1,44500,135000,2,0,40500,1,0,18900,94500,75600
01SCS19E250861,BSC.AR-SD0016,00ARSD0118,S,1,122000,375000,2,0,112500,1,0,52500,262500,210000
01SCS19E250862,AR.MKV-RE009,20ARRE0851,32,1,117000,180000,2,0,90000,1,0,22500,90000,67500
01SCS19E250863,AR.FHL-RJ003,20ARRJ0427,XL,1,91000,140000,2,0,28000,1,0,28000,112000,84000
01SCS19E250864,ESH.AR-SD0026,00ARSD0266,S,1,44500,135000,2,0,40500,1,0,18900,94500,75600
01SCS19E250865,DKS.AR-SE0001,00ARSE0129,28,1,417272,696000,2,0,69600,1,0,93960,626400,532440
01SCS19E250866,BSC.AR-SD0011,00ARSD0104,NON,1,18000,75000,2,0,22500,1,0,10500,52500,42000
01SCS19E250866,BSC.AR-SD0072,00ARSD0402,NON,1,12000,59000,2,0,17700,1,0,8260,41300,33040
01SCS19E260001,BSC.AR-SA0001,00ARSA0003,L,1,120000,315000,0,0,0,0,0,63000,315000,252000
01SCS19E260002,AR.TUC-RK028,20ARRK0134,L,1,94250,145000,2,0,29000,1,0,29000,116000,87000
01SCS19E260002,BSC.AR-SA0009,00ARSA0035,NON,1,47500,140000,0,0,0,0,0,28000,140000,112000
01SCS19E260002,BSC.AR-SD0002,00ARSD0005,S,1,44000,159000,0,0,0,0,0,31800,159000,127200
01SCS19E260003,AR.CPT-QI017,20ARQI0047,S,1,104000,160000,2,0,32000,1,0,32000,128000,96000
01SCS19E260003,AR.PUB-RG012,20ARRG0062,S,1,97500,150000,2,0,30000,1,0,30000,120000,90000
01SCS19E260004,ESH.AR-SB0032,00ARSB0209,M,1,125000,315000,0,0,0,0,0,63000,315000,252000
01SCS19E260005,ESH.AR-SB0026,00ARSB0158,NON,1,35300,120000,0,0,0,0,0,24000,120000,96000
01SCS19E260005,ESH.AR-SE0006,00ARSE0021,S,1,44000,135000,0,0,0,0,0,27000,135000,108000
01SCS19E260006,AR.PUB-SE033,20ARSE0630,M,1,97500,150000,2,0,30000,1,0,30000,120000,90000
01SCS19E260007,BSC.AR-SD0056,00ARSD0289,S,1,125000,315000,0,0,0,0,0,63000,315000,252000
01SCS19E260008,ESH.AR-RK0002,00ARRK0006,M,1,120000,315000,0,0,0,0,0,63000,315000,252000
01SCS19E260009,BSC.AR-SD0022,00ARSD0128,S,1,44000,159000,0,0,0,0,0,31800,159000,127200
01SCS19E260009,BSC.AR-SE0014,00ARSE0179,S,1,44000,159000,0,0,0,0,0,31800,159000,127200
01SCS19E260010,AR.MKV-SD002,20ARSD0223,M,1,97500,150000,0,0,0,0,0,52500,150000,97500
01SCS19E260011,AR.PUB-RK008,20ARRK0383,M,1,97500,150000,2,0,30000,1,0,30000,120000,90000
01SCS19E260012,AR.SMD-RG001,20ARRJ0459,ALL,1,208000,320000,2,0,96000,1,0,56000,224000,168000
01SCS19E260012,BE.RAK-RX215,00BERX0597,M,1,185250,285000,2,0,57000,1,0,57000,228000,171000
01SCS19E260013,AR.MKV-RJ003,20ARRJ0152,L,1,91000,140000,0,0,0,0,0,49000,140000,91000
01SCS19E260014,BSC.AR-SA0022,00ARSA0113,NON,1,47500,140000,0,0,0,0,0,28000,140000,112000
01SCS19E260014,BSC.AR-SD0049,00ARSD0249,NON,1,45000,135000,0,0,0,0,0,27000,135000,108000
01SCS19E260015,AR.CPT-SC007,20ARSC0266,L,1,94250,145000,2,0,29000,1,0,29000,116000,87000
01SCS19E260015,BSC.AR-SE0008,00ARSE0086,M,1,44000,159000,0,0,0,0,0,31800,159000,127200
01SCS19E260016,BSC.AR-SA0023,00ARSA0114,NON,1,47500,140000,0,0,0,0,0,28000,140000,112000
01SCS19E260017,BSC.AR-SA0017,00ARSA0053,L,1,125000,315000,0,0,0,0,0,63000,315000,252000
01SCS19E260017,THR.AR-RB0008,00ARRB0204,L,1,415000,415000,0,0,0,0,0,62250,415000,352750
01SCS19E260018,BSC.AR-SA0019,00ARSA0063,S,1,44000,135000,0,0,0,0,0,27000,135000,108000
01SCS19E260018,BSC.AR-SE0027,00ARSE0276,M,1,52000,155000,0,0,0,0,0,31000,155000,124000
01SCS19E260019,BSC.AR-SD0002,00ARSD0006,M,1,44000,159000,0,0,0,0,0,31800,159000,127200
01SCS19E260020,BSC.AR-RJ0008,00ARRJ0068,M,1,94500,135000,0,0,0,0,0,27000,135000,108000
01SCS19E260020,BSC.AR-SD0042,00ARSD0227,S,1,44500,159000,0,0,0,0,0,31800,159000,127200
01SCS19E260021,AR.TUC-SD002,20ARSD0145,M,1,204750,315000,2,0,63000,1,0,63000,252000,189000
01SCS19E260022,BSC.AR-SD0070,00ARSD0386,S,1,44000,159000,0,0,0,0,0,31800,159000,127200
01SCS19E260023,AR.ESB-SD010,20ARSD0184,M,1,91000,140000,2,0,28000,1,0,28000,112000,84000
01SCS19E260024,BSC.AR-SC0022,00ARSC0170,M,1,44500,135000,0,0,0,0,0,27000,135000,108000
01SCS19E260024,BSC.AR-SE0005,00ARSE0074,M,1,44000,159000,0,0,0,0,0,31800,159000,127200
01SCS19E260025,BSC.AR-SD0028,00ARSD0161,M,1,125000,315000,0,0,0,0,0,63000,315000,252000
01SCS19E260026,AR.PCT-SE020,20ARSE0688,M,1,87750,135000,2,0,27000,1,0,27000,108000,81000
01SCS19E260026,ESH.AR-SD0011,00ARSD0074,M,1,125000,315000,0,0,0,0,0,63000,315000,252000
01SCS19E260027,AR.ESB-SD013,20ARSD0325,S,1,91000,140000,2,0,28000,1,0,28000,112000,84000
01SCS19E260027,AR.MKV-SE025,20ARSE0624,28,1,214500,330000,0,0,0,0,0,115500,330000,214500
01SCS19E260027,ESH.AR-SC0018,00ARSC0144,S,1,44000,135000,0,0,0,0,0,27000,135000,108000
01SCS19E260028,AR.BPH-SD002,20ARSD0361,S,1,182000,280000,2,0,140000,1,0,35000,140000,105000
01SCS19E260029,BSC.AR-SC0024,00ARSC0179,L,1,125000,315000,0,0,0,0,0,63000,315000,252000
01SCS19E260029,ESH.AR-SE0037,00ARSE0329,M,1,44000,135000,0,0,0,0,0,27000,135000,108000
01SCS19E260030,AR.ESB-RG001,20ARRG0188,ALL,1,91000,140000,2,0,70000,1,0,17500,70000,52500
01SCS19E260031,AR.ESB-RK008,20ARRK0241,ALL,1,87750,135000,2,0,40500,1,0,23625,94500,70875
01SCS19E260031,AR.PUB-RL028,20ARRL0436,ALL,1,97500,150000,2,0,30000,1,0,30000,120000,90000
01SCS19E260031,AR.SMD-RI005,20ARRI0326,XL,1,87750,135000,2,0,40500,1,0,23625,94500,70875
01SCS19E260031,ESH.AR-SE0029,00ARSE0265,L,1,44500,135000,0,0,0,0,0,27000,135000,108000
01SCS19E260032,AR.TUC-SB017,20ARSB0474,M,1,87750,135000,2,0,27000,1,0,27000,108000,81000
01SCS19E260033,BSC.AR-RL0020,00ARRL0117,S,1,125000,315000,0,0,0,0,0,63000,315000,252000
01SCS19E260034,BSC.AR-SB0015,00ARSB0129,L,1,125000,315000,0,0,0,0,0,63000,315000,252000
01SCS19E260035,BSC.AR-SD0042,00ARSD0229,L,1,44500,159000,0,0,0,0,0,31800,159000,127200
01SCS19E260036,AR.CPT-QL011,20ARQL0168,L,1,204750,315000,2,0,63000,1,0,63000,252000,189000
01SCS19E260037,AR.TUC-SE018,20ARSE0430,ALL,1,87750,135000,2,0,27000,1,0,27000,108000,81000
01SCS19E260038,BSC.AR-SE0005,00ARSE0074,M,1,44000,159000,0,0,0,0,0,31800,159000,127200
01SCS19E260039,AR.PCT-SE010,20ARSE0668,M,1,211250,325000,2,0,65000,1,0,65000,260000,195000
01SCS19E260039,AR.PCT-SE018,20ARSE0684,M,1,87750,135000,2,0,27000,1,0,27000,108000,81000
01SCS19E260039,ESH.AR-SC0021,00ARSC0157,S,1,44000,135000,0,0,0,0,0,27000,135000,108000
01SCS19E260039,ESH.AR-SE0004,00ARSE0013,S,1,44500,135000,0,0,0,0,0,27000,135000,108000
01SCS19E260040,BSC.AR-SD0022,00ARSD0129,M,1,44000,159000,0,0,0,0,0,31800,159000,127200
01SCS19E260040,ESH.AR-RJ0003,00ARRJ0020,M,1,43000,135000,0,0,0,0,0,27000,135000,108000
01SCS19E260041,AR.TUC-SA002,20ARSA0007,L,1,204750,315000,2,0,63000,1,0,63000,252000,189000
01SCS19E260041,BSC.AR-SE0029,00ARSE0283,S,1,125000,315000,0,0,0,0,0,63000,315000,252000
01SCS19E260042,BSC.AR-RI0006,00ARRI0020,L,1,43000,135000,0,0,0,0,0,27000,135000,108000
01SCS19E260043,ESH.AR-SE0027,00ARSE0257,L,1,44500,135000,0,0,0,0,0,27000,135000,108000
01SCS19E260044,BSC.AR-SC0022,00ARSC0170,M,1,44500,135000,0,0,0,0,0,27000,135000,108000
01SCS19E260045,BSC.AR-RJ0009,00ARRJ0073,L,1,94500,135000,0,0,0,0,0,27000,135000,108000
01SCS19E260046,BSC.AR-SC0018,00ARSC0124,S,1,44500,159000,0,0,0,0,0,31800,159000,127200
01SCS19E260047,BSC.AR-SC0015,00ARSC0102,L,1,44000,159000,0,0,0,0,0,31800,159000,127200
01SCS19E260048,ESH.AR-SD0031,00ARSD0299,S,1,44000,135000,0,0,0,0,0,27000,135000,108000
01SCS19E260049,AR.PCT-SE007,20ARSE0348,M,1,87750,135000,2,0,27000,1,0,27000,108000,81000
01SCS19E260050,BSC.AR-RJ0007,00ARRJ0064,M,1,430000,135000,0,0,0,0,0,27000,135000,108000
01SCS19E260051,BSC.AR-SC0048,00ARSC0304,S,1,44500,159000,0,0,0,0,0,31800,159000,127200
01SCS19E260052,ESH.AR-SD0003,00ARSD0041,S,1,44000,135000,0,0,0,0,0,27000,135000,108000
01SCS19E260053,BSC.AR-SC0049,00ARSC0308,S,1,44500,159000,0,0,0,0,0,31800,159000,127200
01SCS19E260054,AR.MDS-RL003,20ARRL0363,M,1,117000,180000,2,0,36000,1,0,36000,144000,108000
01SCS19E260055,BSC.AR-SE0009,00ARSE0090,M,1,44500,159000,0,0,0,0,0,31800,159000,127200
01SCS19E260056,BSC.AR-SB0004,00ARSB0048,M,1,44000,135000,0,0,0,0,0,27000,135000,108000
01SCS19E260057,AR.YD-SC001,20ARSC0019,L,1,195000,300000,2,0,90000,1,0,52500,210000,157500
01SCS19E260058,AR.MPR-SE006,20ARSE0158,M,1,97500,150000,2,0,45000,1,0,26250,105000,78750
01SCS19E260058,BSC.AR-SE0005,00ARSE0075,L,1,44000,159000,0,0,0,0,0,31800,159000,127200
01SCS19E260059,AR.HLW-SC003,20ARSC0125,L,1,208000,320000,2,0,96000,1,0,56000,224000,168000
01SCS19E260060,ESH.AR-SC0026,00ARSC0236,S,1,44500,135000,0,0,0,0,0,27000,135000,108000
01SCS19E260060,ESH.AR-SD0045,00ARSD0404,S,1,125000,315000,0,0,0,0,0,63000,315000,252000
01SCS19E260061,ESH.AR-SD0011,00ARSD0074,M,1,125000,315000,0,0,0,0,0,63000,315000,252000
01SCS19E260061,ESH.AR-SE0017,00ARSE0115,L,1,44000,135000,0,0,0,0,0,27000,135000,108000
01SCS19E260062,BSC.AR-SB0001,00ARSB0003,S,1,44000,135000,0,0,0,0,0,27000,135000,108000
01SCS19E260062,BSC.AR-SC0006,00ARSC0038,S,1,44000,135000,0,0,0,0,0,27000,135000,108000
01SCS19E260062,ESH.AR-SD0028,00ARSD0274,S,1,44500,135000,0,0,0,0,0,27000,135000,108000
01SCS19E260063,BSC.AR-SD0042,00ARSD0227,S,1,44500,159000,0,0,0,0,0,31800,159000,127200
01SCS19E260064,BSC.AR-RJ0016,00ARRJ0101,L,1,43000,135000,0,0,0,0,0,27000,135000,108000
01SCS19E260065,ESH.AR-SA0013,00ARSA0099,L,1,44000,135000,0,0,0,0,0,27000,135000,108000
01SCS19E260066,BSC.AR-SB0004,00ARSB0049,L,1,44000,135000,0,0,0,0,0,27000,135000,108000
01SCS19E260067,BSC.AR-SD0040,00ARSD0215,S,1,44500,159000,0,0,0,0,0,31800,159000,127200
01SCS19E260068,BSC.AR-SE0007,00ARSE0083,L,1,44500,159000,0,0,0,0,0,31800,159000,127200
01SCS19E260069,AR.PUB-SC013,20ARSC0352,S,1,97500,150000,2,0,30000,1,0,30000,120000,90000
01SCS19E260070,BSC.AR-SE0033,00ARSE0315,28,1,125400,365000,0,0,0,0,0,73000,365000,292000
01SCS19E260070,ESH.AR-RK0020,00ARRK0200,M,1,192500,275000,0,0,0,0,0,55000,275000,220000
01SCS19E260071,AR.CPT-SE004,20ARSE0366,L,1,204750,315000,2,0,63000,1,0,63000,252000,189000
01SCS19E260072,BSC.AR-SD0018,00ARSD0123,NON,1,45000,150000,0,0,0,0,0,30000,150000,120000
01SCS19E260073,AR.ESB-SC004,20ARSC0424,L,1,94250,145000,2,0,29000,1,0,29000,116000,87000
01SCS19E260073,BSC.AR-RI0015,00ARRI0056,L,1,43000,135000,0,0,0,0,0,27000,135000,108000
01SCS19E260074,BSC.AR-RK0005,00ARRK0066,M,1,108500,155000,0,0,0,0,0,31000,155000,124000
01SCS19E260075,AR.TUC-SD015,20ARSD0479,L,1,145000,145000,2,0,29000,1,0,29000,116000,87000
01SCS19E260076,AR.MPR-SE007,20ARSE0162,M,1,97500,150000,2,0,45000,1,0,26250,105000,78750
01SCS19E260077,AR.ESB-RK008,20ARRK0241,ALL,1,87750,135000,2,0,40500,1,0,23625,94500,70875
01SCS19E260078,AR.GTW-SA003,20ARSA0304,M,1,94250,145000,2,0,43500,1,0,25375,101500,76125
01SCS19E260079,BSC.AR-SB0014,00ARSB0110,S,1,44000,135000,0,0,0,0,0,27000,135000,108000
01SCS19E260079,BSC.AR-SC0007,00ARSC0043,M,1,44000,135000,0,0,0,0,0,27000,135000,108000
01SCS19E260080,ESH.AR-RH0015,00ARRH0087,S,1,43000,135000,0,0,0,0,0,27000,135000,108000
01SCS19E260080,ESH.AR-SB0030,00ARSB0200,S,1,44000,135000,0,0,0,0,0,27000,135000,108000
01SCS19E260081,AR.ESB-SC016,20ARSC0457,M,1,91000,140000,2,0,28000,1,0,28000,112000,84000
01SCS19E260081,ESH.AR-RK0005,00ARRK0022,M,1,94500,135000,0,0,0,0,0,27000,135000,108000
01SCS19E260082,BSC.AR-RH0017,00ARRH0076,L,1,120000,315000,0,0,0,0,0,63000,315000,252000
01SCS19E260083,AR.ESB-RE021,20ARRE0399,XL,1,91000,140000,2,0,70000,1,0,17500,70000,52500
01SCS19E260084,ESH.AR-SE0013,00ARSE0049,S,1,44500,135000,0,0,0,0,0,27000,135000,108000
01SCS19E260085,AR.ESB-SC017,20ARSC0461,M,1,91000,140000,2,0,28000,1,0,28000,112000,84000
01SCS19E260086,AR.MER-SB003,20ARSB0220,L,1,97500,150000,2,0,45000,1,0,26250,105000,78750
01SCS19E260087,AR.HLW-SA001,20ARSA0088,L,1,208000,320000,2,0,96000,1,0,56000,224000,168000
01SCS19E260088,ESH.AR-RJ0007,00ARRJ0038,XL,1,44500,135000,0,0,0,0,0,27000,135000,108000
01SCS19E260089,AR.STY-SE008,20ARSE0126,ALL,1,55250,85000,2,0,17000,1,0,17000,68000,51000
01SCS19E260090,ESH.AR-RK0004,00ARRK0015,L,1,120000,315000,0,0,0,0,0,63000,315000,252000
01SCS19E260091,AR.PUB-SD033,20ARSD0243,M,1,204750,315000,2,0,63000,1,0,63000,252000,189000
01SCS19E260092,AR.YD-RL004,20ARRL0020,ALL,1,91000,140000,2,0,70000,1,0,17500,70000,52500
01SCS19E260093,BSC.AR-RL0018,00ARRL0109,S,1,125000,315000,0,0,0,0,0,63000,315000,252000
01SCS19E260094,ESH.AR-SC0021,00ARSC0157,S,1,44000,135000,0,0,0,0,0,27000,135000,108000
01SCS19E260095,AR.TUC-SA005,20ARSA0019,L,1,87750,135000,2,0,27000,1,0,27000,108000,81000
01SCS19E260096,BSC.AR-SD0058,00ARSD0294,NON,1,50000,150000,0,0,0,0,0,30000,150000,120000
01SCS19E260097,ESH.AR-SE0006,00ARSE0023,L,1,44000,135000,0,0,0,0,0,27000,135000,108000
01SCS19E260098,AR.MPR-SE012,20ARSE0183,L,1,97500,150000,2,0,45000,1,0,26250,105000,78750
01SCS19E260099,AR.MKV-SE021,20ARSE0612,M,1,97500,150000,0,0,0,0,0,52500,150000,97500
01SCS19E260100,AR.ESB-SC002,20ARSC0310,L,1,204750,315000,2,0,63000,1,0,63000,252000,189000
01SCS19E260101,BSC.AR-RL0019,00ARRL0115,L,1,125000,315000,0,0,0,0,0,63000,315000,252000
01SCS19E260102,BSC.AR-SD0061,00ARSD0336,NON,1,45000,150000,0,0,0,0,0,30000,150000,120000
01SCS19E260103,ESH.AR-SE0029,00ARSE0264,M,1,44500,135000,0,0,0,0,0,27000,135000,108000
01SCS19E260104,AR.SLS-SC021,20ARSC0325,M,1,425000,500000,0,0,0,0,0,75000,500000,425000
01SCS19E260104,AR.STY-SE004,20ARSE0122,ALL,1,55250,85000,2,0,17000,1,0,17000,68000,51000
01SCS19E260104,AR.YD-RL009,20ARRL0025,ALL,1,55250,85000,2,0,25500,1,0,14875,59500,44625
01SCS19E260105,AR.SMD-QH001,20ARQH0424,XL,1,87750,135000,2,0,40500,1,0,23625,94500,70875
01SCS19E260106,BSC.AR-RL0018,00ARRL0109,S,1,125000,315000,0,0,0,0,0,63000,315000,252000
01SCS19E260107,ESH.AR-SB0033,00ARSB0214,L,1,44500,135000,0,0,0,0,0,27000,135000,108000
01SCS19E260107,ESH.AR-SD0032,00ARSD0305,L,1,44500,135000,0,0,0,0,0,27000,135000,108000
01SCS19E260107,ESH.AR-SE0037,00ARSE0330,L,1,44000,135000,0,0,0,0,0,27000,135000,108000
01SCS19E260108,BSC.AR-SD0038,00ARSD0208,M,1,125000,315000,0,0,0,0,0,63000,315000,252000
01SCS19E260109,AR.ESB-SB003,20ARSB0100,S,1,100750,155000,2,0,31000,1,0,31000,124000,93000
01SCS19E260109,AR.MDS-RL006,20ARRL0374,S,1,117000,180000,2,0,36000,1,0,36000,144000,108000
01SCS19E260110,AR.ESB-SC004,20ARSC0422,S,1,94250,145000,2,0,29000,1,0,29000,116000,87000
01SCS19E260110,ESH.AR-SE0001,00ARSE0003,L,1,44000,135000,0,0,0,0,0,27000,135000,108000
01SCS19E260111,AR.MKV-SE017,20ARSE0599,S,1,97500,150000,0,0,0,0,0,52500,150000,97500
01SCS19E260112,BSC.AR-SC0015,00ARSC0103,XL,1,44000,159000,0,0,0,0,0,31800,159000,127200
01SCS19E260113,AR.MPR-SE035,20ARSE0311,ALL,1,136500,210000,2,0,42000,1,0,42000,168000,126000
01SCS19E260114,AR.MPR-SE030,20ARSE0292,M,1,230750,355000,2,0,71000,1,0,71000,284000,213000
01SCS19E260115,AR.CPT-SC006,20ARSC0261,M,1,94250,145000,2,0,29000,1,0,29000,116000,87000
01SCS19E260116,AR.CPT-SC010,20ARSC0473,L,1,204750,315000,2,0,63000,1,0,63000,252000,189000
01SCS19E260117,AR.ASH-RK004,20ARRK0516,M,1,195000,300000,2,0,90000,1,0,52500,210000,157500
01SCS19E260117,AR.CPT-SE005,20ARSE0369,M,1,204750,315000,2,0,63000,1,0,63000,252000,189000
01SCS19E260118,AR.PCT-RJ005,20ARRJ0286,ALL,1,178750,275000,2,0,55000,1,0,55000,220000,165000
01SCS19E260119,AR.CPT-SE003,20ARSE0361,M,1,94250,145000,2,0,29000,1,0,29000,116000,87000
01SCS19E260119,BSC.AR-SA0021,00ARSA0106,M,1,44000,135000,0,0,0,0,0,27000,135000,108000
01SCS19E260120,AR.ESB-SE008,20ARSE0268,L,1,100750,155000,2,0,31000,1,0,31000,124000,93000
01SCS19E260120,BSC.AR-RI0015,00ARRI0056,L,1,43000,135000,0,0,0,0,0,27000,135000,108000
01SCS19E260121,AR.YD-RL007,20ARRL0023,ALL,1,87750,135000,2,0,67500,1,0,16875,67500,50625
01SCS19E260122,BSC.AR-RJ0006,00ARRJ0059,S,1,94500,135000,0,0,0,0,0,27000,135000,108000
01SCS19E260122,BSC.AR-SC0041,00ARSC0271,M,1,44000,159000,0,0,0,0,0,31800,159000,127200
01SCS19E260122,BSC.AR-SD0003,00ARSD0009,S,1,44000,159000,0,0,0,0,0,31800,159000,127200
01SCS19E260122,BSC.AR-SD0039,00ARSD0211,S,1,125000,315000,0,0,0,0,0,63000,315000,252000
01SCS19E260122,ESH.AR-SB0010,00ARSB0039,S,1,44500,135000,0,0,0,0,0,27000,135000,108000
01SCS19E260122,ESH.AR-SD0045,00ARSD0404,S,1,125000,315000,0,0,0,0,0,63000,315000,252000
01SCS19E260123,AR.PCT-SE002,20ARSE0338,M,1,87750,135000,2,0,27000,1,0,27000,108000,81000
01SCS19E260124,AR.PUB-SD033,20ARSD0243,M,1,204750,315000,2,0,63000,1,0,63000,252000,189000
01SCS19E260125,ESH.AR-SD0032,00ARSD0305,L,1,44500,135000,0,0,0,0,0,27000,135000,108000
01SCS19E260126,AR.PCT-SE016,20ARSE0680,M,1,87750,135000,2,0,27000,1,0,27000,108000,81000
01SCS19E260127,ESH.AR-SD0011,00ARSD0073,S,1,125000,315000,0,0,0,0,0,63000,315000,252000
01SCS19E260128,ESH.AR-SE0037,00ARSE0330,L,1,44000,135000,0,0,0,0,0,27000,135000,108000
01SCS19E260129,BSC.AR-RJ0008,00ARRJ0069,L,1,94500,135000,0,0,0,0,0,27000,135000,108000
01SCS19E260130,AR.TUC-SE010,20ARSE0400,M,1,94250,145000,2,0,29000,1,0,29000,116000,87000
01SCS19E260131,AR.SMD-RI005,20ARRI0325,L,1,87750,135000,2,0,40500,1,0,23625,94500,70875
01SCS19E260131,AR.VRS-SC002,20ARSC0168,L,1,96850,149000,2,0,44700,1,0,26075,104300,78225
01SCS19E260132,ESH.AR-SD0039,00ARSD0347,S,1,122500,350000,0,0,0,0,0,70000,350000,280000
01SCS19E260133,AR.SMD-RC001,20ARRC0618,ALL,1,97500,150000,2,0,45000,1,0,26250,105000,78750
01SCS19E260134,ESH.AR-SB0030,00ARSB0201,M,1,44000,135000,0,0,0,0,0,27000,135000,108000
01SCS19E260134,ESH.AR-SD0028,00ARSD0275,M,1,44500,135000,0,0,0,0,0,27000,135000,108000
01SCS19E260135,BSC.AR-RJ0016,00ARRJ0101,L,1,43000,135000,0,0,0,0,0,27000,135000,108000
01SCS19E260135,BSC.AR-RJ0018,00ARRJ0109,L,1,94500,135000,0,0,0,0,0,27000,135000,108000
01SCS19E260136,BSC.AR-SC0029,00ARSC0201,L,1,125000,315000,0,0,0,0,0,63000,315000,252000
01SCS19E260137,AR.CPT-SC002,20ARSC0244,28,1,227500,350000,2,0,70000,1,0,70000,280000,210000
01SCS19E260138,BSC.AR-SC0006,00ARSC0038,S,1,44000,135000,0,0,0,0,0,27000,135000,108000
01SCS19E260138,BSC.AR-SC0023,00ARSC0174,M,1,44500,135000,0,0,0,0,0,27000,135000,108000
01SCS19E260139,BSC.AR-SC0008,00ARSC0051,NON,1,73000,220000,0,0,0,0,0,44000,220000,176000
01SCS19E260140,AR.STY-SA002,20ARSA0061,ALL,1,61750,95000,2,0,19000,1,0,19000,76000,57000
01SCS19E260141,AR.MKV-SD004,20ARSD0232,32,1,117000,180000,0,0,0,0,0,63000,180000,117000
01SCS19E260141,AR.PUB-RK008,20ARRK0383,M,1,97500,150000,2,0,30000,1,0,30000,120000,90000
01SCS19E260142,BSC.AR-SD0022,00ARSD0129,M,1,44000,159000,0,0,0,0,0,31800,159000,127200
01SCS19E260143,ESH.AR-SD0001,00ARSD0031,L,1,44500,135000,0,0,0,0,0,27000,135000,108000
01SCS19E260144,BE.RAK-SB007,00BESB0032,M,1,243750,375000,2,0,75000,1,0,75000,300000,225000
01SCS19E260145,ESH.AR-SE0012,00ARSE0045,S,1,44500,135000,0,0,0,0,0,27000,135000,108000
01SCS19E260146,AR.PUB-RG012,20ARRG0063,M,1,97500,150000,2,0,30000,1,0,30000,120000,90000
01SCS19E260146,DKS.AR-SE0010,00ARSE0167,32,1,417272,696000,0,0,0,0,0,104400,696000,591600
01SCS19E260147,AR.PUB-RI017,20ARRI0263,L,1,97500,150000,2,0,30000,1,0,30000,120000,90000
01SCS19E260147,AR.PUB-SE024,20ARSE0093,L,1,159250,245000,2,0,49000,1,0,49000,196000,147000
01SCS19E260148,AR.VCS-RL002,20ARRL0299,XL,1,97500,150000,2,0,45000,1,0,26250,105000,78750
01SCS19E260149,AR.MPR-SE012,20ARSE0184,XL,1,97500,150000,2,0,45000,1,0,26250,105000,78750
01SCS19E260150,AR.CPT-SE005,20ARSE0369,M,1,204750,315000,2,0,63000,1,0,63000,252000,189000
01SCS19E260151,AR.MPR-SE032,20ARSE0301,L,1,230750,355000,2,0,71000,1,0,71000,284000,213000
01SCS19E260151,AR.SMD-RH009,20ARRH0760,L,1,87750,135000,2,0,40500,1,0,23625,94500,70875
01SCS19E260151,BSC.AR-RI0001,00ARRI0003,L,1,315000,450000,0,0,0,0,0,90000,450000,360000
01SCS19E260152,AR.STY-RL001,20ARRL0392,ALL,1,61750,95000,2,0,19000,1,0,19000,76000,57000
01SCS19E260152,AR.YRX-RH005,20ARRH0722,ALL,1,146250,225000,2,0,45000,1,0,45000,180000,135000
01SCS19E260152,BSC.AR-RH0019,00ARRH0112,M,1,94500,135000,0,0,0,0,0,27000,135000,108000
01SCS19E260153,BSC.AR-RI0015,00ARRI0057,XL,1,94500,135000,0,0,0,0,0,27000,135000,108000
01SCS19E260154,BSC.AR-SA0020,00ARSA0079,S,1,44000,135000,0,0,0,0,0,27000,135000,108000
01SCS19E260155,AR.RDC-RL001,20ARRL0204,L,1,120250,185000,2,0,37000,1,0,37000,148000,111000
01SCS19E260155,ESH.AR-RK0020,00ARRK0200,M,1,192500,275000,0,0,0,0,0,55000,275000,220000
01SCS19E260156,AR.MKV-RJ015,20ARRJ0198,ALL,1,97500,150000,0,0,0,0,0,52500,150000,97500
01SCS19E260157,AR.PCT-SE014,20ARSE0677,L,1,87750,135000,2,0,27000,1,0,27000,108000,81000
01SCS19E260158,AR.PCT-SE013,20ARSE0674,M,1,87750,135000,2,0,27000,1,0,27000,108000,81000
01SCS19E260159,BE.RAK-SC036,00BESC0152,S,1,91000,140000,2,0,28000,1,0,28000,112000,84000
01SCS19E260160,ESH.AR-SE0001,00ARSE0002,M,1,44000,135000,0,0,0,0,0,27000,135000,108000
01SCS19E260161,BE.RAK-SA023,00BESA0093,L,1,91000,140000,2,0,28000,1,0,28000,112000,84000
01SCS19E260162,DKS.AR-SE0002,00ARSE0134,30,1,417272,696000,0,0,0,0,0,104400,696000,591600
01SCS19E260163,AR.SMD-SD018,20ARSD0580,ALL,1,97500,150000,2,0,30000,1,0,30000,120000,90000
01SCS19E260163,BSC.AR-RK0016,00ARRK0111,L,1,43000,135000,0,0,0,0,0,27000,135000,108000
01SCS19E260164,BSC.AR-SA0023,00ARSA0114,NON,1,47500,140000,0,0,0,0,0,28000,140000,112000
01SCS19E260165,AR.TUC-SD018,20ARSD0491,L,1,94250,145000,2,0,29000,1,0,29000,116000,87000
01SCS19E260166,AR.MKV-SE021,20ARSE0612,M,1,97500,150000,0,0,0,0,0,52500,150000,97500
01SCS19E260167,BSC.AR-SE0027,00ARSE0277,L,1,52000,155000,0,0,0,0,0,31000,155000,124000
01SCS19E260168,BSC.AR-SD0043,00ARSD0233,L,1,44500,159000,0,0,0,0,0,31800,159000,127200
01SCS19E260168,ESH.AR-SD0028,00ARSD0275,M,1,44500,135000,0,0,0,0,0,27000,135000,108000
01SCS19E260168,ESH.AR-SE0010,00ARSE0038,M,1,44000,135000,0,0,0,0,0,27000,135000,108000
01SCS19E260169,BSC.AR-SD0025,00ARSD0149,M,1,44500,159000,0,0,0,0,0,31800,159000,127200
01SCS19E260170,ESH.AR-SC0009,00ARSC0078,L,1,44500,135000,0,0,0,0,0,27000,135000,108000
01SCS19E260171,BSC.AR-SD0046,00ARSD0244,M,1,44500,159000,0,0,0,0,0,31800,159000,127200
01SCS19E260172,BSC.AR-SD0039,00ARSD0212,M,1,125000,315000,0,0,0,0,0,63000,315000,252000
01SCS19E260173,ARN.AR-RK0005,00ARRK0236,32,1,110000,350000,0,0,0,0,0,105000,350000,245000
01SCS19E260174,AR.MKV-RL005,20ARRL0251,30,1,227500,350000,0,0,0,0,0,122500,350000,227500
01SCS19E260174,AR.TUC-SE016,20ARSE0424,M,1,146250,225000,2,0,45000,1,0,45000,180000,135000
01SCS19E260175,BSC.AR-RI0003,00ARRI0008,L,1,43000,135000,0,0,0,0,0,27000,135000,108000
01SCS19E260175,ESH.AR-SB0022,00ARSB0125,L,1,44000,135000,0,0,0,0,0,27000,135000,108000
01SCS19E260176,ESH.AR-SB0005,00ARSB0017,L,1,44000,135000,0,0,0,0,0,27000,135000,108000
01SCS19E260177,AR.VCS-RL003,20ARRL0303,XL,1,97500,150000,2,0,45000,1,0,26250,105000,78750
01SCS19E260178,ESH.AR-SC0007,00ARSC0060,S,1,125000,350000,0,0,0,0,0,70000,350000,280000
01SCS19E260179,AR.ESB-SB005,20ARSB0109,M,1,91000,140000,2,0,28000,1,0,28000,112000,84000
01SCS19E260179,AR.SMD-SD013,20ARSD0569,S,1,87750,135000,2,0,27000,1,0,27000,108000,81000
01SCS19E260180,BSC.AR-SA0001,00ARSA0003,L,1,120000,315000,0,0,0,0,0,63000,315000,252000
01SCS19E260181,BE.RAK-SC014,00BESC0044,M,1,204750,315000,2,0,63000,1,0,63000,252000,189000
01SCS19E260182,BSC.AR-SE0005,00ARSE0076,XL,1,44000,159000,0,0,0,0,0,31800,159000,127200
01SCS19E260182,ESH.AR-SD0008,00ARSD0064,XL,1,44500,135000,0,0,0,0,0,27000,135000,108000
01SCS19E260183,AR.MDS-RF005,20ARRF0093,XL,1,357500,550000,2,0,110000,1,0,110000,440000,330000
01SCS19E260184,AR.ESB-SE007,20ARSE0263,M,1,94250,145000,2,0,29000,1,0,29000,116000,87000
01SCS19E260184,BSC.AR-SA0009,00ARSA0035,NON,1,47500,140000,0,0,0,0,0,28000,140000,112000
01SCS19E260185,AR.PUB-RL004,20ARRL0122,XL,1,97500,150000,2,0,30000,1,0,30000,120000,90000
01SCS19E260186,AR.MPR-SE011,20ARSE0180,XL,1,97500,150000,2,0,45000,1,0,26250,105000,78750
01SCS19E260186,BSC.AR-SD0053,00ARSD0283,S,1,44000,159000,0,0,0,0,0,31800,159000,127200
01SCS19E260187,BSC.AR-RH0019,00ARRH0112,M,1,94500,135000,0,0,0,0,0,27000,135000,108000
01SCS19E260188,AR.FHL-RJ006,20ARRJ0438,L,1,227500,350000,2,0,70000,1,0,70000,280000,210000
01SCS19E260189,AR.CPT-RE009,20ARRE0704,XL,1,204750,315000,2,0,63000,1,0,63000,252000,189000
01SCS19E260190,AR.PUB-SA004,20ARSA0236,M,1,97500,150000,2,0,30000,1,0,30000,120000,90000
01SCS19E260190,AR.SMD-RH009,20ARRH0760,L,1,87750,135000,2,0,40500,1,0,23625,94500,70875
01SCS19E260190,BSC.AR-SE0037,00ARSE0347,M,1,44000,159000,0,0,0,0,0,31800,159000,127200
01SCS19E260191,BSC.AR-SD0052,00ARSD0281,L,1,44500,159000,0,0,0,0,0,31800,159000,127200
01SCS19E260192,ESH.AR-RK0021,00ARRK0215,NON,1,129500,185000,0,0,0,0,0,37000,185000,148000
01SCS19E260193,AR.MER-SB003,20ARSB0220,L,1,97500,150000,2,0,45000,1,0,26250,105000,78750
01SCS19E260194,BSC.AR-SD0039,00ARSD0212,M,1,125000,315000,0,0,0,0,0,63000,315000,252000
01SCS19E260195,AR.MKV-SB011,20ARSB0540,M,1,91000,140000,0,0,0,0,0,49000,140000,91000
01SCS19E260195,ESH.AR-RL0011,00ARRL0121,S,1,100000,265000,0,0,0,0,0,53000,265000,212000
01SCS19E260196,AR.PUB-SB024,20ARSB0131,XL,1,97500,150000,2,0,30000,1,0,30000,120000,90000
01SCS19E260196,AR.PUB-SE001,20ARSE0004,XL,1,97500,150000,2,0,30000,1,0,30000,120000,90000
01SCS19E260197,BSC.AR-SD0025,00ARSD0148,S,1,44500,159000,0,0,0,0,0,31800,159000,127200
01SCS19E260198,AR.PCT-SE011,20ARSE0671,L,1,211250,325000,2,0,65000,1,0,65000,260000,195000
01SCS19E260199,AR.PUB-SE017,20ARSE0067,L,1,159250,245000,2,0,49000,1,0,49000,196000,147000
01SCS19E260200,AR.PUB-RL005,20ARRL0125,L,1,97500,150000,2,0,30000,1,0,30000,120000,90000
01SCS19E260200,AR.YD-SD002,20ARSD0265,M,1,87750,135000,2,0,67500,1,0,16875,67500,50625
01SCS19E260201,AR.TUC-SA005,20ARSA0019,L,1,87750,135000,2,0,27000,1,0,27000,108000,81000
01SCS19E260202,BSC.AR-SB0006,00ARSB0071,M,1,44000,135000,0,0,0,0,0,27000,135000,108000
01SCS19E260203,BSC.AR-SB0001,00ARSB0003,S,1,44000,135000,0,0,0,0,0,27000,135000,108000
01SCS19E260204,AR.MPR-SE004,20ARSE0150,M,1,97500,150000,2,0,45000,1,0,26250,105000,78750
01SCS19E260204,BSC.AR-RK0019,00ARRK0121,S,1,43000,135000,0,0,0,0,0,27000,135000,108000
01SCS19E260205,BSC.AR-RJ0008,00ARRJ0068,M,1,94500,135000,0,0,0,0,0,27000,135000,108000
01SCS19E260205,BSC.AR-SC0007,00ARSC0044,L,1,44000,135000,0,0,0,0,0,27000,135000,108000
01SCS19E260206,BSC.AR-SB0002,00ARSB0019,S,1,44500,135000,0,0,0,0,0,27000,135000,108000
01SCS19E260207,AR.CPT-SE006,20ARSE0373,M,1,204750,315000,2,0,63000,1,0,63000,252000,189000
01SCS19E260208,BE.RAK-RX233,00BERX0688,L,1,185250,285000,2,0,57000,1,0,57000,228000,171000
01SCS19E260209,AR.HLW-SE003,20ARSE0528,S,1,100750,155000,2,0,31000,1,0,31000,124000,93000
01SCS19E260209,AR.HLW-SE003,20ARSE0529,M,1,100750,155000,2,0,31000,1,0,31000,124000,93000
01SCS19E260210,BSC.AR-SA0019,00ARSA0063,S,1,44000,135000,0,0,0,0,0,27000,135000,108000
01SCS19E260211,BSC.AR-RI0011,00ARRI0038,S,1,43000,135000,0,0,0,0,0,27000,135000,108000
01SCS19E260212,ESH.AR-SE0031,00ARSE0273,L,1,125000,315000,0,0,0,0,0,63000,315000,252000
01SCS19E260213,AR.ASH-SD005,20ARSD0398,M,1,243750,375000,2,0,112500,1,0,65625,262500,196875
01SCS19E260213,AR.GTW-SA003,20ARSA0305,L,1,94250,145000,2,0,43500,1,0,25375,101500,76125
01SCS19E260214,BSC.AR-SB0018,00ARSB0141,M,1,44500,135000,0,0,0,0,0,27000,135000,108000
01SCS19E260214,BSC.AR-SD0002,00ARSD0006,M,1,44000,159000,0,0,0,0,0,31800,159000,127200
01SCS19E260215,ESH.AR-SE0005,00ARSE0020,XL,1,44500,135000,0,0,0,0,0,27000,135000,108000
01SCS19E260216,BSC.AR-SE0008,00ARSE0086,M,1,44000,159000,0,0,0,0,0,31800,159000,127200
01SCS19E260217,AR.MKV-QH025,20ARQH0573,M,1,182000,280000,2,0,140000,1,0,35000,140000,105000
01SCS19E260218,AR.MPR-SE029,20ARSE0234,S,1,230750,355000,2,0,71000,1,0,71000,284000,213000
01SCS19E260219,BE.RAK-SA017,00BESA0062,M,1,91000,140000,2,0,28000,1,0,28000,112000,84000
01SCS19E260220,ESH.AR-RJ0002,00ARRJ0016,M,1,94500,135000,0,0,0,0,0,27000,135000,108000
01SCS19E260221,BSC.AR-RJ0018,00ARRJ0109,L,1,94500,135000,0,0,0,0,0,27000,135000,108000
01SCS19E260222,AR.TUC-SD002,20ARSD0145,M,1,204750,315000,2,0,63000,1,0,63000,252000,189000
01SCS19E260223,AR.ESB-SB006,20ARSB0113,M,1,91000,140000,2,0,28000,1,0,28000,112000,84000
01SCS19E260223,BSC.AR-SD0030,00ARSD0175,M,1,44500,159000,0,0,0,0,0,31800,159000,127200
01SCS19E260224,BSC.AR-SD0002,00ARSD0005,S,1,44000,159000,0,0,0,0,0,31800,159000,127200
01SCS19E260225,AR.MKV-RL001,20ARRL0237,L,1,204750,315000,0,0,0,0,0,110250,315000,204750
01SCS19E260226,AR.MDS-RE011,20ARRE0672,XL,1,234000,360000,2,0,72000,1,0,72000,288000,216000
01SCS19E260227,BSC.AR-SC0014,00ARSC0097,M,1,44000,159000,0,0,0,0,0,31800,159000,127200
01SCS19E260228,ESH.AR-SC0017,00ARSC0141,M,1,44000,135000,0,0,0,0,0,27000,135000,108000
01SCS19E260229,BSC.AR-SE0014,00ARSE0179,S,1,44000,159000,0,0,0,0,0,31800,159000,127200
01SCS19E260230,ESH.AR-SD0039,00ARSD0349,L,1,122500,350000,0,0,0,0,0,70000,350000,280000
01SCS19E260231,BSC.AR-RL0018,00ARRL0109,S,1,125000,315000,0,0,0,0,0,63000,315000,252000
01SCS19E260232,AR.REC-SD018,20ARSD0056,ALL,1,107250,165000,2,0,49500,1,0,28875,115500,86625
01SCS19E260233,AR.STY-SE004,20ARSE0122,ALL,1,55250,85000,2,0,17000,1,0,17000,68000,51000
01SCS19E260234,AR.MPR-SE032,20ARSE0301,L,1,230750,355000,2,0,71000,1,0,71000,284000,213000
01SCS19E260235,AR.SMD-SE003,20ARSE0440,S,1,87750,135000,2,0,27000,1,0,27000,108000,81000
01SCS19E260236,BSC.AR-RH0019,00ARRH0112,M,1,94500,135000,0,0,0,0,0,27000,135000,108000
01SCS19E260237,BE.RAK-SC021,00BESC0077,S,1,201500,310000,2,0,62000,1,0,62000,248000,186000
01SCS19E260237,ESH.AR-SB0015,00ARSB0062,S,1,125000,315000,0,0,0,0,0,63000,315000,252000
01SCS19E260238,AR.PUB-SC017,20ARSC0370,L,1,204750,315000,2,0,63000,1,0,63000,252000,189000
01SCS19E260238,AR.TUC-SD011,20ARSD0463,L,1,94250,145000,2,0,29000,1,0,29000,116000,87000
01SCS19E260239,BSC.AR-RI0023,00ARRI0132,NON,1,98000,140000,0,0,0,0,0,28000,140000,112000
01SCS19E260240,ESH.AR-SA0007,00ARSA0076,M,1,44000,135000,0,0,0,0,0,27000,135000,108000
01SCS19E260240,ESH.AR-SE0038,00ARSE0333,M,1,44500,135000,0,0,0,0,0,27000,135000,108000
01SCS19E260241,BSC.AR-SC0029,00ARSC0201,L,1,125000,315000,0,0,0,0,0,63000,315000,252000
01SCS19E260241,BSC.AR-SD0055,00ARSD0288,NON,1,50000,150000,0,0,0,0,0,30000,150000,120000
01SCS19E260242,AR.STY-RL001,20ARRL0392,ALL,1,61750,95000,2,0,19000,1,0,19000,76000,57000
01SCS19E260243,AR.STY-SE002,20ARSE0120,ALL,1,55250,85000,2,0,17000,1,0,17000,68000,51000
01SCS19E260244,AR.CPT-RE010,20ARRE0707,L,1,204750,315000,2,0,63000,1,0,63000,252000,189000
01SCS19E260245,AR.VRS-SC002,20ARSC0169,XL,1,96850,149000,2,0,44700,1,0,26075,104300,78225
01SCS19E260246,ESH.AR-SD0045,00ARSD0406,L,1,125000,315000,0,0,0,0,0,63000,315000,252000
01SCS19E260247,BSC.AR-SD0033,00ARSD0187,S,1,44500,159000,0,0,0,0,0,31800,159000,127200
01SCS19E260248,AR.CPT-RE008,20ARRE0699,L,1,317850,489000,2,0,97800,1,0,97800,391200,293400
01SCS19E260248,ESH.AR-SC0023,00ARSC0167,L,1,125000,315000,0,0,0,0,0,63000,315000,252000
01SCS19E260249,ESH.AR-RK0015,00ARRK0191,NON,1,43000,150000,0,0,0,0,0,30000,150000,120000
01SCS19E260250,AR.ESB-SD013,20ARSD0326,M,1,91000,140000,2,0,28000,1,0,28000,112000,84000
01SCS19E260251,AR.HMR-SB025,20ARSB0416,32,1,194350,299000,2,0,59800,1,0,59800,239200,179400
01SCS19E260251,AR.VRS-SE003,20ARSE0319,28,1,298350,459000,2,0,137700,1,0,80325,321300,240975
01SCS19E260252,AR.MPR-SE024,20ARSE0216,L,1,230750,355000,2,0,71000,1,0,71000,284000,213000
01SCS19E260253,AR.MKV-SD004,20ARSD0231,30,1,117000,180000,0,0,0,0,0,63000,180000,117000
01SCS19E260253,AR.SLS-SE020,20ARSE0665,L,1,212500,250000,0,0,0,0,0,37500,250000,212500
01SCS19E260253,AR.STY-SE012,20ARSE0578,ALL,1,55250,85000,2,0,17000,1,0,17000,68000,51000
01SCS19E260253,BSC.AR-RJ0002,00ARRJ0005,ALL,1,98000,140000,0,0,0,0,0,28000,140000,112000
01SCS19E260254,BSC.AR-SD0022,00ARSD0129,M,1,44000,159000,0,0,0,0,0,31800,159000,127200
01SCS19E260255,AR.TUC-SD011,20ARSD0464,XL,1,94250,145000,2,0,29000,1,0,29000,116000,87000
01SCS19E260256,BSC.AR-SB0009,00ARSB0082,S,1,44500,135000,0,0,0,0,0,27000,135000,108000
01SCS19E260256,BSC.AR-SC0014,00ARSC0097,M,1,44000,159000,0,0,0,0,0,31800,159000,127200
01SCS19E260257,BSC.AR-SD0039,00ARSD0213,L,1,125000,315000,0,0,0,0,0,63000,315000,252000
01SCS19E260257,ESH.AR-SB0033,00ARSB0214,L,1,44500,135000,0,0,0,0,0,27000,135000,108000
01SCS19E260258,BSC.AR-SD0025,00ARSD0148,S,1,44500,159000,0,0,0,0,0,31800,159000,127200
01SCS19E260259,BSC.AR-SC0023,00ARSC0174,M,1,44500,135000,0,0,0,0,0,27000,135000,108000
01SCS19E260259,BSC.AR-SC0049,00ARSC0308,S,1,44500,159000,0,0,0,0,0,31800,159000,127200
01SCS19E260260,ESH.AR-SA0013,00ARSA0098,M,1,44000,135000,0,0,0,0,0,27000,135000,108000
01SCS19E260260,ESH.AR-SB0030,00ARSB0201,M,1,44000,135000,0,0,0,0,0,27000,135000,108000
01SCS19E260261,BSC.AR-SD0006,00ARSD0021,S,1,44000,159000,0,0,0,0,0,31800,159000,127200
01SCS19E260262,AR.MKV-SE019,20ARSE0605,S,1,97500,150000,0,0,0,0,0,52500,150000,97500
01SCS19E260263,AR.BPH-RB003,20ARRB0433,S,1,195000,300000,2,0,150000,1,0,37500,150000,112500
01SCS19E260263,AR.MPR-SE022,20ARSE0206,S,1,243750,375000,2,0,75000,1,0,75000,300000,225000
01SCS19E260264,AR.MKV-SB012,20ARSB0544,M,1,172250,265000,0,0,0,0,0,92750,265000,172250
01SCS19E260265,AR.YRX-RH004,20ARRH0721,ALL,1,172250,265000,2,0,53000,1,0,53000,212000,159000
01SCS19E260266,AR.MPR-SE002,20ARSE0143,L,1,97500,150000,2,0,45000,1,0,26250,105000,78750
01SCS19E260266,ESH.AR-RJ0007,00ARRJ0037,L,1,94500,135000,0,0,0,0,0,27000,135000,108000
01SCS19E260267,BSC.AR-SC0007,00ARSC0044,L,1,44000,135000,0,0,0,0,0,27000,135000,108000
01SCS19E260268,BSC.AR-SC0034,00ARSC0228,S,1,125000,315000,0,0,0,0,0,63000,315000,252000
01SCS19E260269,AR.MPR-SE012,20ARSE0183,L,1,97500,150000,2,0,45000,1,0,26250,105000,78750
01SCS19E260269,ESH.AR-SA0012,00ARSA0093,S,1,44000,135000,0,0,0,0,0,27000,135000,108000
01SCS19E260269,ESH.AR-SD0005,00ARSD0050,M,1,44000,135000,0,0,0,0,0,27000,135000,108000
01SCS19E260270,ESH.AR-RD0007,00ARRD0054,NON,1,80500,115000,0,0,0,0,0,23000,115000,92000
01SCS19E260271,ESH.AR-RK0014,00ARRK0187,S,1,112500,350000,0,0,0,0,0,70000,350000,280000
01SCS19E260272,BSC.AR-SD0029,00ARSD0170,S,1,44500,159000,0,0,0,0,0,31800,159000,127200
01SCS19E260273,AR.ESB-SE010,20ARSE0276,L,1,227500,350000,2,0,70000,1,0,70000,280000,210000
01SCS19E260273,AR.MKV-RJ001,20ARRJ0142,L,1,91000,140000,0,0,0,0,0,49000,140000,91000
01SCS19E260273,AR.MKV-RJ011,20ARRJ0194,XL,1,312000,480000,0,0,0,0,0,168000,480000,312000
01SCS19E260273,AR.MKV-RJ016,20ARRJ0199,ALL,1,117000,180000,0,0,0,0,0,63000,180000,117000
01SCS19E260273,AR.MKV-SE017,20ARSE0599,S,1,97500,150000,0,0,0,0,0,52500,150000,97500
01SCS19E260273,AR.PCT-SE003,20ARSE0340,M,1,87750,135000,2,0,27000,1,0,27000,108000,81000
01SCS19E260273,AR.PCT-SE013,20ARSE0675,L,1,87750,135000,2,0,27000,1,0,27000,108000,81000
01SCS19E260273,AR.SMD-SD014,20ARSD0573,S,1,87750,135000,2,0,27000,1,0,27000,108000,81000
01SCS19E260273,AR.STY-RE007,20ARRE0120,ALL,1,61750,95000,2,0,19000,1,0,19000,76000,57000
01SCS19E260273,AR.STY-RK003,20ARRK0525,ALL,1,61750,95000,2,0,19000,1,0,19000,76000,57000
01SCS19E260273,AR.TUC-SD008,20ARSD0168,ALL,1,81250,125000,2,0,25000,1,0,25000,100000,75000
01SCS19E260274,AR.PUB-SE013,20ARSE0049,S,1,159250,245000,2,0,49000,1,0,49000,196000,147000
01SCS19E260275,AR.VCS-RD001,20ARRD0203,S,1,321750,495000,2,0,148500,1,0,86625,346500,259875
01SCS19E260276,AR.HLW-SE020,20ARSE0569,M,1,208000,320000,2,0,64000,1,0,64000,256000,192000
01SCS19E260277,AR.CPT-SE001,20ARSE0353,M,1,94250,145000,2,0,29000,1,0,29000,116000,87000
01SCS19E260278,AR.HMR-SB009,20ARSB0369,M,1,90350,139000,2,0,27800,1,0,27800,111200,83400
01SCS19E260278,AR.TUC-SE015,20ARSE0420,M,1,94250,145000,2,0,29000,1,0,29000,116000,87000
01SCS19E260279,BSC.AR-SD0039,00ARSD0212,M,1,125000,315000,0,0,0,0,0,63000,315000,252000
01SCS19E260280,AR.ESB-RE008,20ARRE0358,M,1,94250,145000,2,0,72500,1,0,18125,72500,54375
01SCS19E260280,AR.ESB-RL004,20ARRL0014,M,1,100750,155000,2,0,31000,1,0,31000,124000,93000
01SCS19E260280,AR.TUC-RL021,20ARRL0345,ALL,1,87750,135000,2,0,27000,1,0,27000,108000,81000
01SCS19E260281,BSC.AR-SE0027,00ARSE0277,L,1,52000,155000,0,0,0,0,0,31000,155000,124000
01SCS19E260281,ESH.AR-SC0010,00ARSC0081,M,1,44500,135000,0,0,0,0,0,27000,135000,108000
01SCS19E260282,AR.PCT-SE020,20ARSE0688,M,1,87750,135000,2,0,27000,1,0,27000,108000,81000
01SCS19E260283,AR.CLK-SA003,20ARSA0052,ALL,1,91000,140000,2,0,28000,1,0,28000,112000,84000
01SCS19E260284,AR.MER-SB003,20ARSB0221,XL,1,97500,150000,2,0,45000,1,0,26250,105000,78750
01SCS19E260284,AR.YD-RL004,20ARRL0020,ALL,1,91000,140000,2,0,70000,1,0,17500,70000,52500
01SCS19E260285,AR.PUB-RK018,20ARRK0466,XL,1,191750,295000,2,0,59000,1,0,59000,236000,177000
01SCS19E260285,BSC.AR-RL0019,00ARRL0115,L,1,125000,315000,0,0,0,0,0,63000,315000,252000
01SCS19E260286,ESH.AR-SD0029,00ARSD0278,NON,1,58000,175000,0,0,0,0,0,35000,175000,140000
01SCS19E260287,ESH.AR-SE0005,00ARSE0019,L,1,44500,135000,0,0,0,0,0,27000,135000,108000
01SCS19E260288,BSC.AR-SA0008,00ARSA0034,NON,1,47500,140000,0,0,0,0,0,28000,140000,112000
01SCS19E260288,ESH.AR-SB0030,00ARSB0201,M,1,44000,135000,0,0,0,0,0,27000,135000,108000
01SCS19E260288,ESH.AR-SD0031,00ARSD0299,S,1,44000,135000,0,0,0,0,0,27000,135000,108000
01SCS19E260289,BSC.AR-SD0019,00ARSD0124,NON,1,45000,150000,0,0,0,0,0,30000,150000,120000
01SCS19E260290,AR.MKV-SE010,20ARSE0515,30,1,227500,350000,0,0,0,0,0,122500,350000,227500
01SCS19E260290,AR.PCT-RL002,20ARRL0186,M,1,217750,335000,2,0,167500,1,0,41875,167500,125625
01SCS19E260290,AR.PUB-RL022,20ARRL0201,ALL,1,97500,150000,2,0,30000,1,0,30000,120000,90000
01SCS19E260291,AR.MER-SB002,20ARSB0216,M,1,97500,150000,2,0,45000,1,0,26250,105000,78750
01SCS19E260292,AR.SMD-SA003,20ARSA0227,S,1,87750,135000,2,0,27000,1,0,27000,108000,81000
01SCS19E260293,AR.BPH-RB003,20ARRB0434,M,1,195000,300000,2,0,150000,1,0,37500,150000,112500
01SCS19E260293,BE.RAK-SC029,00BESC0116,S,1,211250,325000,2,0,65000,1,0,65000,260000,195000
01SCS19E260294,AR.TUC-SE020,20ARSE0642,XL,1,204750,315000,2,0,63000,1,0,63000,252000,189000
01SCS19E260295,AR.CPT-SD007,20ARSD0439,L,1,204750,315000,2,0,63000,1,0,63000,252000,189000
01SCS19E260296,AR.MKV-SE016,20ARSE0597,L,1,22750,350000,0,0,0,0,0,122500,350000,227500
01SCS19E260296,ESH.AR-SD0004,00ARSD0048,XL,1,44500,135000,0,0,0,0,0,27000,135000,108000
01SCS19E260297,AR.PUB-SB036,20ARSB0467,ALL,1,81250,125000,2,0,25000,1,0,25000,100000,75000
01SCS19E260297,ARN.AR-RK0002,00ARRK0224,L,1,43000,140000,0,0,0,0,0,42000,140000,98000
01SCS19E260298,AR.PUB-SD015,20ARSD0126,M,1,97500,150000,2,0,30000,1,0,30000,120000,90000
01SCS19E260299,ESH.AR-SD0026,00ARSD0267,M,1,44500,135000,0,0,0,0,0,27000,135000,108000
01SCS19E260300,BSC.AR-SE0031,00ARSE0292,M,1,52000,155000,0,0,0,0,0,31000,155000,124000
01SCS19E260301,BSC.AR-SD0058,00ARSD0294,NON,1,50000,150000,0,0,0,0,0,30000,150000,120000
01SCS19E260302,AR.ESB-RE010,20ARRE0364,M,1,87750,135000,2,0,67500,1,0,16875,67500,50625
01SCS19E260302,AR.PCT-SE004,20ARSE0342,M,1,87750,135000,2,0,27000,1,0,27000,108000,81000
01SCS19E260303,BSC.AR-RK0016,00ARRK0112,XL,1,43000,135000,0,0,0,0,0,27000,135000,108000
01SCS19E260303,BSC.AR-RL0026,00ARRL0173,XL,1,94500,135000,0,0,0,0,0,27000,135000,108000
01SCS19E260304,AR.YD-SD004,20ARSD0270,S,1,91000,140000,2,0,42000,1,0,24500,98000,73500
01SCS19E260305,BSC.AR-SC0041,00ARSC0272,L,1,44000,159000,0,0,0,0,0,31800,159000,127200
01SCS19E260305,ESH.AR-SE0009,00ARSE0035,L,1,44500,135000,0,0,0,0,0,27000,135000,108000
01SCS19E260306,AR.MKV-PL008,20ARPL0421,L,1,91000,140000,2,0,70000,1,0,17500,70000,52500
01SCS19E260307,BSC.AR-SA0019,00ARSA0063,S,1,44000,135000,0,0,0,0,0,27000,135000,108000
01SCS19E260307,BSC.AR-SD0046,00ARSD0244,M,1,44500,159000,0,0,0,0,0,31800,159000,127200
01SCS19E260308,AR.SMD-SD007,20ARSD0301,M,1,211250,325000,2,0,65000,1,0,65000,260000,195000
01SCS19E260309,ESH.AR-SE0038,00ARSE0332,S,1,44500,135000,0,0,0,0,0,27000,135000,108000
01SCS19E260310,BSC.AR-RJ0014,00ARRJ0093,L,1,94500,135000,0,0,0,0,0,27000,135000,108000
01SCS19E260310,ESH.AR-SB0006,00ARSB0023,S,1,44500,135000,0,0,0,0,0,27000,135000,108000
01SCS19E260310,ESH.AR-SD0008,00ARSD0062,M,1,44500,135000,0,0,0,0,0,27000,135000,108000
01SCS19E260310,ESH.AR-SE0012,00ARSE0045,S,1,44500,135000,0,0,0,0,0,27000,135000,108000
01SCS19E260311,AR.MPR-SE026,20ARSE0222,S,1,230750,355000,2,0,71000,1,0,71000,284000,213000
01SCS19E260312,BSC.AR-RI0038,00ARRI0215,M,1,262500,375000,0,0,0,0,0,75000,375000,300000
01SCS19E260312,BSC.AR-SD0056,00ARSD0290,M,1,125000,315000,0,0,0,0,0,63000,315000,252000
01SCS19E260313,AR.ESB-SB001,20ARSB0022,L,1,204750,315000,2,0,63000,1,0,63000,252000,189000
01SCS19E260314,AR.PUB-SE026,20ARSE0101,L,1,204750,315000,2,0,63000,1,0,63000,252000,189000
01SCS19E260315,AR.MPR-SE019,20ARSE0203,ALL,1,97500,150000,2,0,45000,1,0,26250,105000,78750
01SCS19E260316,BSC.AR-SC0006,00ARSC0039,M,1,44000,135000,0,0,0,0,0,27000,135000,108000
01SCS19E260317,BSC.AR-RJ0009,00ARRJ0073,L,1,94500,135000,0,0,0,0,0,27000,135000,108000
01SCS19E260317,ESH.AR-RJ0007,00ARRJ0037,L,1,94500,135000,0,0,0,0,0,27000,135000,108000
01SCS19E260318,BSC.AR-RK0012,00ARRK0095,L,1,43000,135000,0,0,0,0,0,27000,135000,108000
01SCS19E260318,BSC.AR-SC0007,00ARSC0044,L,1,44000,135000,0,0,0,0,0,27000,135000,108000
01SCS19E260319,AR.MKV-SE017,20ARSE0600,M,1,97500,150000,0,0,0,0,0,52500,150000,97500
01SCS19E260319,AR.MKV-SE021,20ARSE0613,L,1,97500,150000,0,0,0,0,0,52500,150000,97500
01SCS19E260319,AR.SMD-SD006,20ARSD0296,S,1,87750,135000,2,0,27000,1,0,27000,108000,81000
01SCS19E260320,BSC.AR-RL0018,00ARRL0109,S,1,125000,315000,0,0,0,0,0,63000,315000,252000
01SCS19E260320,BSC.AR-SE0001,00ARSE0058,M,1,44500,159000,0,0,0,0,0,31800,159000,127200
01SCS19E260321,AR.TUC-SD011,20ARSD0463,L,1,94250,145000,2,0,29000,1,0,29000,116000,87000
01SCS19E260321,BSC.AR-SD0055,00ARSD0288,NON,1,50000,150000,0,0,0,0,0,30000,150000,120000
01SCS19E260322,AR.PCT-SE020,20ARSE0688,M,1,87750,135000,2,0,27000,1,0,27000,108000,81000
01SCS19E260323,AR.MKV-SE019,20ARSE0605,S,1,97500,150000,0,0,0,0,0,52500,150000,97500
01SCS19E260323,AR.PUB-RJ003,20ARRJ0012,XL,1,97500,150000,2,0,30000,1,0,30000,120000,90000
01SCS19E260324,ESH.AR-SC0009,00ARSC0077,M,1,44500,135000,0,0,0,0,0,27000,135000,108000
01SCS19E260325,AR.MPR-SE008,20ARSE0167,L,1,97500,150000,2,0,45000,1,0,26250,105000,78750
01SCS19E260326,AR.PUB-SE004,20ARSE0016,XL,1,97500,150000,2,0,30000,1,0,30000,120000,90000
01SCS19E260326,BSC.AR-RL0022,00ARRL0141,S,1,94500,135000,0,0,0,0,0,27000,135000,108000
01SCS19E260327,BSC.AR-RH0019,00ARRH0112,M,1,94500,135000,0,0,0,0,0,27000,135000,108000
01SCS19E260328,AR.TUC-SE017,20ARSE0428,L,1,146250,225000,2,0,45000,1,0,45000,180000,135000
01SCS19E260329,BSC.AR-SD0009,00ARSD0099,S,1,44000,159000,0,0,0,0,0,31800,159000,127200
01SCS19E260330,ESH.AR-SD0025,00ARSD0262,S,1,44000,135000,0,0,0,0,0,27000,135000,108000
01SCS19E260331,ESH.AR-SE0036,00ARSE0327,XL,1,44500,135000,0,0,0,0,0,27000,135000,108000
01SCS19E260332,AR.MKV-RC021,20ARRC0593,ALL,1,78000,120000,0,0,0,0,0,42000,120000,78000
01SCS19E260333,ESH.AR-SB0031,00ARSB0205,M,1,44500,135000,0,0,0,0,0,27000,135000,108000
01SCS19E260334,AR.PCT-SE011,20ARSE0671,L,1,211250,325000,2,0,65000,1,0,65000,260000,195000
01SCS19E260335,AR.PUB-SC013,20ARSC0354,L,1,97500,150000,2,0,30000,1,0,30000,120000,90000
01SCS19E260336,ESH.AR-RH0005,00ARRH0043,L,1,94500,135000,0,0,0,0,0,27000,135000,108000
01SCS19E260336,ESH.AR-SE0025,00ARSE0249,L,1,44500,135000,0,0,0,0,0,27000,135000,108000
01SCS19E260337,BSC.AR-SD0006,00ARSD0022,M,1,44000,159000,0,0,0,0,0,31800,159000,127200
01SCS19E260337,ESH.AR-SD0003,00ARSD0042,M,1,44000,135000,0,0,0,0,0,27000,135000,108000
01SCS19E260338,AR.STY-SE012,20ARSE0578,ALL,1,55250,85000,2,0,17000,1,0,17000,68000,51000
01SCS19E260339,AR.GTW-SC001,20ARSC0022,M,1,214500,330000,2,0,99000,1,0,57750,231000,173250
01SCS19E260340,AR.ESB-SB005,20ARSB0109,M,1,91000,140000,2,0,28000,1,0,28000,112000,84000
01SCS19E260340,AR.PUB-SD016,20ARSD0131,L,1,97500,150000,2,0,30000,1,0,30000,120000,90000
01SCS19E260341,BSC.AR-SD0036,00ARSD0199,S,1,44500,159000,0,0,0,0,0,31800,159000,127200
01SCS19E260342,ESH.AR-SB0034,00ARSB0218,L,1,125000,315000,0,0,0,0,0,63000,315000,252000
01SCS19E260343,BSC.AR-SD0042,00ARSD0228,M,1,44500,159000,0,0,0,0,0,31800,159000,127200
01SCS19E260344,THR.AR-QB0012,00ARQB0030,ALL,1,370000,370000,0,0,0,0,0,55500,370000,314500
01SCS19E260345,AR.ESB-SE004,20ARSE0251,M,1,94250,145000,2,0,29000,1,0,29000,116000,87000
01SCS19E260346,AR.PCT-SE020,20ARSE0689,L,1,87750,135000,2,0,27000,1,0,27000,108000,81000
01SCS19E260346,ESH.AR-SE0005,00ARSE0019,L,1,44500,135000,0,0,0,0,0,27000,135000,108000
01SCS19E260347,AR.STY-RE007,20ARRE0120,ALL,1,61750,95000,2,0,19000,1,0,19000,76000,57000
01SCS19E260348,AR.CPT-RI004,20ARRI0054,L,1,94250,145000,2,0,29000,1,0,29000,116000,87000
01SCS19E260349,BSC.AR-RL0018,00ARRL0110,M,1,125000,315000,0,0,0,0,0,63000,315000,252000
01SCS19E260350,BSC.AR-SC0002,00ARSC0017,S,1,52000,155000,0,0,0,0,0,31000,155000,124000
01SCS19E260351,BSC.AR-SB0006,00ARSB0071,M,1,44000,135000,0,0,0,0,0,27000,135000,108000
01SCS19E260352,BSC.AR-SD0051,00ARSD0254,S,1,44000,159000,0,0,0,0,0,31800,159000,127200
01SCS19E260352,ESH.AR-RK0013,00ARRK0130,M,1,44500,135000,0,0,0,0,0,27000,135000,108000
01SCS19E260353,AR.ESB-SD006,20ARSD0118,L,1,204750,315000,2,0,63000,1,0,63000,252000,189000
01SCS19E260354,AR.TUC-SD011,20ARSD0463,L,1,94250,145000,2,0,29000,1,0,29000,116000,87000
01SCS19E260355,ESH.AR-SE0005,00ARSE0017,S,1,44500,135000,0,0,0,0,0,27000,135000,108000
01SCS19E260355,ESH.AR-SE0025,00ARSE0247,S,1,44500,135000,0,0,0,0,0,27000,135000,108000
01SCS19E260356,AR.YD-SD002,20ARSD0265,M,1,87750,135000,2,0,67500,1,0,16875,67500,50625
01SCS19E260357,AR.MPR-SE019,20ARSE0203,ALL,1,97500,150000,2,0,45000,1,0,26250,105000,78750
01SCS19E260358,AR.PUB-SE021,20ARSE0081,L,1,159250,245000,2,0,49000,1,0,49000,196000,147000
01SCS19E260359,AR.TUC-SE025,20ARSE0660,30,1,204750,315000,2,0,63000,1,0,63000,252000,189000
01SCS19E260360,BSC.AR-RK0019,00ARRK0121,S,1,43000,135000,0,0,0,0,0,27000,135000,108000
01SCS19E260360,BSC.AR-SE0014,00ARSE0180,M,1,44000,159000,0,0,0,0,0,31800,159000,127200
01SCS19E260361,BSC.AR-SC0007,00ARSC0044,L,1,44000,135000,0,0,0,0,0,27000,135000,108000
01SCS19E260362,BSC.AR-SD0007,00ARSD0026,M,1,44500,159000,0,0,0,0,0,31800,159000,127200
01SCS19E260363,BSC.AR-SC0006,00ARSC0039,M,1,44000,135000,0,0,0,0,0,27000,135000,108000
01SCS19E260363,BSC.AR-SE0031,00ARSE0293,L,1,52000,155000,0,0,0,0,0,31000,155000,124000
01SCS19E260364,AR.ESB-SC019,20ARSC0468,ALL,1,68250,105000,2,0,52500,1,0,13125,52500,39375
01SCS19E260364,DKS.AR-SE0010,00ARSE0167,32,1,417272,696000,0,0,0,0,0,104400,696000,591600
01SCS19E260365,BSC.AR-SA0023,00ARSA0114,NON,1,47500,140000,0,0,0,0,0,28000,140000,112000
01SCS19E260366,ESH.AR-SB0003,00ARSB0007,S,1,44000,135000,0,0,0,0,0,27000,135000,108000
01SCS19E260366,ESH.AR-SD0011,00ARSD0073,S,1,125000,315000,0,0,0,0,0,63000,315000,252000
01SCS19E260367,BE.RAK-SC026,00BESC0102,M,1,201500,310000,2,0,62000,1,0,62000,248000,186000
01SCS19E260368,AR.STY-RL001,20ARRL0392,ALL,1,61750,95000,2,0,19000,1,0,19000,76000,57000
01SCS19E260368,BSC.AR-SA0005,00ARSA0023,M,1,94500,135000,0,0,0,0,0,27000,135000,108000
01SCS19E260368,BSC.AR-SB0020,00ARSB0167,S,1,44000,135000,0,0,0,0,0,27000,135000,108000
01SCS19E260369,AR.MPR-SB002,20ARSB0239,M,1,243750,375000,2,0,75000,1,0,75000,300000,225000
01SCS19E260370,ESH.AR-RL0018,00ARRL0148,34,1,122500,175000,0,0,0,0,0,35000,175000,140000
01SCS19E260371,AR.PUB-SE003,20ARSE0012,XL,1,97500,150000,2,0,30000,1,0,30000,120000,90000
01SCS19E260371,ESH.AR-SE0012,00ARSE0047,L,1,44500,135000,0,0,0,0,0,27000,135000,108000
01SCS19E260371,ESH.AR-SE0029,00ARSE0265,L,1,44500,135000,0,0,0,0,0,27000,135000,108000
01SCS19E260371,ESH.AR-SE0038,00ARSE0334,L,1,44500,135000,0,0,0,0,0,27000,135000,108000
01SCS19E260372,AR.BPH-RH021,20ARRH0394,S,1,208000,320000,2,0,160000,1,0,40000,160000,120000
01SCS19E260373,AR.REC-SD023,20ARSD0070,L,1,224250,345000,2,0,103500,1,0,60375,241500,181125
01SCS19E260374,AR.MPR-SE026,20ARSE0223,M,1,230750,355000,2,0,71000,1,0,71000,284000,213000
01SCS19E260375,BSC.AR-SC0015,00ARSC0102,L,1,44000,159000,0,0,0,0,0,31800,159000,127200
01SCS19E260376,BSC.AR-SD0063,00ARSD0338,NON,1,60000,180000,0,0,0,0,0,36000,180000,144000
01SCS19E260377,ESH.AR-SE0003,00ARSE0010,M,1,44500,135000,0,0,0,0,0,27000,135000,108000
01SCS19E260378,BSC.AR-SC0034,00ARSC0229,M,1,125000,315000,0,0,0,0,0,63000,315000,252000
01SCS19E260379,AR.TUC-SE025,20ARSE0660,30,1,204750,315000,2,0,63000,1,0,63000,252000,189000
01SCS19E260380,AR.PUB-SE001,20ARSE0003,L,1,97500,150000,2,0,30000,1,0,30000,120000,90000
01SCS19E260381,BSC.AR-SA0008,00ARSA0034,NON,1,47500,140000,0,0,0,0,0,28000,140000,112000
01SCS19E260381,BSC.AR-SA0017,00ARSA0051,S,1,125000,315000,0,0,0,0,0,63000,315000,252000
01SCS19E260382,ESH.AR-RJ0008,00ARRJ0041,L,1,44500,135000,0,0,0,0,0,27000,135000,108000
01SCS19E260382,ESH.AR-SE0009,00ARSE0035,L,1,44500,135000,0,0,0,0,0,27000,135000,108000
01SCS19E260383,AR.ESB-SE006,20ARSE0260,L,1,94250,145000,2,0,29000,1,0,29000,116000,87000
01SCS19E260384,AR.PUB-SE025,20ARSE0098,XL,1,159250,245000,2,0,49000,1,0,49000,196000,147000
01SCS19E260385,AR.PCT-SE013,20ARSE0675,L,1,87750,135000,2,0,27000,1,0,27000,108000,81000
01SCS19E260385,AR.TUC-RI011,20ARRI0368,L,1,87750,135000,2,0,27000,1,0,27000,108000,81000
01SCS19E260386,ESH.AR-SC0021,00ARSC0158,M,1,44000,135000,0,0,0,0,0,27000,135000,108000
01SCS19E260387,AR.TUC-SB002,20ARSB0028,M,1,204750,315000,2,0,63000,1,0,63000,252000,189000
01SCS19E260388,ESH.AR-SE0009,00ARSE0035,L,1,44500,135000,0,0,0,0,0,27000,135000,108000
01SCS19E260389,BSC.AR-SE0001,00ARSE0058,M,1,44500,159000,0,0,0,0,0,31800,159000,127200
01SCS19E260390,ESH.AR-SC0007,00ARSC0061,M,1,125000,350000,0,0,0,0,0,70000,350000,280000
01SCS19E260391,AR.ESB-SB003,20ARSB0102,L,1,100750,155000,2,0,31000,1,0,31000,124000,93000
01SCS19E260391,BE.RAK-SC039,00BESC0170,XL,1,91000,140000,2,0,28000,1,0,28000,112000,84000
01SCS19E260392,ESH.AR-SA0015,00ARSA0109,S,1,122500,350000,0,0,0,0,0,70000,350000,280000
01SCS19E260393,AR.MPR-SE031,20ARSE0295,S,1,230750,355000,2,0,71000,1,0,71000,284000,213000
01SCS19E260393,AR.PCT-SE012,20ARSE0672,M,1,87750,135000,2,0,27000,1,0,27000,108000,81000
01SCS19E260393,AR.PUB-SD016,20ARSD0130,M,1,97500,150000,2,0,30000,1,0,30000,120000,90000
01SCS19E260394,BSC.AR-RL0018,00ARRL0110,M,1,125000,315000,0,0,0,0,0,63000,315000,252000
01SCS19E260395,AR.ESB-RE008,20ARRE0358,M,1,94250,145000,2,0,72500,1,0,18125,72500,54375
01SCS19E260395,AR.MKV-PL011,20ARPL0430,S,1,91000,140000,2,0,70000,1,0,17500,70000,52500
01SCS19E260396,AR.REC-SD029,20ARSD0076,ALL,1,32500,50000,2,0,15000,1,0,8750,35000,26250
01SCS19E260397,BSC.AR-RI0011,00ARRI0038,S,1,43000,135000,0,0,0,0,0,27000,135000,108000
01SCS19E260398,AR.MKV-SA007,20ARSA0199,28,1,243750,375000,0,0,0,0,0,131250,375000,243750
01SCS19E260399,BE.RAK-RX328,00BERX1169,L,1,91000,140000,2,0,28000,1,0,28000,112000,84000
01SCS19E260400,BSC.AR-RK0019,00ARRK0121,S,1,43000,135000,0,0,0,0,0,27000,135000,108000
01SCS19E260400,BSC.AR-SB0004,00ARSB0048,M,1,44000,135000,0,0,0,0,0,27000,135000,108000
01SCS19E260401,AR.MPR-SE006,20ARSE0158,M,1,97500,150000,2,0,45000,1,0,26250,105000,78750
01SCS19E260402,AR.MPR-SE010,20ARSE0175,L,1,97500,150000,2,0,45000,1,0,26250,105000,78750
01SCS19E260403,BSC.AR-SE0033,00ARSE0315,28,1,125400,365000,0,0,0,0,0,73000,365000,292000
01SCS19E260404,AR.MPR-SE031,20ARSE0296,M,1,230750,355000,2,0,71000,1,0,71000,284000,213000
01SCS19E260405,BSC.AR-SD0047,00ARSD0247,NON,1,68000,220000,0,0,0,0,0,44000,220000,176000
01SCS19E260406,AR.MKV-SE012,20ARSE0525,ALL,1,107250,165000,0,0,0,0,0,57750,165000,107250
01SCS19E260406,ARN.AR-SB0002,00ARSB0087,NON,1,149400,249000,0,0,0,0,0,74700,249000,174300
01SCS19E260406,BSC.AR-RI0038,00ARRI0216,L,1,262500,375000,0,0,0,0,0,75000,375000,300000
01SCS19E260406,BSC.AR-SC0012,00ARSC0075,XL,1,44000,159000,0,0,0,0,0,31800,159000,127200
01SCS19E260407,AR.PUB-SA007,20ARSA0323,L,1,97500,150000,2,0,30000,1,0,30000,120000,90000
01SCS19E260408,BSC.AR-SA0005,00ARSA0022,S,1,44000,135000,0,0,0,0,0,27000,135000,108000
01SCS19E260409,AR.MPR-SE019,20ARSE0203,ALL,1,97500,150000,2,0,45000,1,0,26250,105000,78750
01SCS19E260410,AR.CPT-RI004,20ARRI0055,XL,1,94250,145000,2,0,29000,1,0,29000,116000,87000
01SCS19E260410,AR.RDC-RK007,20ARRK0481,XXL,1,97500,150000,2,0,30000,1,0,30000,120000,90000
01SCS19E260411,BSC.AR-RJ0016,00ARRJ0101,L,1,43000,135000,0,0,0,0,0,27000,135000,108000
01SCS19E260412,AR.MER-RC006,20ARSE0691,ALL,1,32500,50000,2,0,15000,1,0,8750,35000,26250
01SCS19E260413,AR.MPR-SE001,20ARSE0138,M,1,97500,150000,2,0,45000,1,0,26250,105000,78750
01SCS19E260414,ESH.AR-SE0005,00ARSE0017,S,1,44500,135000,0,0,0,0,0,27000,135000,108000
01SCS19E260415,ESH.AR-SB0010,00ARSB0042,XL,1,44500,135000,0,0,0,0,0,27000,135000,108000
01SCS19E260416,AR.TUC-SB008,20ARSB0036,ALL,1,61750,95000,2,0,19000,1,0,19000,76000,57000
01SCS19E260417,AR.PCT-SE011,20ARSE0670,M,1,211250,325000,2,0,65000,1,0,65000,260000,195000
01SCS19E260418,AR.PCT-SE019,20ARSE0686,M,1,87750,135000,2,0,27000,1,0,27000,108000,81000
01SCS19E260418,AR.TUC-SB019,20ARSB0482,L,1,87750,135000,2,0,27000,1,0,27000,108000,81000
01SCS19E260418,ESH.AR-SB0033,00ARSB0214,L,1,44500,135000,0,0,0,0,0,27000,135000,108000
01SCS19E260419,BE.RAK-SB041,00BESB0121,XL,1,94250,145000,2,0,29000,1,0,29000,116000,87000
01SCS19E260420,BE.RAK-SA017,00BESA0063,L,1,91000,140000,2,0,28000,1,0,28000,112000,84000
01SCS19E260421,BSC.AR-RJ0009,00ARRJ0073,L,1,94500,135000,0,0,0,0,0,27000,135000,108000
01SCS19E260422,AR.MPR-SE008,20ARSE0167,L,1,97500,150000,2,0,45000,1,0,26250,105000,78750
01SCS19E260423,BSC.AR-SD0027,00ARSD0158,L,1,125000,315000,0,0,0,0,0,63000,315000,252000
01SCS19E260423,BSC.AR-SD0046,00ARSD0244,M,1,44500,159000,0,0,0,0,0,31800,159000,127200
01SCS19E260424,AR.PUB-RL028,20ARRL0436,ALL,1,97500,150000,2,0,30000,1,0,30000,120000,90000
01SCS19E260425,AR.PUB-SA006,20ARSA0320,XL,1,97500,150000,2,0,30000,1,0,30000,120000,90000
01SCS19E260425,AR.PUB-SB037,20ARSB0468,ALL,1,81250,125000,2,0,25000,1,0,25000,100000,75000
01SCS19E260426,ESH.AR-SA0010,00ARSA0091,NON,1,53000,155000,0,0,0,0,0,31000,155000,124000
01SCS19E260427,AR.MKV-SE017,20ARSE0601,L,1,97500,150000,0,0,0,0,0,52500,150000,97500
01SCS19E260428,ESH.AR-SA0012,00ARSA0094,M,1,44000,135000,0,0,0,0,0,27000,135000,108000
01SCS19E260429,ESH.AR-RJ0001,00ARRJ0012,M,1,44500,135000,0,0,0,0,0,27000,135000,108000
01SCS19E260429,ESH.AR-SB0031,00ARSB0205,M,1,44500,135000,0,0,0,0,0,27000,135000,108000
01SCS19E260430,AR.STY-SE007,20ARSE0125,ALL,1,55250,85000,2,0,17000,1,0,17000,68000,51000
01SCS19E260431,BSC.AR-SD0059,00ARSD0331,NON,1,45000,140000,0,0,0,0,0,28000,140000,112000
01SCS19E260432,AR.MKV-RC024,20ARRC0596,ALL,1,78000,120000,0,0,0,0,0,42000,120000,78000
01SCS19E260433,AR.HLW-SE004,20ARSE0533,L,1,100750,155000,2,0,31000,1,0,31000,124000,93000
01SCS19E260433,ESH.AR-SD0040,00ARSD0367,M,1,122500,350000,0,0,0,0,0,70000,350000,280000
01SCS19E260434,AR.PCT-SE020,20ARSE0689,L,1,87750,135000,2,0,27000,1,0,27000,108000,81000
01SCS19E260434,AR.TUC-SA018,20ARSA0047,L,1,204750,315000,2,0,63000,1,0,63000,252000,189000
01SCS19E260435,ESH.AR-SA0007,00ARSA0076,M,1,44000,135000,0,0,0,0,0,27000,135000,108000
01SCS19E260436,AR.MPR-SE023,20ARSE0210,S,1,230750,355000,2,0,71000,1,0,71000,284000,213000
01SCS19E260437,AR.MPR-SE037,20ARSE0313,ALL,1,130000,200000,2,0,40000,1,0,40000,160000,120000
01SCS19E260438,AR.ESB-SC014,20ARSC0442,L,1,97500,150000,2,0,30000,1,0,30000,120000,90000
01SCS19E260439,AR.PUB-SE012,20ARSE0048,XL,1,97500,150000,2,0,30000,1,0,30000,120000,90000
01SCS19E260440,ESH.AR-RK0010,00ARRK0042,M,1,44500,135000,0,0,0,0,0,27000,135000,108000
01SCS19E260440,ESH.AR-SD0026,00ARSD0266,S,1,44500,135000,0,0,0,0,0,27000,135000,108000
01SCS19E260441,AR.MKV-SA006,20ARSA0197,32,1,243750,375000,0,0,0,0,0,131250,375000,243750
01SCS19E260442,BSC.AR-SC0002,00ARSC0017,S,1,52000,155000,0,0,0,0,0,31000,155000,124000
01SCS19E260443,AR.ESB-RL012,20ARRL0463,ALL,1,91000,140000,2,0,70000,1,0,17500,70000,52500
01SCS19E260444,AR.HLW-SC004,20ARSC0128,L,1,195000,300000,2,0,90000,1,0,52500,210000,157500
01SCS19E260445,AR.TUC-RL015,20ARRL0339,ALL,1,87750,135000,2,0,27000,1,0,27000,108000,81000
01SCS19E260446,BSC.AR-SA0017,00ARSA0051,S,1,125000,315000,0,0,0,0,0,63000,315000,252000
01SCS19E260447,AR.MKV-SE015,20ARSE0591,S,1,22750,350000,0,0,0,0,0,122500,350000,227500
01SCS19E260448,AR.ESB-SC020,20ARSC0469,ALL,1,68250,105000,2,0,52500,1,0,13125,52500,39375
01SCS19E260449,AR.MKV-SE009,20ARSE0510,30,1,227500,350000,0,0,0,0,0,122500,350000,227500
01SCS19E260450,AR.MPR-SE003,20ARSE0147,L,1,97500,150000,2,0,45000,1,0,26250,105000,78750
01SCS19E260451,BE.RAK-RX208,00BERX0562,XL,1,161850,249000,2,0,49800,1,0,49800,199200,149400
01SCS19E260451,ESH.AR-SC0018,00ARSC0146,L,1,44000,135000,0,0,0,0,0,27000,135000,108000
01SCS19E260452,AR.CPT-SC008,20ARSC0268,S,1,94250,145000,2,0,29000,1,0,29000,116000,87000
01SCS19E260453,BE.RAK-SA026,00BESA0107,M,1,91000,140000,2,0,28000,1,0,28000,112000,84000
01SCS19E260454,AR.ESB-RK002,20ARRK0228,M,1,198250,305000,2,0,61000,1,0,61000,244000,183000
01SCS19E260455,AR.MKV-RJ002,20ARRJ0146,M,1,91000,140000,0,0,0,0,0,49000,140000,91000
01SCS19E260456,AR.CLB-SB001,20ARSB0172,ALL,1,185250,285000,2,0,57000,1,0,57000,228000,171000
01SCS19E260457,AR.ESB-RE044,20ARRE0806,M,1,94250,145000,2,0,72500,1,0,18125,72500,54375
01SCS19E260458,AR.MKV-RL004,20ARRL0247,M,1,253500,390000,0,0,0,0,0,136500,390000,253500
01SCS19E260459,AR.PCT-RE006,20ARRE0623,L,1,87750,135000,2,0,67500,1,0,16875,67500,50625
01SCS19E260459,ESH.AR-SD0028,00ARSD0275,M,1,44500,135000,0,0,0,0,0,27000,135000,108000
01SCS19E260460,AR.TUC-SE010,20ARSE0401,L,1,94250,145000,2,0,29000,1,0,29000,116000,87000
01SCS19E260461,ESH.AR-SD0011,00ARSD0074,M,1,125000,315000,0,0,0,0,0,63000,315000,252000
01SCS19E260462,ESH.AR-SC0005,00ARSC0027,M,1,125000,315000,0,0,0,0,0,63000,315000,252000
01SCS19E260463,BSC.AR-SD0041,00ARSD0223,S,1,44500,159000,0,0,0,0,0,31800,159000,127200
01SCS19E260464,BSC.AR-SD0047,00ARSD0247,NON,1,68000,220000,0,0,0,0,0,44000,220000,176000
01SCS19E260465,AR.TUC-SE002,20ARSE0288,ALL,1,159250,245000,2,0,49000,1,0,49000,196000,147000
01SCS19E260466,AR.TUC-RK015,20ARRK0111,ALL,1,87750,135000,2,0,27000,1,0,27000,108000,81000
01SCS19E260466,ARN.AR-RK0001,00ARRK0220,L,1,43000,140000,0,0,0,0,0,42000,140000,98000
01SCS19E260467,AR.MPR-SE004,20ARSE0152,XL,1,97500,150000,2,0,45000,1,0,26250,105000,78750
01SCS19E260467,ESH.AR-RK0011,00ARRK0047,L,1,94500,135000,0,0,0,0,0,27000,135000,108000
01SCS19E260468,BSC.AR-SD0012,00ARSD0105,NON,1,18000,75000,0,0,0,0,0,15000,75000,60000
01SCS19E260468,BSC.AR-SD0030,00ARSD0175,M,1,44500,159000,0,0,0,0,0,31800,159000,127200
01SCS19E260469,ESH.AR-SE0005,00ARSE0018,M,1,44500,135000,0,0,0,0,0,27000,135000,108000
01SCS19E260470,ESH.AR-SD0040,00ARSD0368,L,1,122500,350000,0,0,0,0,0,70000,350000,280000
01SCS19E260471,BSC.AR-RL0020,00ARRL0118,M,1,125000,315000,0,0,0,0,0,63000,315000,252000
01SCS19E260472,AR.FHL-RJ002,20ARRJ0423,XL,1,91000,140000,2,0,28000,1,0,28000,112000,84000
01SCS19E260473,ESH.AR-SE0031,00ARSE0272,M,1,125000,315000,0,0,0,0,0,63000,315000,252000
01SCS19E260474,AR.PUB-SE014,20ARSE0053,S,1,159250,245000,2,0,49000,1,0,49000,196000,147000
01SCS19E260474,AR.YRX-RH004,20ARRH0721,ALL,1,172250,265000,2,0,53000,1,0,53000,212000,159000
01SCS19E260474,BSC.AR-SA0022,00ARSA0113,NON,1,47500,140000,0,0,0,0,0,28000,140000,112000
01SCS19E260474,BSC.AR-SB0005,00ARSB0061,NON,1,47500,140000,0,0,0,0,0,28000,140000,112000
01SCS19E260475,ESH.AR-SD0026,00ARSD0266,S,1,44500,135000,0,0,0,0,0,27000,135000,108000
01SCS19E260476,ESH.AR-SB0030,00ARSB0201,M,1,44000,135000,0,0,0,0,0,27000,135000,108000
01SCS19E260477,AR.ESB-SC017,20ARSC0461,M,1,91000,140000,2,0,28000,1,0,28000,112000,84000
01SCS19E260478,AR.REC-SD004,20ARSD0014,M,1,107250,165000,2,0,49500,1,0,28875,115500,86625
01SCS19E260479,ESH.AR-SD0028,00ARSD0275,M,1,44500,135000,0,0,0,0,0,27000,135000,108000
01SCS19E260480,ESH.AR-SB0022,00ARSB0125,L,1,44000,135000,0,0,0,0,0,27000,135000,108000
01SCS19E260481,AR.GTW-SC002,20ARSC0025,S,1,97500,150000,2,0,45000,1,0,26250,105000,78750
01SCS19E260481,AR.SMD-SE002,20ARSE0436,S,1,97500,150000,2,0,30000,1,0,30000,120000,90000
01SCS19E260482,AR.CPT-SD007,20ARSD0438,M,1,204750,315000,2,0,63000,1,0,63000,252000,189000
01SCS19E260483,AR.ESB-SD014,20ARSD0329,S,1,91000,140000,2,0,28000,1,0,28000,112000,84000
01SCS19E260483,AR.PCT-SE013,20ARSE0675,L,1,87750,135000,2,0,27000,1,0,27000,108000,81000
01SCS19E260484,ESH.AR-SD0026,00ARSD0267,M,1,44500,135000,0,0,0,0,0,27000,135000,108000
01SCS19E260485,AR.TUC-RI012,20ARRI0372,L,1,87750,135000,2,0,27000,1,0,27000,108000,81000
01SCS19E260486,AR.MPR-SE025,20ARSE0218,S,1,230750,355000,2,0,71000,1,0,71000,284000,213000
01SCS19E260487,AR.PUB-SB027,20ARSB0142,L,1,97500,150000,2,0,30000,1,0,30000,120000,90000
01SCS19E260488,BSC.AR-SE0037,00ARSE0346,S,1,44000,159000,0,0,0,0,0,31800,159000,127200
01SCS19E260489,AR.ESB-SC005,20ARSC0428,L,1,94250,145000,2,0,29000,1,0,29000,116000,87000
01SCS19E260490,BSC.AR-SC0017,00ARSC0119,XL,1,44500,135000,0,0,0,0,0,27000,135000,108000
01SCS19E260491,AR.REC-SD033,20ARSD0080,ALL,1,32500,50000,2,0,15000,1,0,8750,35000,26250
01SCS19E260492,BSC.AR-SE0034,00ARSE0323,XL,1,124000,370000,0,0,0,0,0,74000,370000,296000
01SCS19E260493,ESH.AR-SC0005,00ARSC0026,S,1,125000,315000,0,0,0,0,0,63000,315000,252000
01SCS19E260494,BSC.AR-RK0009,00ARRK0082,M,1,52000,155000,0,0,0,0,0,31000,155000,124000
01SCS19E260494,ESH.AR-SD0024,00ARSD0258,S,1,44500,135000,0,0,0,0,0,27000,135000,108000
01SCS19E260495,AR.SMD-RI002,20ARRI0223,S,1,87750,135000,2,0,40500,1,0,23625,94500,70875
01SCS19E260495,ESH.AR-SD0019,00ARSD0141,M,1,125000,315000,0,0,0,0,0,63000,315000,252000
01SCS19E260496,AR.PUB-SB027,20ARSB0142,L,1,97500,150000,2,0,30000,1,0,30000,120000,90000
01SCS19E260496,BSC.AR-SD0009,00ARSD0100,M,1,44000,159000,0,0,0,0,0,31800,159000,127200
01SCS19E260497,BSC.AR-SD0016,00ARSD0119,M,1,122000,375000,0,0,0,0,0,75000,375000,300000
01SCS19E260498,AR.MKV-SB001,20ARSB0002,M,1,227500,350000,0,0,0,0,0,122500,350000,227500
01SCS19E260498,AR.PUB-SE033,20ARSE0631,L,1,97500,150000,2,0,30000,1,0,30000,120000,90000
01SCS19E260499,SLT.AR-SB0016,00ARSB0180,M,1,200000,200000,0,0,0,0,0,40000,200000,160000
01SCS19E260500,ESH.AR-RK0014,00ARRK0188,M,1,112500,350000,0,0,0,0,0,70000,350000,280000
01SCS19E260501,AR.PUB-SD035,20ARSD0344,S,1,204750,315000,2,0,63000,1,0,63000,252000,189000
01SCS19E260502,AR.TUC-SB012,20ARSB0198,XL,1,204750,315000,2,0,63000,1,0,63000,252000,189000
01SCS19E260503,BSC.AR-SD0027,00ARSD0158,L,1,125000,315000,0,0,0,0,0,63000,315000,252000
01SCS19E260504,ESH.AR-SC0034,00ARSC0292,S,1,125000,315000,0,0,0,0,0,63000,315000,252000
01SCS19E260505,AR.FHL-SA004,20ARSA0085,ALL,1,87750,135000,2,0,27000,1,0,27000,108000,81000
01SCS19E260506,AR.HLW-SE016,20ARSE0563,ALL,1,87750,135000,2,0,27000,1,0,27000,108000,81000
01SCS19E260507,BSC.AR-RJ0002,00ARRJ0005,ALL,1,98000,140000,0,0,0,0,0,28000,140000,112000
01SCS19E260508,AR.PCT-SE018,20ARSE0684,M,1,87750,135000,2,0,27000,1,0,27000,108000,81000
01SCS19E260509,AR.TUC-RI012,20ARRI0371,M,1,87750,135000,2,0,27000,1,0,27000,108000,81000
01SCS19E260510,AR.STY-RK003,20ARRK0525,ALL,1,61750,95000,2,0,19000,1,0,19000,76000,57000
01SCS19E260511,BSC.AR-SD0058,00ARSD0294,NON,1,50000,150000,0,0,0,0,0,30000,150000,120000
01SCS19E260512,AR.TUC-SA005,20ARSA0020,XL,1,87750,135000,2,0,27000,1,0,27000,108000,81000
01SCS19E260513,AR.MKV-RJ002,20ARRJ0146,M,1,91000,140000,0,0,0,0,0,49000,140000,91000
01SCS19E260514,AR.KNR-RK001,20ARRK0252,M,1,136500,210000,2,0,63000,1,0,36750,147000,110250
01SCS19E260515,AR.MPR-SE030,20ARSE0291,S,1,230750,355000,2,0,71000,1,0,71000,284000,213000
01SCS19E260516,BE.RAK-SC021,00BESC0079,L,1,201500,310000,2,0,62000,1,0,62000,248000,186000
01SCS19E260517,AR.ESB-SC016,20ARSC0458,L,1,91000,140000,2,0,28000,1,0,28000,112000,84000
01SCS19E260517,ESH.AR-SC0032,00ARSC0282,L,1,44500,135000,0,0,0,0,0,27000,135000,108000
01SCS19E260518,DKS.AR-SE0010,00ARSE0166,30,1,417272,696000,0,0,0,0,0,104400,696000,591600
01SCS19E260519,BSC.AR-SE0007,00ARSE0081,S,1,44500,159000,0,0,0,0,0,31800,159000,127200
01SCS19E260520,BE.RAK-SC030,00BESC0123,L,1,211250,325000,2,0,65000,1,0,65000,260000,195000
01SCS19E260521,AR.PUB-SE034,20ARSE0633,L,1,191750,295000,2,0,59000,1,0,59000,236000,177000
01SCS19E260522,AR.ESB-SE011,20ARSE0280,L,1,227500,350000,2,0,70000,1,0,70000,280000,210000
01SCS19E260523,BSC.AR-SA0005,00ARSA0024,L,1,94500,135000,0,0,0,0,0,27000,135000,108000
01SCS19E260524,ESH.AR-SE0031,00ARSE0272,M,1,125000,315000,0,0,0,0,0,63000,315000,252000
01SCS19E260525,ESH.AR-RI0001,00ARRI0070,S,1,43000,135000,0,0,0,0,0,27000,135000,108000
01SCS19E260526,BSC.AR-SD0006,00ARSD0021,S,1,44000,159000,0,0,0,0,0,31800,159000,127200
01SCS19E260527,AR.HLW-SC003,20ARSC0125,L,1,208000,320000,2,0,96000,1,0,56000,224000,168000
01SCS19E260528,ESH.AR-SE0011,00ARSE0043,L,1,44500,135000,0,0,0,0,0,27000,135000,108000
01SCS19E260529,AR.CPT-RK011,20ARRK0033,ALL,1,48750,75000,2,0,15000,1,0,15000,60000,45000
01SCS19E260529,AR.ESB-RH010,20ARRH0471,ALL,1,91000,140000,2,0,70000,1,0,17500,70000,52500
01SCS19E260530,ESH.AR-SD0026,00ARSD0266,S,1,44500,135000,0,0,0,0,0,27000,135000,108000
01SCS19E260531,AR.SLS-SC019,20ARSC0323,S,1,212500,250000,0,0,0,0,0,37500,250000,212500
01SCS19E260531,AR.SLT-SB007,20ARSB0163,M,1,170000,200000,0,0,0,0,0,40000,200000,160000
01SCS19E260532,ESH.AR-RK0013,00ARRK0131,L,1,44500,135000,0,0,0,0,0,27000,135000,108000
01SCS19E260533,AR.PUB-SD035,20ARSD0344,S,1,204750,315000,2,0,63000,1,0,63000,252000,189000
01SCS19E260534,AR.ESB-SC015,20ARSC0443,M,1,87750,135000,2,0,27000,1,0,27000,108000,81000
01SCS19E260535,AR.TUC-SE005,20ARSE0381,L,1,204750,315000,2,0,63000,1,0,63000,252000,189000
01SCS19E260536,ESH.AR-SD0010,00ARSD0071,L,1,44500,135000,0,0,0,0,0,27000,135000,108000
01SCS19E260537,BSC.AR-SD0016,00ARSD0119,M,1,122000,375000,0,0,0,0,0,75000,375000,300000
01SCS19E260538,AR.MPR-SE031,20ARSE0296,M,1,230750,355000,2,0,71000,1,0,71000,284000,213000
01SCS19E260539,AR.MKV-SA006,20ARSA0197,32,1,243750,375000,0,0,0,0,0,131250,375000,243750
01SCS19E260540,BSC.AR-SB0013,00ARSB0106,S,1,44500,135000,0,0,0,0,0,27000,135000,108000
01SCS19E260541,ESH.AR-SE0036,00ARSE0326,L,1,44500,135000,0,0,0,0,0,27000,135000,108000
01SCS19E260542,AR.STY-SA002,20ARSA0061,ALL,1,61750,95000,2,0,19000,1,0,19000,76000,57000
01SCS19E260543,AR.BPH-RH033,20ARRH0812,XL,1,220350,339000,2,0,169500,1,0,42375,169500,127125
01SCS19E260543,AR.CLB-SE004,20ARSE0700,ALL,1,185250,285000,2,0,57000,1,0,57000,228000,171000
01SCS19E260543,AR.PUB-RI021,20ARRI0281,36,1,224250,345000,2,0,69000,1,0,69000,276000,207000
01SCS19E260544,BSC.AR-RE0012,00ARRE0102,NON,1,35000,110000,0,0,0,0,0,22000,110000,88000
01SCS19E260545,AR.FHL-SC001,20ARSC0328,L,1,91000,140000,2,0,28000,1,0,28000,112000,84000
01SCS19E260546,ESH.AR-SE0005,00ARSE0018,M,1,44500,135000,0,0,0,0,0,27000,135000,108000
01SCS19E260547,AR.SMD-SA003,20ARSA0227,S,1,87750,135000,2,0,27000,1,0,27000,108000,81000
01SCS19E260548,ESH.AR-SA0001,00ARSA0014,30,1,122500,175000,0,0,0,0,0,35000,175000,140000
01SCS19E260549,BSC.AR-SD0042,00ARSD0228,M,1,44500,159000,0,0,0,0,0,31800,159000,127200
01SCS19E260550,AR.ASH-RJ004,20ARSD0390,XL,1,91000,140000,2,0,42000,1,0,24500,98000,73500
01SCS19E260551,BSC.AR-SA0009,00ARSA0035,NON,1,47500,140000,0,0,0,0,0,28000,140000,112000
01SCS19E260552,AR.HLW-SC004,20ARSC0128,L,1,195000,300000,2,0,90000,1,0,52500,210000,157500
01SCS19E260553,AR.MPR-SE030,20ARSE0291,S,1,230750,355000,2,0,71000,1,0,71000,284000,213000
01SCS19E260554,AR.PUB-SE008,20ARSE0030,M,1,97500,150000,2,0,30000,1,0,30000,120000,90000
01SCS19E260555,AR.MKV-SD002,20ARSD0224,L,1,97500,150000,0,0,0,0,0,52500,150000,97500
01SCS19E260556,AR.TUC-RI012,20ARRI0371,M,1,87750,135000,2,0,27000,1,0,27000,108000,81000
01SCS19E260557,ESH.AR-RK0020,00ARRK0199,S,1,192500,275000,0,0,0,0,0,55000,275000,220000
01SCS19E260558,AR.FHL-SC001,20ARSC0328,L,1,91000,140000,2,0,28000,1,0,28000,112000,84000
01SCS19E260558,ARN.AR-SD0001,00ARSD0221,L,1,44500,150000,0,0,0,0,0,45000,150000,105000
01SCS19E270001,AR.CPT-SC014,20ARSC0490,XL,1,94250,145000,2,0,29000,1,0,29000,116000,87000
01SCS19E270001,AR.TUC-SE005,20ARSE0381,L,1,204750,315000,2,0,63000,1,0,63000,252000,189000
01SCS19E270002,AR.CPT-SB001,20ARSB0084,L,1,204750,315000,2,0,63000,1,0,63000,252000,189000
01SCS19E270003,AR.ASH-RK002,20ARRK0508,M,1,195000,300000,2,0,90000,1,0,52500,210000,157500
01SCS19E270004,AR.MKV-PL012,20ARPL0437,XL,1,91000,140000,2,0,70000,1,0,17500,70000,52500
01SCS19E270004,BSC.AR-SE0003,00ARSE0068,XL,1,44000,159000,0,0,0,0,0,31800,159000,127200
01SCS19E270005,BSC.AR-SA0009,00ARSA0035,NON,1,47500,140000,0,0,0,0,0,28000,140000,112000
01SCS19E270005,BSC.AR-SC0017,00ARSC0119,XL,1,44500,135000,0,0,0,0,0,27000,135000,108000
01SCS19E270005,BSC.AR-SD0002,00ARSD0006,M,1,44000,159000,0,0,0,0,0,31800,159000,127200
01SCS19E270005,BSC.AR-SD0022,00ARSD0130,L,1,44000,159000,0,0,0,0,0,31800,159000,127200
01SCS19E270006,ESH.AR-SE0017,00ARSE0115,L,1,44000,135000,0,0,0,0,0,27000,135000,108000
01SCS19E270007,AR.CPT-SB001,20ARSB0083,M,1,204750,315000,2,0,63000,1,0,63000,252000,189000
01SCS19E270008,ESH.AR-SE0001,00ARSE0004,XL,1,44000,135000,0,0,0,0,0,27000,135000,108000
01SCS19E270009,AR.PCT-SE007,20ARSE0349,L,1,87750,135000,2,0,27000,1,0,27000,108000,81000
01SCS19E270010,BSC.AR-SC0043,00ARSC0288,S,1,44000,135000,0,0,0,0,0,27000,135000,108000
01SCS19E270011,AR.MPR-SE004,20ARSE0152,XL,1,97500,150000,2,0,45000,1,0,26250,105000,78750
01SCS19E270011,ESH.AR-SE0037,00ARSE0331,XL,1,44000,135000,0,0,0,0,0,27000,135000,108000
01SCS19E270012,BSC.AR-SD0042,00ARSD0230,XL,1,44500,159000,0,0,0,0,0,31800,159000,127200
01SCS19E270013,AR.MPR-SE026,20ARSE0222,S,1,230750,355000,2,0,71000,1,0,71000,284000,213000
01SCS19E270014,AR.VLD-SB001,20ARSB0041,M,1,91000,140000,2,0,42000,1,0,24500,98000,73500
01SCS19E270015,AR.TUC-SE005,20ARSE0381,L,1,204750,315000,2,0,63000,1,0,63000,252000,189000
01SCS19E270016,BE.RAK-SA026,00BESA0109,XL,1,91000,140000,2,0,28000,1,0,28000,112000,84000
01SCS19E270017,AR.ESB-QE014,20ARQE0413,M,1,97500,150000,2,0,75000,1,0,18750,75000,56250
01SCS19E270017,AR.STY-SE009,20ARSE0127,ALL,1,55250,85000,2,0,17000,1,0,17000,68000,51000
01SCS19E270017,AR.VCS-RL005,20ARRL0309,L,1,97500,150000,2,0,45000,1,0,26250,105000,78750
01SCS19E270018,ESH.AR-RI0015,00ARRI0143,NON,1,98000,140000,0,0,0,0,0,28000,140000,112000
01SCS19E270019,AR.CPT-SE002,20ARSE0356,S,1,94250,145000,2,0,29000,1,0,29000,116000,87000
01SCS19E270020,AR.STY-RJ009,20ARRJ0112,ALL,1,61750,95000,2,0,19000,1,0,19000,76000,57000
01SCS19E270021,AR.MKV-SE015,20ARSE0592,M,1,22750,350000,0,0,0,0,0,122500,350000,227500
01SCS19E270022,AR.PUB-SB033,20ARSB0464,ALL,1,97500,150000,2,0,30000,1,0,30000,120000,90000
01SCS19E270023,AR.MKV-SA007,20ARSA0200,30,1,243750,375000,0,0,0,0,0,131250,375000,243750
01SCS19E270024,ESH.AR-SD0024,00ARSD0258,S,1,44500,135000,0,0,0,0,0,27000,135000,108000
01SCS19E270025,AR.SMD-SD011,20ARSD0316,32,1,211250,325000,2,0,65000,1,0,65000,260000,195000
01SCS19E270026,AR.TUC-SE005,20ARSE0381,L,1,204750,315000,2,0,63000,1,0,63000,252000,189000
01SCS19E270027,ESH.AR-SD0036,00ARSD0334,NON,1,50000,150000,0,0,0,0,0,30000,150000,120000
01SCS19E270028,ESH.AR-SB0021,00ARSB0121,L,1,44500,135000,0,0,0,0,0,27000,135000,108000
01SCS19E270029,AR.PCT-QE016,20ARQE0784,L,1,78000,120000,2,0,60000,1,0,15000,60000,45000
01SCS19E270030,AR.CLB-SE004,20ARSE0700,ALL,1,185250,285000,2,0,57000,1,0,57000,228000,171000
01SCS19E270031,ESH.AR-SD0031,00ARSD0300,M,1,44000,135000,0,0,0,0,0,27000,135000,108000
01SCS19E270032,BSC.AR-SD0043,00ARSD0233,L,1,44500,159000,0,0,0,0,0,31800,159000,127200
01SCS19E270033,BSC.AR-SC0019,00ARSC0128,S,1,44500,159000,0,0,0,0,0,31800,159000,127200
01SCS19E270034,AR.MPR-SE004,20ARSE0151,L,1,97500,150000,2,0,45000,1,0,26250,105000,78750
01SCS19E270034,ESH.AR-SE0036,00ARSE0326,L,1,44500,135000,0,0,0,0,0,27000,135000,108000
01SCS19E270035,AR.STY-SE012,20ARSE0578,ALL,1,55250,85000,2,0,17000,1,0,17000,68000,51000
01SCS19E270036,AR.MDG-SC004,20ARSC0452,ALL,1,97500,150000,2,0,45000,1,0,26250,105000,78750
01SCS19E270037,ESH.AR-SD0003,00ARSD0042,M,1,44000,135000,0,0,0,0,0,27000,135000,108000
01SCS19E270038,BSC.AR-SD0066,00ARSD0356,M,1,44500,159000,0,0,0,0,0,31800,159000,127200
01SCS19E270039,AR.MER-RH005,20ARRH0228,ALL,1,84500,130000,2,0,39000,1,0,22750,91000,68250
01SCS19E270040,AR.PUB-SB035,20ARSB0466,ALL,1,81250,125000,2,0,25000,1,0,25000,100000,75000
01SCS19E270041,AR.CPT-SE001,20ARSE0353,M,1,94250,145000,2,0,29000,1,0,29000,116000,87000
01SCS19E270041,AR.CPT-SE003,20ARSE0361,M,1,94250,145000,2,0,29000,1,0,29000,116000,87000
01SCS19E270042,AR.MDS-RL004,20ARRL0367,M,1,117000,180000,2,0,36000,1,0,36000,144000,108000
01SCS19E270043,BSC.AR-SD0063,00ARSD0338,NON,1,60000,180000,0,0,0,0,0,36000,180000,144000
01SCS19E270044,AR.MPR-SE001,20ARSE0138,M,1,97500,150000,2,0,45000,1,0,26250,105000,78750
01SCS19E270045,AR.CPT-RL008,20ARRL0098,S,1,94250,145000,2,0,29000,1,0,29000,116000,87000
01SCS19E270046,AR.MKV-SE006,20ARSE0494,28,1,165750,255000,0,0,0,0,0,89250,255000,165750
01SCS19E270046,AR.PUB-RG012,20ARRG0063,M,1,97500,150000,2,0,30000,1,0,30000,120000,90000
01SCS19E270047,AR.PUB-SB011,20ARSB0016,30,1,211250,325000,2,0,65000,1,0,65000,260000,195000
01SCS19E270048,AR.TUC-RK028,20ARRK0134,L,1,94250,145000,2,0,29000,1,0,29000,116000,87000
01SCS19E270048,ESH.AR-SD0002,00ARSD0037,S,1,44500,135000,0,0,0,0,0,27000,135000,108000
01SCS19E270049,ESH.AR-SE0003,00ARSE0010,M,1,44500,135000,0,0,0,0,0,27000,135000,108000
01SCS19E270050,ESH.AR-SB0010,00ARSB0039,S,1,44500,135000,0,0,0,0,0,27000,135000,108000
01SCS19E270051,AR.MDS-RL002,20ARRL0358,S,1,117000,180000,2,0,36000,1,0,36000,144000,108000
01SCS19E270051,AR.MER-RH003,20ARRH0226,ALL,1,84500,130000,2,0,39000,1,0,22750,91000,68250
01SCS19E270051,AR.MKV-SE007,20ARSE0500,30,1,165750,255000,0,0,0,0,0,89250,255000,165750
01SCS19E270052,AR.PUB-SE027,20ARSE0104,M,1,204750,315000,2,0,63000,1,0,63000,252000,189000
01SCS19E270052,BSC.AR-SC0049,00ARSC0308,S,1,44500,159000,0,0,0,0,0,31800,159000,127200
01SCS19E270052,BSC.AR-SE0006,00ARSE0077,S,1,44500,159000,0,0,0,0,0,31800,159000,127200
01SCS19E270052,ESH.AR-SE0019,00ARSE0121,S,1,44000,135000,0,0,0,0,0,27000,135000,108000
01SCS19E270053,ESH.AR-SB0006,00ARSB0023,S,1,44500,135000,0,0,0,0,0,27000,135000,108000
01SCS19E270053,ESH.AR-SD0026,00ARSD0266,S,1,44500,135000,0,0,0,0,0,27000,135000,108000
01SCS19E270054,ESH.AR-SD0011,00ARSD0074,M,1,125000,315000,0,0,0,0,0,63000,315000,252000
01SCS19E270055,AR.PUB-SD026,20ARSD0202,M,1,97500,150000,2,0,30000,1,0,30000,120000,90000
01SCS19E270056,AR.PUB-SB011,20ARSB0017,32,1,211250,325000,2,0,65000,1,0,65000,260000,195000
01SCS19E270057,AR.MKV-SE005,20ARSE0490,30,1,165750,255000,0,0,0,0,0,89250,255000,165750
01SCS19E270058,BSC.AR-SA0014,00ARSA0040,NON,1,47500,140000,0,0,0,0,0,28000,140000,112000
01SCS19E270059,AR.MPR-SE006,20ARSE0158,M,1,97500,150000,2,0,45000,1,0,26250,105000,78750
01SCS19E270059,AR.SMD-RE008,20ARRE1124,M,1,87750,135000,2,0,40500,1,0,23625,94500,70875
01SCS19E270059,ESH.AR-SD0003,00ARSD0041,S,1,44000,135000,0,0,0,0,0,27000,135000,108000
01SCS19E270060,AR.SMD-RH005,20ARRH0744,L,1,211250,325000,2,0,97500,1,0,56875,227500,170625
01SCS19E270060,AR.SMD-RI002,20ARRI0224,M,1,87750,135000,2,0,40500,1,0,23625,94500,70875
01SCS19E270061,AR.MKV-SC021,20ARSC0230,M,1,107250,165000,0,0,0,0,0,57750,165000,107250
01SCS19E270062,AR.STY-SE008,20ARSE0126,ALL,1,55250,85000,2,0,17000,1,0,17000,68000,51000
01SCS19E270062,AR.STY-SE009,20ARSE0127,ALL,1,55250,85000,2,0,17000,1,0,17000,68000,51000
01SCS19E270063,BSC.AR-SD0041,00ARSD0224,M,1,44500,159000,0,0,0,0,0,31800,159000,127200
01SCS19E270064,AR.KNR-RK004,20ARRK0263,L,1,136500,210000,2,0,63000,1,0,36750,147000,110250
01SCS19E270065,AR.REC-SD020,20ARSD0059,30,1,208000,320000,2,0,96000,1,0,56000,224000,168000
01SCS19E270066,AR.BPH-RB011,20ARRB0466,M,1,103350,159000,2,0,47700,1,0,27825,111300,83475
01SCS19E270067,AR.MKV-RC024,20ARRC0596,ALL,1,78000,120000,0,0,0,0,0,42000,120000,78000
01SCS19E270068,ESH.AR-SE0005,00ARSE0019,L,1,44500,135000,0,0,0,0,0,27000,135000,108000
01SCS19E270069,AR.MYA-RE005,20ARRE1307,30,1,207350,319000,2,0,159500,1,0,39875,159500,119625
01SCS19E270070,AR.PUB-SB022,20ARSB0122,L,1,97500,150000,2,0,30000,1,0,30000,120000,90000
01SCS19E270071,ESH.AR-SD0040,00ARSD0366,S,1,122500,350000,0,0,0,0,0,70000,350000,280000
01SCS19E270072,ESH.AR-SE0005,00ARSE0017,S,1,44500,135000,0,0,0,0,0,27000,135000,108000
01SCS19E270073,AR.MPR-SE027,20ARSE0227,M,1,243750,375000,2,0,75000,1,0,75000,300000,225000
01SCS19E270073,AR.SMD-SD012,20ARSD0566,M,1,87750,135000,2,0,27000,1,0,27000,108000,81000
01SCS19E270074,ESH.AR-SC0034,00ARSC0294,L,1,125000,315000,0,0,0,0,0,63000,315000,252000
01SCS19E270075,AR.YD-SD002,20ARSD0265,M,1,87750,135000,2,0,67500,1,0,16875,67500,50625
01SCS19E270075,BSC.AR-RJ0002,00ARRJ0005,ALL,1,98000,140000,0,0,0,0,0,28000,140000,112000
01SCS19E270075,BSC.AR-SD0002,00ARSD0006,M,1,44000,159000,0,0,0,0,0,31800,159000,127200
01SCS19E270076,ESH.AR-SB0022,00ARSB0125,L,1,44000,135000,0,0,0,0,0,27000,135000,108000
01SCS19E270077,ESH.AR-SD0041,00ARSD0371,M,1,125000,315000,0,0,0,0,0,63000,315000,252000
01SCS19E270078,AR.MKV-SE019,20ARSE0607,L,1,97500,150000,0,0,0,0,0,52500,150000,97500
01SCS19E270078,AR.PUB-SD026,20ARSD0202,M,1,97500,150000,2,0,30000,1,0,30000,120000,90000
01SCS19E270079,ESH.AR-SC0022,00ARSC0164,XL,1,125000,315000,0,0,0,0,0,63000,315000,252000
01SCS19E270079,ESH.AR-SD0027,00ARSD0273,XL,1,44000,135000,0,0,0,0,0,27000,135000,108000
01SCS19E270079,ESH.AR-SE0013,00ARSE0052,XL,1,44500,135000,0,0,0,0,0,27000,135000,108000
01SCS19E270079,ESH.AR-SE0027,00ARSE0258,XL,1,44500,135000,0,0,0,0,0,27000,135000,108000
01SCS19E270080,AR.YAS-RH009,20ARRH0862,L,1,122850,189000,2,0,37800,1,0,37800,151200,113400
01SCS19E270080,ESH.AR-SE0036,00ARSE0326,L,1,44500,135000,0,0,0,0,0,27000,135000,108000
01SCS19E270081,AR.SMD-SE008,20ARSE0468,41,1,97500,150000,2,0,30000,1,0,30000,120000,90000
01SCS19E270082,AR.PUB-SC017,20ARSC0370,L,1,204750,315000,2,0,63000,1,0,63000,252000,189000
01SCS19E270083,AR.BPH-RL003,20ARRL0190,L,1,291850,449000,2,0,224500,1,0,56125,224500,168375
01SCS19E270084,BSC.AR-SA0019,00ARSA0063,S,1,44000,135000,0,0,0,0,0,27000,135000,108000
01SCS19E270084,BSC.AR-SC0020,00ARSC0132,S,1,44000,159000,0,0,0,0,0,31800,159000,127200
01SCS19E270085,BE.RAK-RJ008,00BERJ0029,XL,1,94250,145000,2,0,29000,1,0,29000,116000,87000
01SCS19E270086,AR.MDS-RL002,20ARRL0358,S,1,117000,180000,2,0,36000,1,0,36000,144000,108000
01SCS19E270086,BSC.AR-SD0043,00ARSD0233,L,1,44500,159000,0,0,0,0,0,31800,159000,127200
01SCS19E270086,ESH.AR-RI0001,00ARRI0070,S,1,43000,135000,0,0,0,0,0,27000,135000,108000
01SCS19E270087,AR.MKV-SE011,20ARSE0520,30,1,227500,350000,0,0,0,0,0,122500,350000,227500
01SCS19E270088,AR.MKV-SE002,20ARSE0476,32,1,214500,330000,0,0,0,0,0,115500,330000,214500
01SCS19E270089,BSC.AR-SC0041,00ARSC0270,S,1,44000,159000,0,0,0,0,0,31800,159000,127200
01SCS19E270089,BSC.AR-SC0043,00ARSC0288,S,1,44000,135000,0,0,0,0,0,27000,135000,108000
01SCS19E270089,ESH.AR-RD0006,00ARRD0053,NON,1,37500,115000,0,0,0,0,0,23000,115000,92000
01SCS19E270089,ESH.AR-RI0001,00ARRI0070,S,1,43000,135000,0,0,0,0,0,27000,135000,108000
01SCS19E270089,ESH.AR-RJ0010,00ARRJ0047,S,1,94500,135000,0,0,0,0,0,27000,135000,108000
01SCS19E270089,ESH.AR-SB0003,00ARSB0007,S,1,44000,135000,0,0,0,0,0,27000,135000,108000
01SCS19E270090,AR.MPR-SE001,20ARSE0138,M,1,97500,150000,2,0,45000,1,0,26250,105000,78750
01SCS19E270090,BSC.AR-SD0066,00ARSD0355,S,1,44500,159000,0,0,0,0,0,31800,159000,127200
01SCS19E270091,ESH.AR-SE0005,00ARSE0017,S,1,44500,135000,0,0,0,0,0,27000,135000,108000
01SCS19E270092,BSC.AR-SA0021,00ARSA0106,M,1,44000,135000,0,0,0,0,0,27000,135000,108000
01SCS19E270092,ESH.AR-SA0013,00ARSA0098,M,1,44000,135000,0,0,0,0,0,27000,135000,108000
01SCS19E270093,AR.MDS-RL002,20ARRL0359,M,1,117000,180000,2,0,36000,1,0,36000,144000,108000
01SCS19E270093,AR.PUB-SD026,20ARSD0203,L,1,97500,150000,2,0,30000,1,0,30000,120000,90000
01SCS19E270094,BSC.AR-RL0019,00ARRL0115,L,1,125000,315000,0,0,0,0,0,63000,315000,252000
01SCS19E270095,AR.TUC-SD011,20ARSD0463,L,1,94250,145000,2,0,29000,1,0,29000,116000,87000
01SCS19E270096,AR.ASH-RK003,20ARRK0511,S,1,195000,300000,2,0,90000,1,0,52500,210000,157500
01SCS19E270097,BSC.AR-SD0004,00ARSD0014,M,1,44000,159000,0,0,0,0,0,31800,159000,127200
01SCS19E270098,AR.STY-SE009,20ARSE0127,ALL,1,55250,85000,2,0,17000,1,0,17000,68000,51000
01SCS19E270098,ESH.AR-SB0030,00ARSB0201,M,1,44000,135000,0,0,0,0,0,27000,135000,108000
01SCS19E270099,BSC.AR-SC0027,00ARSC0192,L,1,106400,350000,0,0,0,0,0,70000,350000,280000
01SCS19E270100,AR.ASH-RJ006,20ARRJ0268,M,1,91000,140000,2,0,42000,1,0,24500,98000,73500
01SCS19E270100,ESH.AR-SC0013,00ARSC0105,M,1,44500,135000,0,0,0,0,0,27000,135000,108000
01SCS19E270101,ESH.AR-SE0010,00ARSE0038,M,1,44000,135000,0,0,0,0,0,27000,135000,108000
01SCS19E270102,AR.STY-SA002,20ARSA0061,ALL,1,61750,95000,2,0,19000,1,0,19000,76000,57000
01SCS19E270103,AR.MKV-RG003,20ARRG0089,ALL,1,78000,120000,0,0,0,0,0,42000,120000,78000
01SCS19E270104,ESH.AR-RK0008,00ARRK0034,M,1,94500,135000,0,0,0,0,0,27000,135000,108000
01SCS19E270104,ESH.AR-SC0021,00ARSC0160,XL,1,44000,135000,0,0,0,0,0,27000,135000,108000
01SCS19E270105,ESH.AR-SD0027,00ARSD0270,S,1,44000,135000,0,0,0,0,0,27000,135000,108000
01SCS19E270106,ARN.AR-RK0005,00ARRK0234,28,1,110000,350000,0,0,0,0,0,105000,350000,245000
01SCS19E270107,AR.SMD-RL001,20ARRL0265,ALL,1,22750,35000,2,0,7000,1,0,7000,28000,21000
01SCS19E270108,AR.CPT-SD012,20ARSD0458,M,1,94250,145000,2,0,29000,1,0,29000,116000,87000
01SCS19E270109,BSC.AR-SC0043,00ARSC0289,M,1,44000,135000,0,0,0,0,0,27000,135000,108000
01SCS19E270109,BSC.AR-SD0002,00ARSD0006,M,1,44000,159000,0,0,0,0,0,31800,159000,127200
01SCS19E270110,AR.SMD-RI002,20ARRI0224,M,1,87750,135000,2,0,40500,1,0,23625,94500,70875
01SCS19E270111,AR.BPH-RH014,20ARRH0376,ALL,1,103350,159000,2,0,47700,1,0,27825,111300,83475
01SCS19E270111,AR.PUB-SE017,20ARSE0067,L,1,159250,245000,2,0,49000,1,0,49000,196000,147000
01SCS19E270111,BE.RAK-SC040,00BESC0175,XL,1,91000,140000,2,0,28000,1,0,28000,112000,84000
01SCS19E270112,AR.MPR-SE001,20ARSE0138,M,1,97500,150000,2,0,45000,1,0,26250,105000,78750
01SCS19E270113,ESH.AR-SB0023,00ARSB0135,NON,1,52800,185000,0,0,0,0,0,37000,185000,148000
01SCS19E270114,AR.BPH-RH020,20ARRH0390,S,1,182000,280000,2,0,140000,1,0,35000,140000,105000
01SCS19E270114,AR.BPH-SD002,20ARSD0363,L,1,182000,280000,2,0,140000,1,0,35000,140000,105000
01SCS19E270114,AR.ESB-SC003,20ARSC0420,L,1,91000,140000,2,0,28000,1,0,28000,112000,84000
01SCS19E270114,BSC.AR-SD0001,00ARSD0001,S,1,44000,159000,0,0,0,0,0,31800,159000,127200
01SCS19E270114,BSC.AR-SD0032,00ARSD0183,S,1,44500,159000,0,0,0,0,0,31800,159000,127200
01SCS19E270114,BSC.AR-SD0041,00ARSD0223,S,1,44500,159000,0,0,0,0,0,31800,159000,127200
01SCS19E270114,ESH.AR-RJ0011,00ARRJ0051,S,1,94500,135000,0,0,0,0,0,27000,135000,108000
01SCS19E270114,ESH.AR-SA0012,00ARSA0093,S,1,44000,135000,0,0,0,0,0,27000,135000,108000
01SCS19E270115,BSC.AR-SD0046,00ARSD0245,L,1,44500,159000,0,0,0,0,0,31800,159000,127200
01SCS19E270116,ESH.AR-SD0028,00ARSD0276,L,1,44500,135000,0,0,0,0,0,27000,135000,108000
01SCS19E270116,ESH.AR-SE0001,00ARSE0004,XL,1,44000,135000,0,0,0,0,0,27000,135000,108000
01SCS19E270117,BSC.AR-SD0030,00ARSD0176,L,1,44500,159000,0,0,0,0,0,31800,159000,127200
01SCS19E270117,ESH.AR-SD0010,00ARSD0071,L,1,44500,135000,0,0,0,0,0,27000,135000,108000
01SCS19E270118,BE.RAK-SD016,00BESD0078,L,1,91000,140000,2,0,28000,1,0,28000,112000,84000
01SCS19E270119,ESH.AR-SE0025,00ARSE0248,M,1,44500,135000,0,0,0,0,0,27000,135000,108000
01SCS19E270120,BSC.AR-SC0018,00ARSC0124,S,1,44500,159000,0,0,0,0,0,31800,159000,127200
01SCS19E270121,ESH.AR-SD0027,00ARSD0271,M,1,44000,135000,0,0,0,0,0,27000,135000,108000
01SCS19E270122,BSC.AR-SB0009,00ARSB0082,S,1,44500,135000,0,0,0,0,0,27000,135000,108000
01SCS19E270123,BSC.AR-SD0038,00ARSD0208,M,1,125000,315000,0,0,0,0,0,63000,315000,252000
01SCS19E270123,BSC.AR-SD0056,00ARSD0290,M,1,125000,315000,0,0,0,0,0,63000,315000,252000
01SCS19E270124,AR.TUC-SA005,20ARSA0019,L,1,87750,135000,2,0,27000,1,0,27000,108000,81000
01SCS19E270125,AR.PUB-SE021,20ARSE0082,XL,1,159250,245000,2,0,49000,1,0,49000,196000,147000
01SCS19E270126,ESH.AR-SD0002,00ARSD0040,XL,1,44500,135000,0,0,0,0,0,27000,135000,108000
01SCS19E270126,ESH.AR-SE0003,00ARSE0012,XL,1,44500,135000,0,0,0,0,0,27000,135000,108000
01SCS19E270127,AR.STY-RJ009,20ARRJ0112,ALL,1,61750,95000,2,0,19000,1,0,19000,76000,57000
01SCS19E270128,BE.RAK-RJ009,00BERJ0033,L,1,94250,145000,2,0,29000,1,0,29000,116000,87000
01SCS19E270129,ESH.AR-SB0015,00ARSB0062,S,1,125000,315000,0,0,0,0,0,63000,315000,252000
01SCS19E270130,ESH.AR-SE0005,00ARSE0018,M,1,44500,135000,0,0,0,0,0,27000,135000,108000
01SCS19E270131,BSC.AR-SC0032,00ARSC0221,32,1,135000,375000,0,0,0,0,0,75000,375000,300000
01SCS19E270131,ESH.AR-SD0012,00ARSD0078,32,1,145000,375000,0,0,0,0,0,75000,375000,300000
01SCS19E270132,BSC.AR-RI0020,00ARRI0111,M,1,108500,155000,0,0,0,0,0,31000,155000,124000
01SCS19E270133,BSC.AR-SE0007,00ARSE0081,S,1,44500,159000,0,0,0,0,0,31800,159000,127200
01SCS19E270134,BE.RAK-SA022,00BESA0089,XL,1,91000,140000,2,0,28000,1,0,28000,112000,84000
01SCS19E270135,AR.SMD-RJ001,20ARRJ0456,M,1,87750,135000,2,0,27000,1,0,27000,108000,81000
01SCS19E270136,AR.RDC-RK008,20ARRK0484,L,1,97500,150000,2,0,30000,1,0,30000,120000,90000
01SCS19E270137,ESH.AR-SD0025,00ARSD0262,S,1,44000,135000,0,0,0,0,0,27000,135000,108000
01SCS19E270138,ESH.AR-SE0003,00ARSE0010,M,1,44500,135000,0,0,0,0,0,27000,135000,108000
01SCS19E270139,BSC.AR-SD0042,00ARSD0228,M,1,44500,159000,0,0,0,0,0,31800,159000,127200
01SCS19E270140,BSC.AR-SE0003,00ARSE0066,M,1,44000,159000,0,0,0,0,0,31800,159000,127200
01SCS19E270141,AR.SMD-SE002,20ARSE0436,S,1,97500,150000,2,0,30000,1,0,30000,120000,90000
01SCS19E270142,AR.STY-SE002,20ARSE0120,ALL,1,55250,85000,2,0,17000,1,0,17000,68000,51000
01SCS19E270143,AR.FHL-SA003,20ARSA0084,ALL,1,87750,135000,2,0,27000,1,0,27000,108000,81000
01SCS19E270143,BE.RAK-SC006,00BESC0015,ALL,1,42250,65000,2,0,13000,1,0,13000,52000,39000
01SCS19E270144,AR.PUB-SC005,20ARSC0115,ALL,1,48750,75000,2,0,15000,1,0,15000,60000,45000
01SCS19E270144,AR.STY-RK003,20ARRK0525,ALL,1,61750,95000,2,0,19000,1,0,19000,76000,57000
01SCS19E270145,AR.YAS-SE012,20ARSE0741,S,1,122850,189000,2,0,37800,1,0,37800,151200,113400
01SCS19E270145,BSC.AR-SB0011,00ARSB0098,L,1,44500,135000,0,0,0,0,0,27000,135000,108000
01SCS19E270145,ESH.AR-SE0005,00ARSE0018,M,1,44500,135000,0,0,0,0,0,27000,135000,108000
01SCS19E270146,AR.YAS-SE013,20ARSE0745,S,1,122850,189000,2,0,37800,1,0,37800,151200,113400
01SCS19E270147,AR.STY-SE016,20ARSE0582,ALL,1,55250,85000,2,0,17000,1,0,17000,68000,51000
01SCS19E270148,AR.STY-SA002,20ARSA0061,ALL,1,61750,95000,2,0,19000,1,0,19000,76000,57000
01SCS19E270149,AR.MKV-RJ006,20ARRJ0166,M,1,91000,140000,0,0,0,0,0,49000,140000,91000
01SCS19E270149,AR.MPR-SE007,20ARSE0162,M,1,97500,150000,2,0,45000,1,0,26250,105000,78750
01SCS19E270150,AR.ESB-RK002,20ARRK0228,M,1,198250,305000,2,0,61000,1,0,61000,244000,183000
01SCS19E270150,AR.ESB-SB003,20ARSB0101,M,1,100750,155000,2,0,31000,1,0,31000,124000,93000
01SCS19E270151,AR.MER-RH002,20ARRH0224,L,1,204750,315000,2,0,94500,1,0,55125,220500,165375
01SCS19E270152,AR.MKV-SE010,20ARSE0514,28,1,227500,350000,0,0,0,0,0,122500,350000,227500
01SCS19E270152,BSC.AR-SC0009,00ARSC0055,XL,1,125000,315000,0,0,0,0,0,63000,315000,252000
01SCS19E270153,AR.TUC-SA004,20ARSA0016,XL,1,87750,135000,2,0,27000,1,0,27000,108000,81000
01SCS19E270153,BSC.AR-SE0001,00ARSE0059,L,1,44500,159000,0,0,0,0,0,31800,159000,127200
01SCS19E270153,ESH.AR-SA0007,00ARSA0075,S,1,44000,135000,0,0,0,0,0,27000,135000,108000
01SCS19E270154,AR.PUB-SD031,20ARSD0216,34,1,211250,325000,2,0,65000,1,0,65000,260000,195000
01SCS19E270155,AR.MKV-SE001,20ARSE0471,32,1,214500,330000,0,0,0,0,0,115500,330000,214500
01SCS19E270156,AR.MKV-RJ009,20ARRJ0181,M,1,91000,140000,0,0,0,0,0,49000,140000,91000
01SCS19E270157,ESH.AR-SB0006,00ARSB0025,L,1,44500,135000,0,0,0,0,0,27000,135000,108000
01SCS19E270158,AR.CPT-SC003,20ARSC0250,32,1,227500,350000,2,0,70000,1,0,70000,280000,210000
01SCS19E270159,AR.MPR-SE007,20ARSE0162,M,1,97500,150000,2,0,45000,1,0,26250,105000,78750
01SCS19E270159,ESH.AR-SD0026,00ARSD0267,M,1,44500,135000,0,0,0,0,0,27000,135000,108000
01SCS19E270160,AR.ESB-SE007,20ARSE0264,L,1,94250,145000,2,0,29000,1,0,29000,116000,87000
01SCS19E270160,AR.TUC-SB019,20ARSB0482,L,1,87750,135000,2,0,27000,1,0,27000,108000,81000
01SCS19E270161,AR.ESB-SB005,20ARSB0110,L,1,91000,140000,2,0,28000,1,0,28000,112000,84000
01SCS19E270161,AR.MKV-RJ028,20ARRJ0226,30,1,214500,330000,0,0,0,0,0,115500,330000,214500
01SCS19E270162,ESH.AR-SC0023,00ARSC0167,L,1,125000,315000,0,0,0,0,0,63000,315000,252000
01SCS19E270163,BSC.AR-RI0007,00ARRI0023,M,1,108500,155000,0,0,0,0,0,31000,155000,124000
01SCS19E270164,AR.MKV-SE019,20ARSE0607,L,1,97500,150000,0,0,0,0,0,52500,150000,97500
01SCS19E270165,ESH.AR-SA0006,00ARSA0071,S,1,44500,135000,0,0,0,0,0,27000,135000,108000
01SCS19E270166,ESH.AR-SC0011,00ARSC0086,L,1,44000,135000,0,0,0,0,0,27000,135000,108000
01SCS19E270167,ESH.AR-SD0026,00ARSD0267,M,1,44500,135000,0,0,0,0,0,27000,135000,108000
01SCS19E270167,ESH.AR-SE0009,00ARSE0035,L,1,44500,135000,0,0,0,0,0,27000,135000,108000
01SCS19E270167,ESH.AR-SE0029,00ARSE0265,L,1,44500,135000,0,0,0,0,0,27000,135000,108000
01SCS19E270168,AR.MYA-SD002,20ARSD0251,30,1,207350,319000,2,0,159500,1,0,39875,159500,119625
01SCS19E270168,BSC.AR-SD0002,00ARSD0006,M,1,44000,159000,0,0,0,0,0,31800,159000,127200
01SCS19E270168,ESH.AR-SD0045,00ARSD0404,S,1,125000,315000,0,0,0,0,0,63000,315000,252000
01SCS19E270169,BSC.AR-SD0066,00ARSD0355,S,1,44500,159000,0,0,0,0,0,31800,159000,127200
01SCS19E270170,ESH.AR-SB0017,00ARSB0100,NON,1,41000,120000,0,0,0,0,0,24000,120000,96000
01SCS19E270170,ESH.AR-SD0015,00ARSD0091,L,1,106400,350000,0,0,0,0,0,70000,350000,280000
01SCS19E270171,AR.MPR-SE030,20ARSE0292,M,1,230750,355000,2,0,71000,1,0,71000,284000,213000
01SCS19E270172,AR.SMD-SE006,20ARSE0455,39,1,97500,150000,2,0,30000,1,0,30000,120000,90000
01SCS19E270173,BSC.AR-SB0014,00ARSB0110,S,1,44000,135000,0,0,0,0,0,27000,135000,108000
01SCS19E270173,BSC.AR-SC0007,00ARSC0044,L,1,44000,135000,0,0,0,0,0,27000,135000,108000
01SCS19E270174,BE.RAK-RL021,00BERL0067,M,1,211250,325000,2,0,65000,1,0,65000,260000,195000
01SCS19E270175,AR.MPR-SE006,20ARSE0159,L,1,97500,150000,2,0,45000,1,0,26250,105000,78750
01SCS19E270175,ESH.AR-SD0010,00ARSD0071,L,1,44500,135000,0,0,0,0,0,27000,135000,108000
01SCS19E270175,ESH.AR-SD0011,00ARSD0075,L,1,125000,315000,0,0,0,0,0,63000,315000,252000
01SCS19E270176,AR.TUC-RG005,20ARRG0156,ALL,1,87750,135000,2,0,27000,1,0,27000,108000,81000
01SCS19E270177,AR.SMD-SD005,20ARSD0294,L,1,87750,135000,2,0,27000,1,0,27000,108000,81000
01SCS19E270178,AR.PCT-SE010,20ARSE0669,L,1,211250,325000,2,0,65000,1,0,65000,260000,195000
01SCS19E270179,AR.TUC-SD025,20ARSD0519,32,1,211250,325000,2,0,65000,1,0,65000,260000,195000
01SCS19E270179,AR.YRX-RH006,20ARRH0723,ALL,1,146250,225000,2,0,45000,1,0,45000,180000,135000
01SCS19E270180,BSC.AR-RL0020,00ARRL0119,L,1,125000,315000,0,0,0,0,0,63000,315000,252000
01SCS19E270181,DKS.AR-SE0010,00ARSE0165,28,1,417272,696000,0,0,0,0,0,104400,696000,591600
01SCS19E270182,AR.ESB-SC016,20ARSC0458,L,1,91000,140000,2,0,28000,1,0,28000,112000,84000
01SCS19E270183,AR.BPH-RH029,20ARRH0795,L,2,220350,339000,2,0,169500,1,0,42375,339000,254250
01SCS19E270184,AR.ESB-SD014,20ARSD0329,S,1,91000,140000,2,0,28000,1,0,28000,112000,84000
01SCS19E270185,BSC.AR-RL0019,00ARRL0113,S,1,125000,315000,0,0,0,0,0,63000,315000,252000
01SCS19E270186,AR.MKV-RE036,20ARRE1406,M,1,165750,255000,0,0,0,0,0,89250,255000,165750
01SCS19E270186,AR.VLD-SA003,20ARSA0173,B,1,211250,325000,2,0,97500,1,0,56875,227500,170625
01SCS19E270187,AR.CPT-RK007,20ARRK0025,L,1,204750,315000,2,0,63000,1,0,63000,252000,189000
01SCS19E270188,AR.CPT-SE001,20ARSE0354,L,1,94250,145000,2,0,29000,1,0,29000,116000,87000
01SCS19E270188,AR.SMD-SB001,20ARSB0193,L,1,211250,325000,2,0,65000,1,0,65000,260000,195000
01SCS19E270188,BSC.AR-RH0006,00ARRH0027,L,1,108500,155000,0,0,0,0,0,31000,155000,124000
01SCS19E270189,AR.CPT-SC010,20ARSC0473,L,1,204750,315000,2,0,63000,1,0,63000,252000,189000
01SCS19E270190,AR.STY-RJ009,20ARRJ0112,ALL,1,61750,95000,2,0,19000,1,0,19000,76000,57000
01SCS19E270191,AR.BPH-SD001,20ARSD0359,L,1,103350,159000,2,0,47700,1,0,27825,111300,83475
01SCS19E270191,AR.YAS-SE016,20ARSE0757,S,1,122850,189000,2,0,37800,1,0,37800,151200,113400
01SCS19E270192,ESH.AR-SC0005,00ARSC0028,L,1,125000,315000,0,0,0,0,0,63000,315000,252000
01SCS19E270192,ESH.AR-SC0013,00ARSC0105,M,1,44500,135000,0,0,0,0,0,27000,135000,108000
01SCS19E270193,AR.YAS-SE015,20ARSE0753,S,1,122850,189000,2,0,37800,1,0,37800,151200,113400
01SCS19E270194,AR.BPH-RH028,20ARRH0792,XL,1,187850,289000,2,0,144500,1,0,36125,144500,108375
01SCS19E270194,BSC.AR-RK0005,00ARRK0067,L,1,108500,155000,0,0,0,0,0,31000,155000,124000
01SCS19E270195,AR.VCS-RL003,20ARRL0302,L,1,97500,150000,2,0,45000,1,0,26250,105000,78750
01SCS19E270195,BSC.AR-SC0015,00ARSC0103,XL,1,44000,159000,0,0,0,0,0,31800,159000,127200
01SCS19E270196,BSC.AR-SC0040,00ARSC0258,M,1,52000,155000,0,0,0,0,0,31000,155000,124000
01SCS19E270196,BSC.AR-SD0030,00ARSD0176,L,1,44500,159000,0,0,0,0,0,31800,159000,127200
01SCS19E270196,ESH.AR-SA0011,00ARSA0092,NON,1,19000,50000,0,0,0,0,0,10000,50000,40000
01SCS19E270197,BSC.AR-SC0006,00ARSC0039,M,1,44000,135000,0,0,0,0,0,27000,135000,108000
01SCS19E270198,AR.MKV-SE006,20ARSE0495,30,1,165750,255000,0,0,0,0,0,89250,255000,165750
01SCS19E270199,BSC.AR-SD0028,00ARSD0160,S,1,125000,315000,0,0,0,0,0,63000,315000,252000
01SCS19E270200,BSC.AR-SC0034,00ARSC0229,M,1,125000,315000,0,0,0,0,0,63000,315000,252000
01SCS19E270201,AR.RDC-RK009,20ARRK0487,S,1,97500,150000,2,0,30000,1,0,30000,120000,90000
01SCS19E270201,ESH.AR-SA0007,00ARSA0075,S,1,44000,135000,0,0,0,0,0,27000,135000,108000
01SCS19E270202,AR.BPH-RL002,20ARRL0071,L,1,103350,159000,2,0,47700,1,0,27825,111300,83475
01SCS19E270202,ESH.AR-RJ0001,00ARRJ0012,M,1,44500,135000,0,0,0,0,0,27000,135000,108000
01SCS19E270203,BSC.AR-SD0044,00ARSD0237,L,1,44500,159000,0,0,0,0,0,31800,159000,127200
01SCS19E270203,ESH.AR-SD0030,00ARSD0296,M,1,44500,135000,0,0,0,0,0,27000,135000,108000
01SCS19E270204,BSC.AR-SD0032,00ARSD0184,M,1,44500,159000,0,0,0,0,0,31800,159000,127200
01SCS19E270205,ESH.AR-RH0001,00ARRH0002,M,1,131000,395000,0,0,0,0,0,79000,395000,316000
01SCS19E270205,ESH.AR-SC0028,00ARSC0267,L,1,44500,135000,0,0,0,0,0,27000,135000,108000
01SCS19E270206,ESH.AR-SD0007,00ARSD0057,S,1,44500,135000,0,0,0,0,0,27000,135000,108000
01SCS19E270207,BE.RAK-RX207,00BERX0555,M,1,161850,249000,2,0,49800,1,0,49800,199200,149400
01SCS19E270208,AR.TUC-SD004,20ARSD0153,M,1,204750,315000,2,0,63000,1,0,63000,252000,189000
01SCS19E270209,AR.HMR-SB005,20ARSB0353,M,1,243750,375000,2,0,75000,1,0,75000,300000,225000
01SCS19E270210,AR.STY-SA003,20ARSA0062,ALL,1,61750,95000,2,0,19000,1,0,19000,76000,57000
01SCS19E270211,AR.STY-SA003,20ARSA0062,ALL,1,61750,95000,2,0,19000,1,0,19000,76000,57000
01SCS19E270211,AR.STY-SE011,20ARSE0577,ALL,1,55250,85000,2,0,17000,1,0,17000,68000,51000
01SCS19E270212,ESH.AR-SE0009,00ARSE0033,S,1,44500,135000,0,0,0,0,0,27000,135000,108000
01SCS19E270213,BSC.AR-SC0006,00ARSC0039,M,1,44000,135000,0,0,0,0,0,27000,135000,108000
01SCS19E270214,AR.ASH-RK002,20ARRK0507,S,1,195000,300000,2,0,90000,1,0,52500,210000,157500
01SCS19E270215,AR.SMD-RH003,20ARRH0399,M,1,211250,325000,2,0,97500,1,0,56875,227500,170625
01SCS19E270216,ESH.AR-RK0020,00ARRK0200,M,1,192500,275000,0,0,0,0,0,55000,275000,220000
01SCS19E270217,AR.PCT-SE020,20ARSE0689,L,1,87750,135000,2,0,27000,1,0,27000,108000,81000
01SCS19E270218,AR.MKV-SA006,20ARSA0198,34,1,243750,375000,0,0,0,0,0,131250,375000,243750
01SCS19E270219,AR.TRF-RJ009,20ARRJ0090,XL,1,195000,300000,2,0,90000,1,0,52500,210000,157500
01SCS19E270220,BE.RAK-SC037,00BESC0159,L,1,91000,140000,2,0,28000,1,0,28000,112000,84000
01SCS19E270221,ESH.AR-RL0011,00ARRL0121,S,1,100000,265000,0,0,0,0,0,53000,265000,212000
01SCS19E270222,AR.MDS-RL004,20ARRL0368,L,1,117000,180000,2,0,36000,1,0,36000,144000,108000
01SCS19E270222,AR.PUB-RJ016,20ARRJ0236,XL,1,97500,150000,2,0,30000,1,0,30000,120000,90000
01SCS19E270222,AR.PUB-RL019,20ARRL0194,L,1,97500,150000,2,0,30000,1,0,30000,120000,90000
01SCS19E270222,AR.REC-SD006,20ARSD0023,L,1,107250,165000,2,0,49500,1,0,28875,115500,86625
01SCS19E270222,AR.SMD-PL002,20ARPL0267,L,1,84500,130000,2,0,39000,1,0,22750,91000,68250
01SCS19E270222,BSC.AR-RJ0016,00ARRJ0101,L,1,43000,135000,0,0,0,0,0,27000,135000,108000
01SCS19E270222,BSC.AR-SE0014,00ARSE0180,M,1,44000,159000,0,0,0,0,0,31800,159000,127200
01SCS19E270223,AR.MPR-SE012,20ARSE0183,L,1,97500,150000,2,0,45000,1,0,26250,105000,78750
01SCS19E270223,AR.TUC-SD018,20ARSD0491,L,1,94250,145000,2,0,29000,1,0,29000,116000,87000
01SCS19E270224,BSC.AR-RI0035,00ARRI0210,L,1,220500,315000,0,0,0,0,0,63000,315000,252000
01SCS19E270225,ESH.AR-SE0038,00ARSE0334,L,1,44500,135000,0,0,0,0,0,27000,135000,108000
01SCS19E270225,ESH.AR-SE0038,00ARSE0335,XL,1,44500,135000,0,0,0,0,0,27000,135000,108000
01SCS19E270226,ESH.AR-SC0005,00ARSC0029,XL,1,125000,315000,0,0,0,0,0,63000,315000,252000
01SCS19E270227,AR.SMD-RH003,20ARRH0399,M,1,211250,325000,2,0,97500,1,0,56875,227500,170625
01SCS19E270228,AR.CPT-QI001,20ARQI0002,ALL,1,94250,145000,2,0,29000,1,0,29000,116000,87000
01SCS19E270228,AR.FHL-SC001,20ARSC0329,XL,1,91000,140000,2,0,28000,1,0,28000,112000,84000
01SCS19E270228,AR.PUB-SB043,20ARSB0530,ALL,1,97500,150000,2,0,30000,1,0,30000,120000,90000
01SCS19E270228,AR.TUC-RK031,20ARRK0144,XL,1,87750,135000,2,0,27000,1,0,27000,108000,81000
01SCS19E270229,AR.ESB-SB003,20ARSB0101,M,1,100750,155000,2,0,31000,1,0,31000,124000,93000
01SCS19E270229,AR.HLW-SE004,20ARSE0531,S,1,100750,155000,2,0,31000,1,0,31000,124000,93000
01SCS19E270230,BSC.AR-SB0007,00ARSB0075,M,1,44500,135000,0,0,0,0,0,27000,135000,108000
01SCS19E270231,AR.TUC-RI012,20ARRI0372,L,1,87750,135000,2,0,27000,1,0,27000,108000,81000
01SCS19E270232,AR.PUB-SE033,20ARSE0630,M,1,97500,150000,2,0,30000,1,0,30000,120000,90000
01SCS19E270233,BSC.AR-SB0011,00ARSB0098,L,1,44500,135000,0,0,0,0,0,27000,135000,108000
01SCS19E270234,BSC.AR-RL0019,00ARRL0114,M,1,125000,315000,0,0,0,0,0,63000,315000,252000
01SCS19E270235,AR.HLW-SA006,20ARSA0093,ALL,1,71500,110000,2,0,22000,1,0,22000,88000,66000
01SCS19E270236,AR.TUC-SD018,20ARSD0491,L,1,94250,145000,2,0,29000,1,0,29000,116000,87000
01SCS19E270237,AR.MDS-RL003,20ARRL0363,M,1,117000,180000,2,0,36000,1,0,36000,144000,108000
01SCS19E270237,AR.TUC-SD002,20ARSD0145,M,1,204750,315000,2,0,63000,1,0,63000,252000,189000
01SCS19E270238,AR.FHL-SA004,20ARSA0085,ALL,1,87750,135000,2,0,27000,1,0,27000,108000,81000
01SCS19E270239,ESH.AR-SC0001,00ARSC0002,M,1,125000,315000,0,0,0,0,0,63000,315000,252000
01SCS19E270240,BSC.AR-SD0016,00ARSD0119,M,1,122000,375000,0,0,0,0,0,75000,375000,300000
01SCS19E270240,BSC.AR-SE0027,00ARSE0277,L,1,52000,155000,0,0,0,0,0,31000,155000,124000
01SCS19E270241,ESH.AR-SD0032,00ARSD0304,M,1,44500,135000,0,0,0,0,0,27000,135000,108000
01SCS19E270242,BSC.AR-RL0020,00ARRL0117,S,1,125000,315000,0,0,0,0,0,63000,315000,252000
01SCS19E270243,ESH.AR-SD0024,00ARSD0258,S,1,44500,135000,0,0,0,0,0,27000,135000,108000
01SCS19E270244,AR.MKV-SE025,20ARSE0624,28,1,214500,330000,0,0,0,0,0,115500,330000,214500
01SCS19E270244,AR.PUB-RI001,20ARRI0097,M,1,97500,150000,2,0,30000,1,0,30000,120000,90000
01SCS19E270245,BSC.AR-SB0018,00ARSB0141,M,1,44500,135000,0,0,0,0,0,27000,135000,108000
01SCS19E270245,BSC.AR-SE0026,00ARSE0227,S,1,44000,159000,0,0,0,0,0,31800,159000,127200
01SCS19E270246,AR.TUC-SE010,20ARSE0400,M,1,94250,145000,2,0,29000,1,0,29000,116000,87000
01SCS19E270246,AR.VLD-SB001,20ARSB0040,S,1,91000,140000,2,0,42000,1,0,24500,98000,73500
01SCS19E270247,AR.PCT-SE017,20ARSE0682,M,1,87750,135000,2,0,27000,1,0,27000,108000,81000
01SCS19E270247,ESH.AR-SE0010,00ARSE0038,M,1,44000,135000,0,0,0,0,0,27000,135000,108000
01SCS19E270248,AR.TUC-SB003,20ARSB0031,ALL,1,61750,95000,2,0,19000,1,0,19000,76000,57000
01SCS19E270249,AR.CPT-SE001,20ARSE0354,L,1,94250,145000,2,0,29000,1,0,29000,116000,87000
01SCS19E270249,AR.YAS-SE011,20ARSE0737,S,1,122850,189000,2,0,37800,1,0,37800,151200,113400
01SCS19E270249,AR.YAS-SE017,20ARSE0761,S,1,122850,189000,2,0,37800,1,0,37800,151200,113400
01SCS19E270249,BSC.AR-SD0006,00ARSD0021,S,1,44000,159000,0,0,0,0,0,31800,159000,127200
01SCS19E270250,AR.ESB-SE008,20ARSE0268,L,1,100750,155000,2,0,31000,1,0,31000,124000,93000
01SCS19E270250,AR.MKV-SE009,20ARSE0509,28,1,227500,350000,0,0,0,0,0,122500,350000,227500
01SCS19E270250,AR.STY-SE009,20ARSE0127,ALL,1,55250,85000,2,0,17000,1,0,17000,68000,51000
01SCS19E270250,BSC.AR-SB0014,00ARSB0111,M,1,44000,135000,0,0,0,0,0,27000,135000,108000
01SCS19E270251,AR.MKV-SE010,20ARSE0516,32,1,227500,350000,0,0,0,0,0,122500,350000,227500
01SCS19E270251,AR.PCT-SE018,20ARSE0685,L,1,87750,135000,2,0,27000,1,0,27000,108000,81000
01SCS19E270251,ESH.AR-SD0009,00ARSD0067,L,1,44500,135000,0,0,0,0,0,27000,135000,108000
01SCS19E270252,AR.PUB-SB010,20ARSB0014,ALL,1,97500,150000,2,0,30000,1,0,30000,120000,90000
01SCS19E270253,BSC.AR-RL0020,00ARRL0118,M,1,125000,315000,0,0,0,0,0,63000,315000,252000
01SCS19E270254,AR.YAS-SE016,20ARSE0758,M,1,122850,189000,2,0,37800,1,0,37800,151200,113400
01SCS19E270255,AR.CPT-RL004,20ARRL0084,L,1,94250,145000,2,0,29000,1,0,29000,116000,87000
01SCS19E270256,ESH.AR-SA0018,00ARSA0121,M,1,44000,135000,0,0,0,0,0,27000,135000,108000
01SCS19E270257,AR.VCS-SC001,20ARSC0375,L,1,97500,150000,2,0,45000,1,0,26250,105000,78750
01SCS19E270258,AR.CPT-SE005,20ARSE0370,L,1,204750,315000,2,0,63000,1,0,63000,252000,189000
01SCS19E270259,ESH.AR-SE0037,00ARSE0330,L,1,44000,135000,0,0,0,0,0,27000,135000,108000
01SCS19E270260,ESH.AR-SD0045,00ARSD0404,S,1,125000,315000,0,0,0,0,0,63000,315000,252000
01SCS19E270261,ESH.AR-SD0011,00ARSD0074,M,1,125000,315000,0,0,0,0,0,63000,315000,252000
01SCS19E270262,AR.ESB-SE003,20ARSE0246,S,1,204750,315000,2,0,63000,1,0,63000,252000,189000
01SCS19E270263,BSC.AR-RI0003,00ARRI0008,L,1,43000,135000,0,0,0,0,0,27000,135000,108000
01SCS19E270263,BSC.AR-SE0002,00ARSE0063,L,1,44000,159000,0,0,0,0,0,31800,159000,127200
01SCS19E270263,ESH.AR-SB0034,00ARSB0218,L,1,125000,315000,0,0,0,0,0,63000,315000,252000
01SCS19E270264,BSC.AR-SD0028,00ARSD0162,L,1,125000,315000,0,0,0,0,0,63000,315000,252000
01SCS19E270265,AR.PCT-SE010,20ARSE0669,L,1,211250,325000,2,0,65000,1,0,65000,260000,195000
01SCS19E270266,ESH.AR-SE0031,00ARSE0272,M,1,125000,315000,0,0,0,0,0,63000,315000,252000
01SCS19E270267,ESH.AR-RH0015,00ARRH0088,M,1,43000,135000,0,0,0,0,0,27000,135000,108000
01SCS19E270267,ESH.AR-SD0028,00ARSD0277,XL,1,44500,135000,0,0,0,0,0,27000,135000,108000
01SCS19E270268,ESH.AR-SD0027,00ARSD0271,M,1,44000,135000,0,0,0,0,0,27000,135000,108000
01SCS19E270269,ESH.AR-SE0005,00ARSE0018,M,1,44500,135000,0,0,0,0,0,27000,135000,108000
01SCS19E270270,ESH.AR-SB0032,00ARSB0209,M,1,125000,315000,0,0,0,0,0,63000,315000,252000
01SCS19E270271,AR.HLW-SE013,20ARSE0560,L,1,100750,155000,2,0,31000,1,0,31000,124000,93000
01SCS19E270271,ESH.AR-RH0020,00ARRH0109,L,1,94500,135000,0,0,0,0,0,27000,135000,108000
01SCS19E270272,AR.CPT-RI005,20ARRI0056,S,1,94250,145000,2,0,29000,1,0,29000,116000,87000
01SCS19E270273,BSC.AR-SD0053,00ARSD0284,M,1,44000,159000,0,0,0,0,0,31800,159000,127200
01SCS19E270273,ESH.AR-SB0011,00ARSB0052,M,1,125000,315000,0,0,0,0,0,63000,315000,252000
01SCS19E270274,ESH.AR-SE0019,00ARSE0121,S,1,44000,135000,0,0,0,0,0,27000,135000,108000
01SCS19E270274,ESH.AR-SE0028,00ARSE0259,S,1,44000,135000,0,0,0,0,0,27000,135000,108000
01SCS19E270275,AR.ESB-RL011,20ARRL0462,ALL,1,91000,140000,2,0,70000,1,0,17500,70000,52500
01SCS19E270275,BSC.AR-SA0007,00ARSA0033,XL,1,94500,135000,0,0,0,0,0,27000,135000,108000
01SCS19E270275,BSC.AR-SD0007,00ARSD0028,XL,1,44500,159000,0,0,0,0,0,31800,159000,127200
01SCS19E270276,AR.MKV-SC019,20ARSC0224,ALL,1,91000,140000,2,0,70000,1,0,17500,70000,52500
01SCS19E270277,AR.ESB-RH009,20ARRH0470,ALL,1,91000,140000,2,0,70000,1,0,17500,70000,52500
01SCS19E270278,AR.MPR-SE030,20ARSE0293,L,1,230750,355000,2,0,71000,1,0,71000,284000,213000
01SCS19E270279,AR.PUB-SE014,20ARSE0054,M,1,159250,245000,2,0,49000,1,0,49000,196000,147000
01SCS19E270280,AR.CPT-SC011,20ARSC0476,M,1,204750,315000,2,0,63000,1,0,63000,252000,189000
01SCS19E270281,AR.REC-SD025,20ARSD0072,ALL,1,117000,180000,2,0,54000,1,0,31500,126000,94500
01SCS19E270282,AR.MPR-SE030,20ARSE0291,S,1,230750,355000,2,0,71000,1,0,71000,284000,213000
01SCS19E270283,AR.TUC-SA024,20ARSA0152,L,1,87750,135000,2,0,27000,1,0,27000,108000,81000
01SCS19E270283,AR.TUC-SD017,20ARSD0487,L,1,94250,145000,2,0,29000,1,0,29000,116000,87000
01SCS19E270284,AR.PUB-SE007,20ARSE0027,L,1,97500,150000,2,0,30000,1,0,30000,120000,90000
01SCS19E270285,AR.PUB-SB033,20ARSB0464,ALL,1,97500,150000,2,0,30000,1,0,30000,120000,90000
01SCS19E270286,AR.TUC-SD023,20ARSD0511,L,1,204750,315000,2,0,63000,1,0,63000,252000,189000
01SCS19E270287,AR.PCT-SE015,20ARSE0678,M,1,87750,135000,2,0,27000,1,0,27000,108000,81000
01SCS19E270288,AR.PCT-SE019,20ARSE0686,M,1,87750,135000,2,0,27000,1,0,27000,108000,81000
01SCS19E270289,AR.SMD-SD005,20ARSD0292,S,1,87750,135000,2,0,27000,1,0,27000,108000,81000
01SCS19E270290,AR.MKV-SD001,20ARSD0218,S,1,97500,150000,0,0,0,0,0,52500,150000,97500
01SCS19E270291,AR.PCT-SE020,20ARSE0689,L,1,87750,135000,2,0,27000,1,0,27000,108000,81000
01SCS19E270292,AR.PUB-SE021,20ARSE0081,L,1,159250,245000,2,0,49000,1,0,49000,196000,147000
01SCS19E270292,ESH.AR-SD0031,00ARSD0300,M,1,44000,135000,0,0,0,0,0,27000,135000,108000
01SCS19E270293,ESH.AR-SE0037,00ARSE0330,L,1,44000,135000,0,0,0,0,0,27000,135000,108000
01SCS19E270294,AR.MPR-SE028,20ARSE0230,S,1,230750,355000,2,0,71000,1,0,71000,284000,213000
01SCS19E270295,AR.PUB-RL027,20ARRL0433,M,1,191750,295000,2,0,59000,1,0,59000,236000,177000
01SCS19E270295,AR.SMD-SD013,20ARSD0571,L,1,87750,135000,2,0,27000,1,0,27000,108000,81000
01SCS19E270296,AR.PUB-SD035,20ARSD0345,M,1,204750,315000,2,0,63000,1,0,63000,252000,189000
01SCS19E270297,AR.PCT-SE012,20ARSE0672,M,1,87750,135000,2,0,27000,1,0,27000,108000,81000
01SCS19E270297,ESH.AR-SE0006,00ARSE0022,M,1,44000,135000,0,0,0,0,0,27000,135000,108000
01SCS19E270298,AR.CPT-SC007,20ARSC0266,L,1,94250,145000,2,0,29000,1,0,29000,116000,87000
01SCS19E270299,AR.TUC-SE023,20ARSE0654,34,1,204750,315000,2,0,63000,1,0,63000,252000,189000
01SCS19E270300,ESH.AR-SD0002,00ARSD0037,S,1,44500,135000,0,0,0,0,0,27000,135000,108000
01SCS19E270300,ESH.AR-SD0007,00ARSD0057,S,1,44500,135000,0,0,0,0,0,27000,135000,108000
01SCS19E270301,AR.SMD-SE003,20ARSE0442,L,1,87750,135000,2,0,27000,1,0,27000,108000,81000
01SCS19E270302,AR.MPR-SE025,20ARSE0219,M,1,230750,355000,2,0,71000,1,0,71000,284000,213000
01SCS19E270303,ESH.AR-SA0012,00ARSA0096,XL,1,44000,135000,0,0,0,0,0,27000,135000,108000
01SCS19E270304,ESH.AR-RK0013,00ARRK0130,M,1,44500,135000,0,0,0,0,0,27000,135000,108000
01SCS19E270305,AR.HLW-SC001,20ARSC0117,S,1,126750,195000,2,0,58500,1,0,34125,136500,102375
01SCS19E270306,BSC.AR-SD0015,00ARSD0115,M,1,122000,375000,0,0,0,0,0,75000,375000,300000
01SCS19E270307,BSC.AR-SC0033,00ARSC0225,M,1,125000,315000,0,0,0,0,0,63000,315000,252000
01SCS19E270308,AR.CPT-SE006,20ARSE0373,M,1,204750,315000,2,0,63000,1,0,63000,252000,189000
01SCS19E270309,ESH.AR-SD0027,00ARSD0270,S,1,44000,135000,0,0,0,0,0,27000,135000,108000
01SCS19E270310,AR.HLW-SE005,20ARSE0536,L,1,100750,155000,2,0,31000,1,0,31000,124000,93000
01SCS19E270310,AR.STY-SA003,20ARSA0062,ALL,1,61750,95000,2,0,19000,1,0,19000,76000,57000
01SCS19E270310,AR.STY-SE010,20ARSE0576,ALL,1,61750,95000,2,0,19000,1,0,19000,76000,57000
01SCS19E270310,ESH.AR-SA0013,00ARSA0098,M,1,44000,135000,0,0,0,0,0,27000,135000,108000
01SCS19E270311,AR.YAS-SE004,20ARSE0715,S,1,317850,489000,2,0,97800,1,0,97800,391200,293400
01SCS19E270312,AR.PUB-SD015,20ARSD0126,M,1,97500,150000,2,0,30000,1,0,30000,120000,90000
01SCS19E270312,AR.SMD-SD017,20ARSD0579,ALL,1,97500,150000,2,0,30000,1,0,30000,120000,90000
01SCS19E270313,AR.PUB-RI011,20ARRI0150,ALL,1,97500,150000,2,0,30000,1,0,30000,120000,90000
01SCS19E270313,AR.VCS-SC001,20ARSC0375,L,1,97500,150000,2,0,45000,1,0,26250,105000,78750
01SCS19E270314,AR.MDS-RL003,20ARRL0362,S,1,117000,180000,2,0,36000,1,0,36000,144000,108000
01SCS19E270314,AR.MDS-RL004,20ARRL0368,L,1,117000,180000,2,0,36000,1,0,36000,144000,108000
01SCS19E270315,AR.ESB-SE010,20ARSE0276,L,1,227500,350000,2,0,70000,1,0,70000,280000,210000
01SCS19E270316,AR.PCT-SE013,20ARSE0675,L,1,87750,135000,2,0,27000,1,0,27000,108000,81000
01SCS19E270317,AR.CPT-SD012,20ARSD0458,M,1,94250,145000,2,0,29000,1,0,29000,116000,87000
01SCS19E270318,BSC.AR-SA0019,00ARSA0063,S,1,44000,135000,0,0,0,0,0,27000,135000,108000
01SCS19E270319,BSC.AR-SE0001,00ARSE0058,M,1,44500,159000,0,0,0,0,0,31800,159000,127200
01SCS19E270319,BSC.AR-SE0037,00ARSE0346,S,1,44000,159000,0,0,0,0,0,31800,159000,127200
01SCS19E270320,AR.TUC-SE019,20ARSE0636,M,1,204750,315000,2,0,63000,1,0,63000,252000,189000
01SCS19E270321,BSC.AR-RL0019,00ARRL0114,M,1,125000,315000,0,0,0,0,0,63000,315000,252000
01SCS19E270322,AR.MPR-SB018,20ARSB0305,XL,1,217750,335000,2,0,67000,1,0,67000,268000,201000
01SCS19E270323,AR.MPR-SE001,20ARSE0139,L,1,97500,150000,2,0,45000,1,0,26250,105000,78750
01SCS19E270323,AR.PUB-RH029,20ARRH0447,L,1,97500,150000,2,0,30000,1,0,30000,120000,90000
01SCS19E270324,BSC.AR-SD0032,00ARSD0183,S,1,44500,159000,1,0,31800,1,0,25440,127200,101760
01SCS19E270324,ESH.AR-SE0013,00ARSE0049,S,1,44500,135000,1,0,27000,1,0,21600,108000,86400
01SCS19E270325,AR.ASH-RJ010,20ARRJ0486,S,1,91000,140000,2,0,42000,1,0,24500,98000,73500
01SCS19E270325,AR.ESB-SD004,20ARSD0108,S,1,91000,140000,2,0,28000,1,0,28000,112000,84000
01SCS19E270325,AR.HLW-SE010,20ARSE0549,S,1,100750,155000,2,0,31000,1,0,31000,124000,93000
01SCS19E270325,AR.PCT-SE012,20ARSE0672,M,1,87750,135000,2,0,27000,1,0,27000,108000,81000
01SCS19E270326,AR.PUB-RJ007,20ARRJ0026,L,1,224250,345000,2,0,69000,1,0,69000,276000,207000
01SCS19E270327,AR.YAS-SE017,20ARSE0763,L,1,122850,189000,2,0,37800,1,0,37800,151200,113400
01SCS19E270327,DKS.AR-SE0007,00ARSE0153,32,1,417272,696000,0,0,0,0,0,104400,696000,591600
01SCS19E270328,ESH.AR-SD0011,00ARSD0075,L,1,125000,315000,0,0,0,0,0,63000,315000,252000
01SCS19E270329,ESH.AR-SD0043,00ARSD0396,L,1,125000,315000,0,0,0,0,0,63000,315000,252000
01SCS19E270330,AR.HLW-SE013,20ARSE0559,M,1,100750,155000,2,0,31000,1,0,31000,124000,93000
01SCS19E270331,AR.TUC-RK030,20ARRK0140,L,1,94250,145000,2,0,29000,1,0,29000,116000,87000
01SCS19E270332,AR.SMD-SA003,20ARSA0228,M,1,87750,135000,2,0,27000,1,0,27000,108000,81000
01SCS19E270333,AR.PUB-SE009,20ARSE0036,XL,1,97500,150000,2,0,30000,1,0,30000,120000,90000
01SCS19E270334,ESH.AR-SA0006,00ARSA0071,S,1,44500,135000,0,0,0,0,0,27000,135000,108000
01SCS19E270335,AR.PCT-SE007,20ARSE0348,M,1,87750,135000,2,0,27000,1,0,27000,108000,81000
01SCS19E270336,AR.YAS-SE011,20ARSE0738,M,1,122850,189000,2,0,37800,1,0,37800,151200,113400
01SCS19E270336,BSC.AR-SA0021,00ARSA0106,M,1,44000,135000,0,0,0,0,0,27000,135000,108000
01SCS19E270337,AR.ESB-SB005,20ARSB0111,XL,1,91000,140000,2,0,28000,1,0,28000,112000,84000
01SCS19E270337,BSC.AR-RJ0019,00ARRJ0112,M,1,94500,135000,0,0,0,0,0,27000,135000,108000
01SCS19E270337,BSC.AR-SD0004,00ARSD0015,L,1,44000,159000,0,0,0,0,0,31800,159000,127200
01SCS19E270337,BSC.AR-SD0058,00ARSD0294,NON,1,50000,150000,0,0,0,0,0,30000,150000,120000
01SCS19E270337,ESH.AR-RJ0010,00ARRJ0047,S,1,94500,135000,0,0,0,0,0,27000,135000,108000
01SCS19E270337,ESH.AR-RK0013,00ARRK0130,M,1,44500,135000,0,0,0,0,0,27000,135000,108000
01SCS19E270337,ESH.AR-SD0007,00ARSD0058,M,1,44500,135000,0,0,0,0,0,27000,135000,108000
01SCS19E270338,AR.HLW-SE022,20ARSE0573,S,1,100750,155000,2,0,31000,1,0,31000,124000,93000
01SCS19E270338,BSC.AR-SD0041,00ARSD0223,S,1,44500,159000,0,0,0,0,0,31800,159000,127200
01SCS19E270339,ESH.AR-SD0025,00ARSD0262,S,1,44000,135000,0,0,0,0,0,27000,135000,108000
01SCS19E270340,ESH.AR-RJ0013,00ARRJ0177,L,1,94500,135000,0,0,0,0,0,27000,135000,108000
01SCS19E270341,AR.PUB-SE004,20ARSE0015,L,1,97500,150000,2,0,30000,1,0,30000,120000,90000
01SCS19E270342,AR.CPT-RI004,20ARRI0054,L,1,94250,145000,2,0,29000,1,0,29000,116000,87000
01SCS19E270343,ESH.AR-SB0003,00ARSB0007,S,1,44000,135000,0,0,0,0,0,27000,135000,108000
01SCS19E270344,AR.BPH-RB008,20ARRB0453,S,1,103350,159000,2,0,47700,1,0,27825,111300,83475
01SCS19E270345,AR.PCT-SE010,20ARSE0669,L,1,211250,325000,2,0,65000,1,0,65000,260000,195000
01SCS19E270346,ESH.AR-SD0025,00ARSD0262,S,1,44000,135000,0,0,0,0,0,27000,135000,108000
01SCS19E270347,AR.MPR-SE010,20ARSE0174,M,1,97500,150000,2,0,45000,1,0,26250,105000,78750
01SCS19E270348,AR.BPH-RH020,20ARRH0391,M,1,182000,280000,2,0,140000,1,0,35000,140000,105000
01SCS19E270348,ESH.AR-SA0006,00ARSA0071,S,1,44500,135000,0,0,0,0,0,27000,135000,108000
01SCS19E270349,ESH.AR-SD0029,00ARSD0278,NON,1,58000,175000,0,0,0,0,0,35000,175000,140000
01SCS19E270350,AR.PUB-SB036,20ARSB0467,ALL,1,81250,125000,2,0,25000,1,0,25000,100000,75000
01SCS19E270351,BSC.AR-SB0003,00ARSB0044,M,1,125000,315000,0,0,0,0,0,63000,315000,252000
01SCS19E270352,AR.MKV-RJ010,20ARRJ0185,S,1,91000,140000,0,0,0,0,0,49000,140000,91000
01SCS19E270352,SLT.AR-SB0024,00ARSB0190,S,1,235000,235000,0,0,0,0,0,47000,235000,188000
01SCS19E270353,AR.CPT-QL011,20ARQL0169,XL,1,204750,315000,2,0,63000,1,0,63000,252000,189000
01SCS19E270353,BSC.AR-SB0010,00ARSB0094,L,1,125000,315000,0,0,0,0,0,63000,315000,252000
01SCS19E270354,AR.MPR-SE002,20ARSE0142,M,1,97500,150000,2,0,45000,1,0,26250,105000,78750
01SCS19E270355,ESH.AR-SD0027,00ARSD0272,L,1,44000,135000,0,0,0,0,0,27000,135000,108000
01SCS19E270356,ESH.AR-RD0009,00ARRD0056,NON,1,37500,115000,0,0,0,0,0,23000,115000,92000
01SCS19E280001,AR.PUB-SA002,20ARSA0130,L,1,224250,345000,2,0,69000,1,0,69000,276000,207000
01SCS19E280002,AR.YRX-RH005,20ARRH0722,ALL,1,146250,225000,2,0,45000,1,0,45000,180000,135000
01SCS19E280003,AR.TRF-RJ001,20ARRJ0057,L,1,97500,150000,2,0,45000,1,0,26250,105000,78750
01SCS19E280004,BSC.AR-RL0019,00ARRL0113,S,1,125000,315000,0,0,0,0,0,63000,315000,252000
01SCS19E280004,BSC.AR-SC0045,00ARSC0297,NON,1,45000,150000,0,0,0,0,0,30000,150000,120000
01SCS19E280005,AR.CPT-SC008,20ARSC0270,L,1,94250,145000,2,0,29000,1,0,29000,116000,87000
01SCS19E280006,AR.CPT-RI005,20ARRI0057,M,1,94250,145000,2,0,29000,1,0,29000,116000,87000
01SCS19E280007,AR.CPT-SD010,20ARSD0451,L,1,94250,145000,2,0,29000,1,0,29000,116000,87000
01SCS19E280008,AR.ESB-SC002,20ARSC0310,L,1,204750,315000,2,0,63000,1,0,63000,252000,189000
01SCS19E280009,ESH.AR-SC0021,00ARSC0157,S,1,44000,135000,0,0,0,0,0,27000,135000,108000
01SCS19E280010,ESH.AR-SC0021,00ARSC0158,M,1,44000,135000,0,0,0,0,0,27000,135000,108000
01SCS19E280011,ESH.AR-SC0008,00ARSC0070,L,1,44500,135000,0,0,0,0,0,27000,135000,108000
01SCS19E280012,AR.CPT-SD010,20ARSD0450,M,1,94250,145000,2,0,29000,1,0,29000,116000,87000
01SCS19E280012,BSC.AR-SC0034,00ARSC0229,M,1,125000,315000,0,0,0,0,0,63000,315000,252000
01SCS19E280013,AR.ESB-SE013,20ARSE0769,S,1,91000,140000,2,0,28000,1,0,28000,112000,84000
01SCS19E280014,AR.MPR-SE018,20ARSE0202,ALL,1,110500,170000,2,0,51000,1,0,29750,119000,89250
01SCS19E280014,BSC.AR-SA0001,00ARSA0003,L,1,120000,315000,0,0,0,0,0,63000,315000,252000
01SCS19E280015,AR.REC-SD025,20ARSD0072,ALL,1,117000,180000,2,0,54000,1,0,31500,126000,94500
01SCS19E280015,AR.STY-SE010,20ARSE0576,ALL,1,61750,95000,2,0,19000,1,0,19000,76000,57000
01SCS19E280016,AR.MPR-SE002,20ARSE0142,M,1,97500,150000,2,0,45000,1,0,26250,105000,78750
01SCS19E280017,BSC.AR-SB0010,00ARSB0092,S,1,125000,315000,0,0,0,0,0,63000,315000,252000
01SCS19E280018,AR.TUC-SD004,20ARSD0153,M,1,204750,315000,2,0,63000,1,0,63000,252000,189000
01SCS19E280019,ESH.AR-SE0003,00ARSE0010,M,1,44500,135000,0,0,0,0,0,27000,135000,108000
01SCS19E280020,AR.PUB-RI025,20ARRI0312,L,1,97500,150000,2,0,30000,1,0,30000,120000,90000
01SCS19E280021,AR.ESB-SC011,20ARSC0435,ALL,1,123500,190000,2,0,57000,1,0,33250,133000,99750
01SCS19E280022,AR.TUC-RK002,20ARRK0084,XL,1,204750,315000,2,0,63000,1,0,63000,252000,189000
01SCS19E280023,BSC.AR-RI0035,00ARRI0210,L,1,220500,315000,0,0,0,0,0,63000,315000,252000
01SCS19E280023,ESH.AR-SD0007,00ARSD0057,S,1,44500,135000,0,0,0,0,0,27000,135000,108000
01SCS19E280023,ESH.AR-SD0031,00ARSD0300,M,1,44000,135000,0,0,0,0,0,27000,135000,108000
01SCS19E280024,BSC.AR-SC0024,00ARSC0180,XL,1,125000,315000,0,0,0,0,0,63000,315000,252000
01SCS19E280025,ESH.AR-SD0029,00ARSD0278,NON,1,58000,175000,0,0,0,0,0,35000,175000,140000
01SCS19E280026,AR.REC-SD028,20ARSD0075,ALL,1,32500,50000,2,0,15000,1,0,8750,35000,26250
01SCS19E280027,AR.REC-SD006,20ARSD0024,XL,1,107250,165000,2,0,49500,1,0,28875,115500,86625
01SCS19E280028,BSC.AR-SC0048,00ARSC0305,M,1,44500,159000,0,0,0,0,0,31800,159000,127200
01SCS19E280029,AR.MPR-SE004,20ARSE0151,L,1,97500,150000,2,0,45000,1,0,26250,105000,78750
01SCS19E280029,AR.MPR-SE006,20ARSE0158,M,1,97500,150000,2,0,45000,1,0,26250,105000,78750
01SCS19E280030,AR.SMD-RL001,20ARRL0265,ALL,1,22750,35000,2,0,7000,1,0,7000,28000,21000
01SCS19E280030,BE.RAK-RL020,00BERL0063,L,1,211250,325000,2,0,65000,1,0,65000,260000,195000
01SCS19E280031,BSC.AR-SD0039,00ARSD0213,L,1,125000,315000,0,0,0,0,0,63000,315000,252000
01SCS19E280032,BSC.AR-RK0019,00ARRK0123,L,1,43000,135000,0,0,0,0,0,27000,135000,108000
01SCS19E280033,AR.ESB-RL012,20ARRL0463,ALL,1,91000,140000,2,0,70000,1,0,17500,70000,52500
01SCS19E280034,ESH.AR-SE0038,00ARSE0335,XL,1,44500,135000,0,0,0,0,0,27000,135000,108000
01SCS19E280035,AR.TUC-SB023,20ARSB0487,ALL,1,87750,135000,2,0,27000,1,0,27000,108000,81000
01SCS19E280036,ESH.AR-SD0026,00ARSD0267,M,1,44500,135000,0,0,0,0,0,27000,135000,108000
01SCS19E280037,AR.MKV-SE015,20ARSE0592,M,1,22750,350000,0,0,0,0,0,122500,350000,227500
01SCS19E280038,BSC.AR-SB0003,00ARSB0044,M,1,125000,315000,0,0,0,0,0,63000,315000,252000
01SCS19E280039,BSC.AR-SD0046,00ARSD0245,L,1,44500,159000,0,0,0,0,0,31800,159000,127200
01SCS19E280039,BSC.AR-SD0066,00ARSD0357,L,1,44500,159000,0,0,0,0,0,31800,159000,127200
01SCS19E280039,BSC.AR-SE0035,00ARSE0339,34,1,125000,365000,0,0,0,0,0,73000,365000,292000
01SCS19E280040,AR.STY-SC002,20ARSC0201,ALL,1,77350,119000,2,0,23800,1,0,23800,95200,71400
01SCS19E280041,AR.SMD-SE002,20ARSE0437,M,1,97500,150000,2,0,30000,1,0,30000,120000,90000
01SCS19E280042,AR.CPT-SE004,20ARSE0365,M,1,204750,315000,2,0,63000,1,0,63000,252000,189000
01SCS19E280043,BSC.AR-SC0016,00ARSC0112,S,1,44500,135000,0,0,0,0,0,27000,135000,108000
01SCS19E280044,AR.CPT-SC011,20ARSC0476,M,1,204750,315000,2,0,63000,1,0,63000,252000,189000
01SCS19E280045,AR.MPR-SE032,20ARSE0302,XL,1,230750,355000,2,0,71000,1,0,71000,284000,213000
01SCS19E280046,AR.MPR-SE004,20ARSE0151,L,1,97500,150000,2,0,45000,1,0,26250,105000,78750
01SCS19E280047,AR.TUC-SD018,20ARSD0492,XL,1,94250,145000,2,0,29000,1,0,29000,116000,87000
01SCS19E280047,BSC.AR-SD0006,00ARSD0023,L,1,44000,159000,0,0,0,0,0,31800,159000,127200
01SCS19E280047,ESH.AR-SB0012,00ARSB0056,32,1,90,285000,0,0,0,0,0,57000,285000,228000
01SCS19E280048,BSC.AR-SD0046,00ARSD0244,M,1,44500,159000,0,0,0,0,0,31800,159000,127200
01SCS19E280049,AR.STY-SE012,20ARSE0578,ALL,1,55250,85000,2,0,17000,1,0,17000,68000,51000
01SCS19E280049,ESH.AR-SD0008,00ARSD0062,M,1,44500,135000,0,0,0,0,0,27000,135000,108000
01SCS19E280050,BSC.AR-SC0030,00ARSC0203,S,1,44000,135000,0,0,0,0,0,27000,135000,108000
01SCS19E280051,AR.PUB-SB036,20ARSB0467,ALL,1,81250,125000,2,0,25000,1,0,25000,100000,75000
01SCS19E280051,BSC.AR-RI0023,00ARRI0132,NON,1,98000,140000,0,0,0,0,0,28000,140000,112000
01SCS19E280051,BSC.AR-RL0020,00ARRL0119,L,1,125000,315000,0,0,0,0,0,63000,315000,252000
01SCS19E280051,BSC.AR-RL0025,00ARRL0168,L,1,94500,135000,0,0,0,0,0,27000,135000,108000
01SCS19E280051,BSC.AR-SD0002,00ARSD0007,L,1,44000,159000,0,0,0,0,0,31800,159000,127200
01SCS19E280052,AR.ESB-SB004,20ARSB0106,L,1,91000,140000,2,0,28000,1,0,28000,112000,84000
01SCS19E280053,AR.REC-SD017,20ARSD0055,ALL,1,107250,165000,2,0,49500,1,0,28875,115500,86625
01SCS19E280053,BSC.AR-SC0001,00ARSC0015,L,1,125000,315000,0,0,0,0,0,63000,315000,252000
01SCS19E280054,AR.ESB-SD015,20ARSD0335,L,1,91000,140000,2,0,28000,1,0,28000,112000,84000
01SCS19E280054,AR.TUC-SE008,20ARSE0393,L,1,204750,315000,2,0,63000,1,0,63000,252000,189000
01SCS19E280055,AR.MPR-SE025,20ARSE0218,S,1,230750,355000,2,0,71000,1,0,71000,284000,213000
01SCS19E280056,AR.ESB-SB006,20ARSB0113,M,1,91000,140000,2,0,28000,1,0,28000,112000,84000
01SCS19E280056,AR.ESB-SD016,20ARSD0337,M,1,91000,140000,2,0,28000,1,0,28000,112000,84000
01SCS19E280057,AR.ESB-RH002,20ARRH0180,ALL,1,87750,135000,2,0,40500,1,0,23625,94500,70875
01SCS19E280058,BSC.AR-RI0011,00ARRI0038,S,1,43000,135000,0,0,0,0,0,27000,135000,108000
01SCS19E280059,BSC.AR-SA0005,00ARSA0024,L,1,94500,135000,0,0,0,0,0,27000,135000,108000
01SCS19E280060,ESH.AR-SC0037,00ARSC0302,NON,1,40000,140000,0,0,0,0,0,28000,140000,112000
01SCS19E280061,AR.STY-SE004,20ARSE0122,ALL,1,55250,85000,2,0,17000,1,0,17000,68000,51000
01SCS19E280062,AR.PCT-SE013,20ARSE0675,L,1,87750,135000,2,0,27000,1,0,27000,108000,81000
01SCS19E280063,AR.CPT-SD006,20ARSD0434,M,1,200850,309000,2,0,61800,1,0,61800,247200,185400
01SCS19E280063,ESH.AR-SE0001,00ARSE0002,M,1,44000,135000,0,0,0,0,0,27000,135000,108000
01SCS19E280064,AR.MPR-SE002,20ARSE0142,M,1,97500,150000,2,0,45000,1,0,26250,105000,78750
01SCS19E280064,BSC.AR-SB0003,00ARSB0044,M,1,125000,315000,0,0,0,0,0,63000,315000,252000
01SCS19E280065,BSC.AR-SC0011,00ARSC0064,S,1,44000,159000,0,0,0,0,0,31800,159000,127200
01SCS19E280065,BSC.AR-SD0013,00ARSD0106,S,1,44500,159000,0,0,0,0,0,31800,159000,127200
01SCS19E280066,BSC.AR-SD0064,00ARSD0341,L,1,125000,315000,0,0,0,0,0,63000,315000,252000
01SCS19E280067,BSC.AR-SB0015,00ARSB0128,M,1,125000,315000,0,0,0,0,0,63000,315000,252000
01SCS19E280068,AR.GTW-SC002,20ARSC0027,L,1,97500,150000,2,0,45000,1,0,26250,105000,78750
01SCS19E280068,AR.TUC-RI011,20ARRI0368,L,1,87750,135000,2,0,27000,1,0,27000,108000,81000
01SCS19E280069,AR.MDS-RL002,20ARRL0360,L,1,117000,180000,2,0,36000,1,0,36000,144000,108000
01SCS19E280070,ESH.AR-SC0008,00ARSC0070,L,1,44500,135000,0,0,0,0,0,27000,135000,108000
01SCS19E280071,ESH.AR-SE0006,00ARSE0022,M,1,44000,135000,0,0,0,0,0,27000,135000,108000
01SCS19E280072,BSC.AR-SC0029,00ARSC0202,XL,1,125000,315000,0,0,0,0,0,63000,315000,252000
01SCS19E280073,ESH.AR-SC0014,00ARSC0110,L,1,44500,135000,0,0,0,0,0,27000,135000,108000
01SCS19E280074,BE.RAK-SA026,00BESA0106,S,1,91000,140000,2,0,28000,1,0,28000,112000,84000
01SCS19E280075,AR.ESB-SD012,20ARSD0323,M,1,91000,140000,2,0,28000,1,0,28000,112000,84000
01SCS19E280075,AR.MKV-SE001,20ARSE0472,34,1,214500,330000,0,0,0,0,0,115500,330000,214500
01SCS19E280075,AR.MPR-SE013,20ARSE0185,S,1,110500,170000,2,0,51000,1,0,29750,119000,89250
01SCS19E280075,AR.PUB-SE008,20ARSE0031,L,1,97500,150000,2,0,30000,1,0,30000,120000,90000
01SCS19E280075,AR.REC-SD002,20ARSD0006,M,1,120250,185000,2,0,55500,1,0,32375,129500,97125
01SCS19E280075,AR.STY-SE004,20ARSE0122,ALL,1,55250,85000,2,0,17000,1,0,17000,68000,51000
01SCS19E280075,AR.STY-SE013,20ARSE0579,ALL,1,55250,85000,2,0,17000,1,0,17000,68000,51000
01SCS19E280075,AR.TUC-SE008,20ARSE0394,XL,1,204750,315000,2,0,63000,1,0,63000,252000,189000
01SCS19E280076,AR.MKV-SE021,20ARSE0613,L,1,97500,150000,0,0,0,0,0,52500,150000,97500
01SCS19E280077,AR.PUB-SB033,20ARSB0464,ALL,1,97500,150000,2,0,30000,1,0,30000,120000,90000
01SCS19E280078,BSC.AR-SE0031,00ARSE0292,M,1,52000,155000,0,0,0,0,0,31000,155000,124000
01SCS19E280079,AR.STY-SE009,20ARSE0127,ALL,1,55250,85000,2,0,17000,1,0,17000,68000,51000
01SCS19E280080,AR.PUB-RJ041,20ARRJ0516,XL,1,97500,150000,2,0,30000,1,0,30000,120000,90000
01SCS19E280080,BE.RAK-RX538,00BERX2232,XL,1,91000,140000,2,0,28000,1,0,28000,112000,84000
01SCS19E280081,AR.TUC-SD020,20ARSD0498,M,1,94250,145000,2,0,29000,1,0,29000,116000,87000
01SCS19E280082,AR.TUC-SB002,20ARSB0029,L,1,204750,315000,2,0,63000,1,0,63000,252000,189000
01SCS19E280083,BSC.AR-RK0019,00ARRK0121,S,1,43000,135000,0,0,0,0,0,27000,135000,108000
01SCS19E280083,BSC.AR-SB0006,00ARSB0071,M,1,44000,135000,0,0,0,0,0,27000,135000,108000
01SCS19E280083,BSC.AR-SB0011,00ARSB0098,L,1,44500,135000,0,0,0,0,0,27000,135000,108000
01SCS19E280083,BSC.AR-SD0052,00ARSD0280,M,1,44500,159000,0,0,0,0,0,31800,159000,127200
01SCS19E280084,BE.RAK-RX328,00BERX1170,XL,1,91000,140000,2,0,28000,1,0,28000,112000,84000
01SCS19E280085,AR.PUB-SB033,20ARSB0464,ALL,1,97500,150000,2,0,30000,1,0,30000,120000,90000
01SCS19E280085,BSC.AR-SC0014,00ARSC0098,L,1,44000,159000,0,0,0,0,0,31800,159000,127200
01SCS19E280085,BSC.AR-SD0006,00ARSD0021,S,1,44000,159000,0,0,0,0,0,31800,159000,127200
01SCS19E280086,ESH.AR-SD0043,00ARSD0395,M,1,125000,315000,0,0,0,0,0,63000,315000,252000
01SCS19E280087,AR.ESB-SE011,20ARSE0279,M,1,227500,350000,2,0,70000,1,0,70000,280000,210000
01SCS19E280088,AR.PUB-SD035,20ARSD0346,L,1,204750,315000,2,0,63000,1,0,63000,252000,189000
01SCS19E280089,AR.TUC-SE023,20ARSE0651,28,1,204750,315000,2,0,63000,1,0,63000,252000,189000
01SCS19E280090,BSC.AR-RJ0020,00ARRJ0116,M,1,44500,135000,0,0,0,0,0,27000,135000,108000
01SCS19E280090,ESH.AR-SC0018,00ARSC0145,M,1,44000,135000,0,0,0,0,0,27000,135000,108000
01SCS19E280091,ESH.AR-SD0014,00ARSD0086,32,1,145000,375000,0,0,0,0,0,75000,375000,300000
01SCS19E280092,BSC.AR-SD0063,00ARSD0338,NON,1,60000,180000,0,0,0,0,0,36000,180000,144000
01SCS19E280093,BSC.AR-SD0033,00ARSD0187,S,1,44500,159000,0,0,0,0,0,31800,159000,127200
01SCS19E280094,AR.ESB-SC003,20ARSC0419,M,1,91000,140000,2,0,28000,1,0,28000,112000,84000
01SCS19E280095,AR.HMR-SB001,20ARSB0337,M,1,237250,365000,2,0,73000,1,0,73000,292000,219000
01SCS19E280096,ESH.AR-SD0009,00ARSD0067,L,1,44500,135000,0,0,0,0,0,27000,135000,108000
01SCS19E280097,BSC.AR-SD0051,00ARSD0254,S,1,44000,159000,0,0,0,0,0,31800,159000,127200
01SCS19E280098,AR.BPH-SD002,20ARSD0364,XL,1,182000,280000,2,0,140000,1,0,35000,140000,105000
01SCS19E280098,BSC.AR-SC0034,00ARSC0231,XL,1,125000,315000,0,0,0,0,0,63000,315000,252000
01SCS19E280098,BSC.AR-SD0023,00ARSD0135,XL,1,44000,159000,0,0,0,0,0,31800,159000,127200
01SCS19E280099,AR.MPR-SE004,20ARSE0151,L,1,97500,150000,2,0,45000,1,0,26250,105000,78750
01SCS19E280099,AR.PUB-SE027,20ARSE0105,L,1,204750,315000,2,0,63000,1,0,63000,252000,189000
01SCS19E280100,BSC.AR-SA0009,00ARSA0035,NON,1,47500,140000,0,0,0,0,0,28000,140000,112000
01SCS19E280101,AR.PUB-SD033,20ARSD0244,L,1,204750,315000,2,0,63000,1,0,63000,252000,189000
01SCS19E280102,AR.CPT-SC010,20ARSC0473,L,1,204750,315000,2,0,63000,1,0,63000,252000,189000
01SCS19E280103,AR.MKV-SE014,20ARSE0588,M,1,22750,350000,0,0,0,0,0,122500,350000,227500
01SCS19E280104,AR.MKV-SE013,20ARSE0584,M,1,22750,350000,0,0,0,0,0,122500,350000,227500
01SCS19E280105,BSC.AR-SC0006,00ARSC0040,L,1,44000,135000,0,0,0,0,0,27000,135000,108000
01SCS19E280105,BSC.AR-SD0009,00ARSD0099,S,1,44000,159000,0,0,0,0,0,31800,159000,127200
01SCS19E280106,BSC.AR-SE0001,00ARSE0058,M,1,44500,159000,0,0,0,0,0,31800,159000,127200
01SCS19E280107,BSC.AR-SD0047,00ARSD0247,NON,1,68000,220000,0,0,0,0,0,44000,220000,176000
01SCS19E280108,AR.TUC-SB002,20ARSB0029,L,1,204750,315000,2,0,63000,1,0,63000,252000,189000
01SCS19E280109,ESH.AR-SE0011,00ARSE0043,L,1,44500,135000,0,0,0,0,0,27000,135000,108000
01SCS19E280110,BSC.AR-SB0003,00ARSB0045,L,1,125000,315000,0,0,0,0,0,63000,315000,252000
01SCS19E280111,BSC.AR-SC0046,00ARSC0298,NON,1,45000,150000,0,0,0,0,0,30000,150000,120000
01SCS19E280112,BSC.AR-SC0049,00ARSC0308,S,1,44500,159000,0,0,0,0,0,31800,159000,127200
01SCS19E280113,BSC.AR-SC0049,00ARSC0310,L,1,44500,159000,0,0,0,0,0,31800,159000,127200
01SCS19E280114,AR.CPT-RE009,20ARRE0702,M,1,204750,315000,2,0,63000,1,0,63000,252000,189000
01SCS19E280115,AR.PUB-SE018,20ARSE0071,L,1,159250,245000,2,0,49000,1,0,49000,196000,147000
01SCS19E280116,AR.YAS-RL004,20ARRL0220,L,1,317850,489000,2,0,97800,1,0,97800,391200,293400
01SCS19E280117,AR.PUB-RL027,20ARRL0433,M,1,191750,295000,2,0,59000,1,0,59000,236000,177000
01SCS19E280118,AR.PCT-SE013,20ARSE0675,L,1,87750,135000,2,0,27000,1,0,27000,108000,81000
01SCS19E280119,AR.MKV-RC024,20ARRC0596,ALL,1,78000,120000,0,0,0,0,0,42000,120000,78000
01SCS19E280120,AR.MKV-SE003,20ARSE0480,30,1,224250,345000,0,0,0,0,0,120750,345000,224250
01SCS19E280121,ESH.AR-SD0007,00ARSD0058,M,1,44500,135000,0,0,0,0,0,27000,135000,108000
01SCS19E280122,AR.PUB-RK008,20ARRK0384,L,1,97500,150000,2,0,30000,1,0,30000,120000,90000
01SCS19E280123,AR.MER-SE005,20ARSE0696,ALL,1,97500,150000,0,0,0,0,0,52500,150000,97500
01SCS19E280124,BSC.AR-SE0001,00ARSE0059,L,1,44500,159000,0,0,0,0,0,31800,159000,127200
01SCS19E280125,ARN.AR-SB0003,00ARSB0090,L,1,95400,159000,0,0,0,0,0,47700,159000,111300
01SCS19E280125,ESH.AR-SC0004,00ARSC0023,L,1,44500,135000,0,0,0,0,0,27000,135000,108000
01SCS19E280125,ESH.AR-SE0025,00ARSE0249,L,1,44500,135000,0,0,0,0,0,27000,135000,108000
01SCS19E280126,AR.YAS-SE017,20ARSE0762,M,1,122850,189000,2,0,37800,1,0,37800,151200,113400
01SCS19E280127,AR.CPT-RE009,20ARRE0703,L,1,204750,315000,2,0,63000,1,0,63000,252000,189000
01SCS19E280128,AR.TUC-RI011,20ARRI0369,XL,1,87750,135000,2,0,27000,1,0,27000,108000,81000
01SCS19E280129,AR.CPT-SC012,20ARSC0480,M,1,204750,315000,2,0,63000,1,0,63000,252000,189000
01SCS19E280130,AR.ESB-SB003,20ARSB0101,M,1,100750,155000,2,0,31000,1,0,31000,124000,93000
01SCS19E280131,AR.PUB-RK014,20ARRK0456,ALL,1,97500,150000,2,0,30000,1,0,30000,120000,90000
01SCS19E280132,AR.ESB-SE008,20ARSE0269,XL,1,100750,155000,2,0,31000,1,0,31000,124000,93000
01SCS19E280133,BSC.AR-SD0005,00ARSD0017,S,1,44500,159000,0,0,0,0,0,31800,159000,127200
01SCS19E280134,ESH.AR-SC0001,00ARSC0002,M,1,125000,315000,0,0,0,0,0,63000,315000,252000
01SCS19E280134,ESH.AR-SD0001,00ARSD0031,L,1,44500,135000,0,0,0,0,0,27000,135000,108000
01SCS19E280135,AR.YAS-SE016,20ARSE0759,L,1,122850,189000,2,0,37800,1,0,37800,151200,113400
01SCS19E280135,ESH.AR-SA0018,00ARSA0121,M,1,44000,135000,0,0,0,0,0,27000,135000,108000
01SCS19E280136,AR.CPT-RE009,20ARRE0703,L,1,204750,315000,2,0,63000,1,0,63000,252000,189000
01SCS19E280137,AR.CPT-SC006,20ARSC0261,M,1,94250,145000,2,0,29000,1,0,29000,116000,87000
01SCS19E280138,AR.REC-SD010,20ARSD0038,M,1,178750,275000,2,0,82500,1,0,48125,192500,144375
01SCS19E280139,AR.ESB-SB003,20ARSB0101,M,1,100750,155000,2,0,31000,1,0,31000,124000,93000
01SCS19E280139,AR.ESB-SB004,20ARSB0106,L,1,91000,140000,2,0,28000,1,0,28000,112000,84000
01SCS19E280139,BSC.AR-RJ0029,00ARRJ0169,L,1,120000,315000,0,0,0,0,0,63000,315000,252000
01SCS19E280139,BSC.AR-SC0005,00ARSC0035,M,1,44500,159000,0,0,0,0,0,31800,159000,127200
01SCS19E280140,AR.PUB-RK018,20ARRK0466,XL,1,191750,295000,2,0,59000,1,0,59000,236000,177000
01SCS19E280141,ESH.AR-SC0010,00ARSC0082,L,1,44500,135000,0,0,0,0,0,27000,135000,108000
01SCS19E280141,ESH.AR-SD0003,00ARSD0043,L,1,44000,135000,0,0,0,0,0,27000,135000,108000
01SCS19E280142,BSC.AR-SE0002,00ARSE0062,M,1,44000,159000,0,0,0,0,0,31800,159000,127200
01SCS19E280143,BE.RAK-SC027,00BESC0106,S,1,201500,310000,2,0,62000,1,0,62000,248000,186000
01SCS19E280144,ESH.AR-SB0003,00ARSB0007,S,1,44000,135000,0,0,0,0,0,27000,135000,108000
01SCS19E280144,ESH.AR-SD0026,00ARSD0266,S,1,44500,135000,0,0,0,0,0,27000,135000,108000
01SCS19E280145,AR.REC-SD018,20ARSD0056,ALL,1,107250,165000,2,0,49500,1,0,28875,115500,86625
01SCS19E280146,AR.CPT-SE002,20ARSE0356,S,1,94250,145000,2,0,29000,1,0,29000,116000,87000
01SCS19E280147,AR.PUB-SC010,20ARSC0294,L,1,97500,150000,2,0,30000,1,0,30000,120000,90000
01SCS19E280147,AR.STY-SA002,20ARSA0061,ALL,1,61750,95000,2,0,19000,1,0,19000,76000,57000
01SCS19E280148,AR.BPH-RB011,20ARRB0466,M,1,103350,159000,2,0,47700,1,0,27825,111300,83475
01SCS19E280149,AR.TUC-SE013,20ARSE0412,M,1,94250,145000,2,0,29000,1,0,29000,116000,87000
01SCS19E280150,AR.CPT-SE003,20ARSE0361,M,1,94250,145000,2,0,29000,1,0,29000,116000,87000
01SCS19E280151,AR.MKV-RJ004,20ARRJ0157,L,1,91000,140000,0,0,0,0,0,49000,140000,91000
01SCS19E280151,AR.PUB-SA004,20ARSA0237,L,1,97500,150000,2,0,30000,1,0,30000,120000,90000
01SCS19E280152,AR.MKV-SB007,20ARSB0329,M,1,292500,450000,0,0,0,0,0,157500,450000,292500
01SCS19E280153,BSC.AR-RL0019,00ARRL0113,S,1,125000,315000,0,0,0,0,0,63000,315000,252000
01SCS19E280154,AR.ESB-SB006,20ARSB0113,M,1,91000,140000,2,0,28000,1,0,28000,112000,84000
01SCS19E280154,AR.SMD-PL014,20ARPL0539,ALL,1,84500,130000,2,0,39000,1,0,22750,91000,68250
01SCS19E280155,ESH.AR-SD0005,00ARSD0050,M,1,44000,135000,0,0,0,0,0,27000,135000,108000
01SCS19E280156,BSC.AR-RJ0020,00ARRJ0117,L,1,44500,135000,0,0,0,0,0,27000,135000,108000
01SCS19E280157,ESH.AR-SE0009,00ARSE0036,XL,1,44500,135000,0,0,0,0,0,27000,135000,108000
01SCS19E280158,BSC.AR-SC0031,00ARSC0208,M,1,44500,135000,0,0,0,0,0,27000,135000,108000
01SCS19E280159,BSC.AR-SB0008,00ARSB0080,L,1,44500,135000,0,0,0,0,0,27000,135000,108000
01SCS19E280160,AR.ESB-SC018,20ARSC0465,M,1,91000,140000,2,0,28000,1,0,28000,112000,84000
01SCS19E280161,AR.ESB-SE021,20ARSE0800,ALL,1,87750,135000,2,0,27000,1,0,27000,108000,81000
01SCS19E280162,AR.MKV-RJ026,20ARRJ0220,ALL,1,97500,150000,0,0,0,0,0,52500,150000,97500
01SCS19E280163,AR.MKV-RJ004,20ARRJ0156,M,1,91000,140000,0,0,0,0,0,49000,140000,91000
01SCS19E280163,AR.SMD-RE004,20ARRE0132,ALL,1,97500,150000,2,0,45000,1,0,26250,105000,78750
01SCS19E280163,AR.TUC-RL023,20ARRL0347,ALL,1,87750,135000,2,0,27000,1,0,27000,108000,81000
01SCS19E280164,AR.CPT-RK011,20ARRK0033,ALL,1,48750,75000,2,0,15000,1,0,15000,60000,45000
01SCS19E280164,BSC.AR-RJ0016,00ARRJ0101,L,1,43000,135000,0,0,0,0,0,27000,135000,108000
01SCS19E280165,AR.PCT-SE017,20ARSE0682,M,1,87750,135000,2,0,27000,1,0,27000,108000,81000
01SCS19E280166,AR.PUB-RL027,20ARRL0434,L,1,191750,295000,2,0,59000,1,0,59000,236000,177000
01SCS19E280167,AR.STY-SE004,20ARSE0122,ALL,1,55250,85000,2,0,17000,1,0,17000,68000,51000
01SCS19E280167,AR.YAS-SE013,20ARSE0746,M,1,122850,189000,2,0,37800,1,0,37800,151200,113400
01SCS19E280168,ESH.AR-SE0006,00ARSE0021,S,1,44000,135000,0,0,0,0,0,27000,135000,108000
01SCS19E280169,AR.SMD-RI001,20ARRI0221,L,1,87750,135000,2,0,40500,1,0,23625,94500,70875
01SCS19E280170,AR.ESB-SD012,20ARSD0323,M,1,91000,140000,2,0,28000,1,0,28000,112000,84000
01SCS19E280171,AR.CPT-SD011,20ARSD0454,M,1,94250,145000,2,0,29000,1,0,29000,116000,87000
01SCS19E280172,AR.CPT-RE013,20ARRE0717,S,1,94250,145000,2,0,29000,1,0,29000,116000,87000
01SCS19E280172,AR.CPT-SD008,20ARSD0442,M,1,204750,315000,2,0,63000,1,0,63000,252000,189000
01SCS19E280172,AR.ESB-RH016,20ARRH0825,M,1,198250,305000,2,0,61000,1,0,61000,244000,183000
01SCS19E280172,BSC.AR-SA0005,00ARSA0022,S,1,44000,135000,0,0,0,0,0,27000,135000,108000
01SCS19E280173,AR.CPT-SD003,20ARSD0139,ALL,1,94250,145000,2,0,29000,1,0,29000,116000,87000
01SCS19E280174,AR.REC-SD014,20ARSD0052,ALL,1,107250,165000,2,0,49500,1,0,28875,115500,86625
01SCS19E280175,AR.BPH-RL003,20ARRL0190,L,1,291850,449000,2,0,224500,1,0,56125,224500,168375
01SCS19E280175,AR.CPT-SC008,20ARSC0271,XL,1,94250,145000,2,0,29000,1,0,29000,116000,87000
01SCS19E280176,AR.PUB-SE013,20ARSE0052,XL,1,159250,245000,2,0,49000,1,0,49000,196000,147000
01SCS19E280177,AR.STY-RJ002,20ARRJ0051,ALL,1,55250,85000,2,0,17000,1,0,17000,68000,51000
01SCS19E280178,AR.ESB-SB006,20ARSB0113,M,1,91000,140000,2,0,28000,1,0,28000,112000,84000
01SCS19E280179,AR.MPR-SE007,20ARSE0163,L,1,97500,150000,2,0,45000,1,0,26250,105000,78750
01SCS19E280180,BSC.AR-SC0019,00ARSC0128,S,1,44500,159000,0,0,0,0,0,31800,159000,127200
01SCS19E280180,BSC.AR-SC0044,00ARSC0296,NON,1,45000,150000,0,0,0,0,0,30000,150000,120000
01SCS19E280180,ESH.AR-SE0010,00ARSE0039,L,1,44000,135000,0,0,0,0,0,27000,135000,108000
01SCS19E280181,BSC.AR-SD0063,00ARSD0338,NON,1,60000,180000,0,0,0,0,0,36000,180000,144000
01SCS19E280182,AR.YAS-RL001,20ARRL0208,M,1,317850,489000,2,0,97800,1,0,97800,391200,293400
01SCS19E280183,AR.CPT-SE001,20ARSE0352,S,1,94250,145000,2,0,29000,1,0,29000,116000,87000
01SCS19E280184,AR.ESB-SE004,20ARSE0250,S,1,94250,145000,2,0,29000,1,0,29000,116000,87000
01SCS19E280185,ESH.AR-SB0007,00ARSB0028,M,1,44000,135000,0,0,0,0,0,27000,135000,108000
01SCS19E280185,ESH.AR-SE0033,00ARSE0304,M,1,52000,155000,0,0,0,0,0,31000,155000,124000
01SCS19E280186,AR.PCT-SE002,20ARSE0339,L,1,87750,135000,2,0,27000,1,0,27000,108000,81000
01SCS19E280186,AR.PUB-SC012,20ARSC0303,XL,1,113750,175000,2,0,35000,1,0,35000,140000,105000
01SCS19E280186,AR.SMD-QF006,20ARQF0710,XL,1,104000,160000,2,0,48000,1,0,28000,112000,84000
01SCS19E280186,AR.YAS-RH009,20ARRH0862,L,1,122850,189000,2,0,37800,1,0,37800,151200,113400
01SCS19E280186,BE.RAK-SA025,00BESA0103,L,1,104000,160000,2,0,32000,1,0,32000,128000,96000
01SCS19E280186,BSC.AR-SE0035,00ARSE0337,30,1,125000,365000,0,0,0,0,0,73000,365000,292000
01SCS19E280187,AR.CPT-SB001,20ARSB0083,M,1,204750,315000,2,0,63000,1,0,63000,252000,189000
01SCS19E280188,THR.AR-QG0014,00ARQG0053,XL,1,949000,949000,0,0,0,0,0,142350,949000,806650
01SCS19E280189,BSC.AR-RI0030,00ARRI0139,NON,1,98000,140000,0,0,0,0,0,28000,140000,112000
01SCS19E280189,BSC.AR-SC0016,00ARSC0112,S,1,44500,135000,0,0,0,0,0,27000,135000,108000
01SCS19E280190,AR.PUB-RJ005,20ARRJ0020,XL,1,97500,150000,2,0,30000,1,0,30000,120000,90000
01SCS19E280190,AR.PUB-SD006,20ARSD0092,ALL,1,81250,125000,2,0,25000,1,0,25000,100000,75000
01SCS19E280190,BSC.AR-RJ0016,00ARRJ0102,XL,1,94500,135000,0,0,0,0,0,27000,135000,108000
01SCS19E280190,BSC.AR-SE0007,00ARSE0083,L,1,44500,159000,0,0,0,0,0,31800,159000,127200
01SCS19E280190,ESH.AR-SE0008,00ARSE0029,S,1,44500,135000,0,0,0,0,0,27000,135000,108000
01SCS19E280191,ESH.AR-SC0012,00ARSC0088,S,1,44000,135000,0,0,0,0,0,27000,135000,108000
01SCS19E280192,ESH.AR-SC0008,00ARSC0070,L,1,44500,135000,0,0,0,0,0,27000,135000,108000
01SCS19E280193,AR.MYA-SC002,20ARSC0040,S,1,220350,339000,2,0,101700,1,0,59325,237300,177975
01SCS19E280193,AR.STY-SE011,20ARSE0577,ALL,1,55250,85000,2,0,17000,1,0,17000,68000,51000
01SCS19E280194,AR.CPT-SC008,20ARSC0270,L,1,94250,145000,2,0,29000,1,0,29000,116000,87000
01SCS19E280194,AR.CPT-SC014,20ARSC0488,M,1,94250,145000,2,0,29000,1,0,29000,116000,87000
01SCS19E280194,AR.SMD-SD004,20ARSD0288,S,1,100750,155000,2,0,46500,1,0,27125,108500,81375
01SCS19E280195,AR.YAS-RL001,20ARRL0208,M,1,317850,489000,2,0,97800,1,0,97800,391200,293400
01SCS19E280196,BE.RAK-SC021,00BESC0078,M,1,201500,310000,2,0,62000,1,0,62000,248000,186000
01SCS19E280197,AR.BPH-RB012,20ARRB0469,S,1,103350,159000,2,0,47700,1,0,27825,111300,83475
01SCS19E280197,AR.CPT-SD010,20ARSD0449,S,1,94250,145000,2,0,29000,1,0,29000,116000,87000
01SCS19E280197,AR.PUB-SD016,20ARSD0131,L,1,97500,150000,2,0,30000,1,0,30000,120000,90000
01SCS19E280198,ESH.AR-SD0018,00ARSD0137,M,1,125000,315000,0,0,0,0,0,63000,315000,252000
01SCS19E280199,ESH.AR-SD0018,00ARSD0138,L,1,125000,315000,0,0,0,0,0,63000,315000,252000
01SCS19E280200,AR.PUB-SE015,20ARSE0058,M,1,159250,245000,2,0,49000,1,0,49000,196000,147000
01SCS19E280201,ESH.AR-SD0039,00ARSD0347,S,1,122500,350000,0,0,0,0,0,70000,350000,280000
01SCS19E280202,ESH.AR-SD0026,00ARSD0266,S,1,44500,135000,0,0,0,0,0,27000,135000,108000
01SCS19E280203,BSC.AR-SE0049,00ARSE0410,S,1,52000,155000,0,0,0,0,0,31000,155000,124000
01SCS19E280204,AR.GTW-SC001,20ARSC0022,M,1,214500,330000,2,0,99000,1,0,57750,231000,173250
01SCS19E280205,AR.CPT-SC011,20ARSC0477,L,1,204750,315000,2,0,63000,1,0,63000,252000,189000
01SCS19E280206,AR.TUC-RK003,20ARRK0087,L,1,204750,315000,2,0,63000,1,0,63000,252000,189000
01SCS19E280206,BSC.AR-SC0009,00ARSC0055,XL,1,125000,315000,0,0,0,0,0,63000,315000,252000
01SCS19E280206,BSC.AR-SD0044,00ARSD0236,M,1,44500,159000,0,0,0,0,0,31800,159000,127200
01SCS19E280207,ESH.AR-SC0006,00ARSC0046,S,1,125000,350000,0,0,0,0,0,70000,350000,280000
01SCS19E280208,AR.TUC-SE013,20ARSE0412,M,1,94250,145000,2,0,29000,1,0,29000,116000,87000
01SCS19E280208,ESH.AR-SB0032,00ARSB0209,M,1,125000,315000,0,0,0,0,0,63000,315000,252000
01SCS19E280209,AR.MKV-SE003,20ARSE0480,30,1,224250,345000,0,0,0,0,0,120750,345000,224250
01SCS19E280210,AR.REC-SD004,20ARSD0015,L,1,107250,165000,2,0,49500,1,0,28875,115500,86625
01SCS19E280211,BSC.AR-SD0058,00ARSD0294,NON,1,50000,150000,0,0,0,0,0,30000,150000,120000
01SCS19E280212,AR.PUB-SE032,20ARSE0327,L,1,204750,315000,2,0,63000,1,0,63000,252000,189000
01SCS19E280213,AR.HLW-SE012,20ARSE0557,L,1,100750,155000,2,0,31000,1,0,31000,124000,93000
01SCS19E280214,BSC.AR-SB0008,00ARSB0080,L,1,44500,135000,0,0,0,0,0,27000,135000,108000
01SCS19E280215,BSC.AR-RJ0009,00ARRJ0073,L,1,94500,135000,0,0,0,0,0,27000,135000,108000
01SCS19E280215,BSC.AR-SE0005,00ARSE0075,L,1,44000,159000,0,0,0,0,0,31800,159000,127200
01SCS19E280216,AR.CPT-RL002,20ARRL0075,M,1,94250,145000,2,0,29000,1,0,29000,116000,87000
01SCS19E280217,AR.MPR-SB010,20ARSB0271,M,1,97500,150000,2,0,45000,1,0,26250,105000,78750
01SCS19E280218,AR.CPT-QL011,20ARQL0168,L,1,204750,315000,2,0,63000,1,0,63000,252000,189000
01SCS19E280219,BSC.AR-SB0003,00ARSB0045,L,1,125000,315000,0,0,0,0,0,63000,315000,252000
01SCS19E280220,AR.MPR-SE024,20ARSE0215,M,1,230750,355000,2,0,71000,1,0,71000,284000,213000
01SCS19E280221,AR.STY-SE010,20ARSE0576,ALL,1,61750,95000,2,0,19000,1,0,19000,76000,57000
01SCS19E280222,AR.ESB-SE006,20ARSE0260,L,1,94250,145000,2,0,29000,1,0,29000,116000,87000
01SCS19E280223,AR.BPH-RK004,20ARRK0050,S,1,103350,159000,2,0,47700,1,0,27825,111300,83475
01SCS19E280223,AR.FHL-RJ002,20ARRJ0420,S,1,91000,140000,2,0,28000,1,0,28000,112000,84000
01SCS19E280224,AR.MKV-SA004,20ARSA0190,ALL,1,87750,135000,0,0,0,0,0,47250,135000,87750
01SCS19E280225,AR.CPT-SE002,20ARSE0358,L,1,94250,145000,2,0,29000,1,0,29000,116000,87000
01SCS19E280225,AR.CPT-SE005,20ARSE0370,L,1,204750,315000,2,0,63000,1,0,63000,252000,189000
01SCS19E280226,ESH.AR-SE0043,00ARSE0418,S,1,125000,315000,0,0,0,0,0,63000,315000,252000
01SCS19E280227,ESH.AR-RI0016,00ARRI0144,NON,1,65000,185000,0,0,0,0,0,37000,185000,148000
01SCS19E280228,AR.ESB-SD011,20ARSD0319,M,1,91000,140000,2,0,28000,1,0,28000,112000,84000
01SCS19E280228,BSC.AR-RH0009,00ARRH0053,NON,1,98000,140000,0,0,0,0,0,28000,140000,112000
01SCS19E280229,AR.CPT-SD007,20ARSD0437,S,1,204750,315000,2,0,63000,1,0,63000,252000,189000
01SCS19E280230,AR.FHL-SC005,20ARSC0342,S,1,110500,170000,2,0,34000,1,0,34000,136000,102000
01SCS19E280230,BSC.AR-SD0029,00ARSD0170,S,1,44500,159000,0,0,0,0,0,31800,159000,127200
01SCS19E280231,AR.TUC-SE010,20ARSE0400,M,1,94250,145000,2,0,29000,1,0,29000,116000,87000
01SCS19E280232,ESH.AR-SA0012,00ARSA0094,M,1,44000,135000,0,0,0,0,0,27000,135000,108000
01SCS19E280233,AR.MPR-SE011,20ARSE0180,XL,1,97500,150000,2,0,45000,1,0,26250,105000,78750
01SCS19E280234,AR.MPR-SE027,20ARSE0227,M,1,243750,375000,2,0,75000,1,0,75000,300000,225000
01SCS19E280235,AR.TUC-SE022,20ARSE0649,L,1,152750,235000,2,0,47000,1,0,47000,188000,141000
01SCS19E280236,AR.PUB-RJ022,20ARRJ0254,ALL,1,97500,150000,2,0,30000,1,0,30000,120000,90000
01SCS19E280237,AR.VLD-SA001,20ARSA0166,M,1,211250,325000,2,0,97500,1,0,56875,227500,170625
01SCS19E280238,AR.MKV-RJ003,20ARRJ0153,XL,1,91000,140000,0,0,0,0,0,49000,140000,91000
01SCS19E280238,BSC.AR-SA0021,00ARSA0107,L,1,44000,135000,0,0,0,0,0,27000,135000,108000
01SCS19E280239,BSC.AR-SC0043,00ARSC0291,XL,1,44000,135000,0,0,0,0,0,27000,135000,108000
01SCS19E280240,AR.ESB-SE004,20ARSE0250,S,1,94250,145000,2,0,29000,1,0,29000,116000,87000
01SCS19E280240,AR.MDG-SA003,20ARSA0289,M,1,94250,145000,2,0,43500,1,0,25375,101500,76125
01SCS19E280241,AR.CPT-SE004,20ARSE0365,M,1,204750,315000,2,0,63000,1,0,63000,252000,189000
01SCS19E280241,BSC.AR-SB0004,00ARSB0049,L,1,44000,135000,0,0,0,0,0,27000,135000,108000
01SCS19E280242,AR.ESB-SD014,20ARSD0330,M,1,91000,140000,2,0,28000,1,0,28000,112000,84000
01SCS19E280242,AR.SMD-PL002,20ARPL0266,M,1,84500,130000,2,0,39000,1,0,22750,91000,68250
01SCS19E280243,BSC.AR-RJ0021,00ARRJ0122,XL,1,94500,135000,0,0,0,0,0,27000,135000,108000
01SCS19E280243,ESH.AR-SC0032,00ARSC0282,L,1,44500,135000,0,0,0,0,0,27000,135000,108000
01SCS19E280244,AR.PUB-SE032,20ARSE0326,M,1,204750,315000,2,0,63000,1,0,63000,252000,189000
01SCS19E280245,AR.HLW-SA006,20ARSA0093,ALL,1,71500,110000,2,0,22000,1,0,22000,88000,66000
01SCS19E280245,BSC.AR-RI0023,00ARRI0132,NON,1,98000,140000,0,0,0,0,0,28000,140000,112000
01SCS19E280246,AR.CPT-SE002,20ARSE0357,M,1,94250,145000,2,0,29000,1,0,29000,116000,87000
01SCS19E280246,AR.MPR-SE013,20ARSE0185,S,1,110500,170000,2,0,51000,1,0,29750,119000,89250
01SCS19E280247,AR.PCT-SE010,20ARSE0669,L,1,211250,325000,2,0,65000,1,0,65000,260000,195000
01SCS19E280248,AR.CPT-SD008,20ARSD0442,M,1,204750,315000,2,0,63000,1,0,63000,252000,189000
01SCS19E280248,AR.HLW-SE012,20ARSE0556,M,1,100750,155000,2,0,31000,1,0,31000,124000,93000
01SCS19E280248,AR.SMD-PL007,20ARQE0274,S,1,84500,130000,2,0,39000,1,0,22750,91000,68250
01SCS19E280249,AR.SMD-SD006,20ARSD0296,S,1,87750,135000,2,0,27000,1,0,27000,108000,81000
01SCS19E280249,BSC.AR-RJ0019,00ARRJ0112,M,1,94500,135000,0,0,0,0,0,27000,135000,108000
01SCS19E280250,AR.ESB-SE002,20ARSE0244,L,1,204750,315000,2,0,63000,1,0,63000,252000,189000
01SCS19E280251,AR.ESB-SE010,20ARSE0275,M,1,227500,350000,2,0,70000,1,0,70000,280000,210000
01SCS19E280252,AR.ESB-RL011,20ARRL0462,ALL,1,91000,140000,2,0,70000,1,0,17500,70000,52500
01SCS19E280252,AR.STY-SE011,20ARSE0577,ALL,1,55250,85000,2,0,17000,1,0,17000,68000,51000
01SCS19E280252,AR.YD-SB005,20ARSB0508,S,1,195000,300000,2,0,90000,1,0,52500,210000,157500
01SCS19E280253,BSC.AR-SE0046,00ARSE0400,L,1,44500,159000,0,0,0,0,0,31800,159000,127200
01SCS19E280254,BSC.AR-SE0035,00ARSE0336,28,1,125000,365000,0,0,0,0,0,73000,365000,292000
01SCS19E280254,ESH.AR-RJ0004,00ARRJ0024,M,1,43000,135000,0,0,0,0,0,27000,135000,108000
01SCS19E280255,BSC.AR-RJ0008,00ARRJ0068,M,1,94500,135000,0,0,0,0,0,27000,135000,108000
01SCS19E280256,AR.PUB-SD010,20ARSD0120,ALL,1,97500,150000,2,0,30000,1,0,30000,120000,90000
01SCS19E280257,AR.STY-SE009,20ARSE0127,ALL,1,55250,85000,2,0,17000,1,0,17000,68000,51000
01SCS19E280258,AR.ESB-SC016,20ARSC0457,M,1,91000,140000,2,0,28000,1,0,28000,112000,84000
01SCS19E280259,AR.SMD-QD002,20ARQD0027,M,1,84500,130000,2,0,39000,1,0,22750,91000,68250
01SCS19E280260,AR.TUC-SD020,20ARSD0497,S,1,94250,145000,2,0,29000,1,0,29000,116000,87000
01SCS19E280261,AR.ESB-SC017,20ARSC0462,L,1,91000,140000,2,0,28000,1,0,28000,112000,84000
01SCS19E280262,BSC.AR-SD0027,00ARSD0157,M,1,125000,315000,0,0,0,0,0,63000,315000,252000
01SCS19E280263,BSC.AR-SD0009,00ARSD0101,L,1,44000,159000,0,0,0,0,0,31800,159000,127200
01SCS19E280264,BSC.AR-SE0049,00ARSE0411,M,1,52000,155000,0,0,0,0,0,31000,155000,124000
01SCS19E280265,AR.TUC-RK028,20ARRK0134,L,1,94250,145000,2,0,29000,1,0,29000,116000,87000
01SCS19E280266,AR.ESB-SD015,20ARSD0334,M,1,91000,140000,2,0,28000,1,0,28000,112000,84000
01SCS19E280267,BSC.AR-SE0031,00ARSE0293,L,1,52000,155000,0,0,0,0,0,31000,155000,124000
01SCS19E280268,AR.HLW-SE004,20ARSE0532,M,1,100750,155000,2,0,31000,1,0,31000,124000,93000
01SCS19E280269,ESH.AR-SE0038,00ARSE0334,L,1,44500,135000,0,0,0,0,0,27000,135000,108000
01SCS19E280270,AR.STY-SE009,20ARSE0127,ALL,1,55250,85000,2,0,17000,1,0,17000,68000,51000
01SCS19E280270,AR.STY-SE011,20ARSE0577,ALL,1,55250,85000,2,0,17000,1,0,17000,68000,51000
01SCS19E280271,AR.CPT-SD012,20ARSD0459,L,1,94250,145000,2,0,29000,1,0,29000,116000,87000
01SCS19E280271,AR.PUB-SE006,20ARSE0023,L,1,97500,150000,2,0,30000,1,0,30000,120000,90000
01SCS19E280272,BSC.AR-SD0058,00ARSD0294,NON,1,50000,150000,0,0,0,0,0,30000,150000,120000
01SCS19E280273,BSC.AR-RK0012,00ARRK0095,L,1,43000,135000,0,0,0,0,0,27000,135000,108000
01SCS19E280274,AR.ESB-SD015,20ARSD0334,M,1,91000,140000,2,0,28000,1,0,28000,112000,84000
01SCS19E280275,AR.CPT-SE006,20ARSE0372,S,1,204750,315000,2,0,63000,1,0,63000,252000,189000
01SCS19E280275,BSC.AR-SD0064,00ARSD0340,M,1,125000,315000,0,0,0,0,0,63000,315000,252000
01SCS19E280276,AR.PUB-SD029,20ARSD0207,ALL,1,97500,150000,2,0,30000,1,0,30000,120000,90000
01SCS19E280277,ESH.AR-SD0010,00ARSD0072,XL,1,44500,135000,0,0,0,0,0,27000,135000,108000
01SCS19E280278,BE.RAK-SC037,00BESC0157,S,1,91000,140000,2,0,28000,1,0,28000,112000,84000
01SCS19E280279,AR.ESB-RL012,20ARRL0463,ALL,1,91000,140000,2,0,70000,1,0,17500,70000,52500
01SCS19E280280,AR.CPT-RE009,20ARRE0702,M,1,204750,315000,2,0,63000,1,0,63000,252000,189000
01SCS19E280281,BSC.AR-RL0019,00ARRL0114,M,1,125000,315000,0,0,0,0,0,63000,315000,252000
01SCS19E280282,AR.PUB-SE029,20ARSE0113,L,1,224250,345000,2,0,69000,1,0,69000,276000,207000
01SCS19E280283,AR.STY-SE007,20ARSE0125,ALL,1,55250,85000,2,0,17000,1,0,17000,68000,51000
01SCS19E280284,AR.STY-SE002,20ARSE0120,ALL,1,55250,85000,2,0,17000,1,0,17000,68000,51000
01SCS19E280285,AR.MPR-SE025,20ARSE0220,L,1,230750,355000,2,0,71000,1,0,71000,284000,213000
01SCS19E280286,AR.MKV-SE009,20ARSE0509,28,1,227500,350000,0,0,0,0,0,122500,350000,227500
01SCS19E280287,AR.ESB-SD010,20ARSD0183,S,1,91000,140000,2,0,28000,1,0,28000,112000,84000
01SCS19E280287,AR.MYA-SC003,20ARSC0045,32,1,220350,339000,2,0,101700,1,0,59325,237300,177975
01SCS19E280288,AR.ESB-SA002,20ARSA0209,L,1,204750,315000,2,0,63000,1,0,63000,252000,189000
01SCS19E280289,BSC.AR-SC0024,00ARSC0179,L,1,125000,315000,0,0,0,0,0,63000,315000,252000
01SCS19E280290,AR.CPT-SC012,20ARSC0480,M,1,204750,315000,2,0,63000,1,0,63000,252000,189000
01SCS19E280291,AR.CPT-QL011,20ARQL0167,M,1,204750,315000,2,0,63000,1,0,63000,252000,189000
01SCS19E280292,ARN.AR-RK0001,00ARRK0220,L,1,43000,140000,0,0,0,0,0,42000,140000,98000
01SCS19E280293,AR.ESB-SE002,20ARSE0243,M,1,204750,315000,2,0,63000,1,0,63000,252000,189000
01SCS19E280294,BSC.AR-SD0058,00ARSD0294,NON,1,50000,150000,0,0,0,0,0,30000,150000,120000
01SCS19E280295,AR.CPT-SC009,20ARSC0272,S,1,94250,145000,2,0,29000,1,0,29000,116000,87000
01SCS19E280295,AR.SMD-RI002,20ARRI0224,M,1,87750,135000,2,0,40500,1,0,23625,94500,70875
01SCS19E280295,ESH.AR-SE0039,00ARSE0362,S,1,44000,135000,0,0,0,0,0,27000,135000,108000
01SCS19E280296,BSC.AR-RH0027,00ARRH0169,30,1,245000,350000,0,0,0,0,0,70000,350000,280000
01SCS19E280297,AR.TUC-SB002,20ARSB0029,L,1,204750,315000,2,0,63000,1,0,63000,252000,189000
01SCS19E280298,BE.RAK-RX538,00BERX2231,L,1,91000,140000,2,0,28000,1,0,28000,112000,84000
01SCS19E280298,BSC.AR-RL0028,00ARRL0178,S,1,44500,135000,0,0,0,0,0,27000,135000,108000
01SCS19E280299,BSC.AR-SD0049,00ARSD0249,NON,2,45000,135000,0,0,0,0,0,27000,270000,216000
01SCS19E280300,AR.PUB-SE032,20ARSE0326,M,1,204750,315000,2,0,63000,1,0,63000,252000,189000
01SCS19E280301,AR.ESB-SC003,20ARSC0419,M,1,91000,140000,2,0,28000,1,0,28000,112000,84000
01SCS19E280302,ESH.AR-SB0021,00ARSB0121,L,1,44500,135000,0,0,0,0,0,27000,135000,108000
01SCS19E280303,BSC.AR-SC0033,00ARSC0226,L,1,125000,315000,0,0,0,0,0,63000,315000,252000
01SCS19E280304,AR.MER-QJ005,20ARQJ0409,ALL,1,84500,130000,2,0,39000,1,0,22750,91000,68250
01SCS19E280304,BE.RAK-RX624,00BERX2666,M,1,110500,170000,2,0,34000,1,0,34000,136000,102000
01SCS19E280305,AR.REC-SD029,20ARSD0076,ALL,1,32500,50000,2,0,15000,1,0,8750,35000,26250
01SCS19E280305,BSC.AR-SB0010,00ARSB0092,S,1,125000,315000,0,0,0,0,0,63000,315000,252000
01SCS19E280306,ESH.AR-SA0008,00ARSA0084,M,1,113450,350000,0,0,0,0,0,70000,350000,280000
01SCS19E280307,AR.PUB-SA003,20ARSA0231,S,1,97500,150000,2,0,30000,1,0,30000,120000,90000
01SCS19E280307,ESH.AR-SD0018,00ARSD0138,L,1,125000,315000,0,0,0,0,0,63000,315000,252000
01SCS19E280308,AR.CPT-RL002,20ARRL0075,M,1,94250,145000,2,0,29000,1,0,29000,116000,87000
01SCS19E280309,AR.CPT-QL011,20ARQL0167,M,1,204750,315000,2,0,63000,1,0,63000,252000,189000
01SCS19E280309,AR.CPT-RH007,20ARRH0065,ALL,1,94250,145000,2,0,29000,1,0,29000,116000,87000
01SCS19E280309,AR.HLW-SE013,20ARSE0559,M,1,100750,155000,2,0,31000,1,0,31000,124000,93000
01SCS19E280309,AR.PCT-SE010,20ARSE0669,L,1,211250,325000,2,0,65000,1,0,65000,260000,195000
01SCS19E280310,ESH.AR-SE0012,00ARSE0047,L,1,44500,135000,0,0,0,0,0,27000,135000,108000
01SCS19E280311,BSC.AR-SD0022,00ARSD0130,L,1,44000,159000,0,0,0,0,0,31800,159000,127200
01SCS19E280312,AR.ESB-RK001,20ARRK0224,M,1,201500,310000,2,0,62000,1,0,62000,248000,186000
01SCS19E280313,AR.HLW-SA006,20ARSA0093,ALL,1,71500,110000,2,0,22000,1,0,22000,88000,66000
01SCS19E280314,BSC.AR-SD0012,00ARSD0105,NON,1,18000,75000,0,0,0,0,0,15000,75000,60000
01SCS19E280315,AR.CPT-SE002,20ARSE0357,M,1,94250,145000,2,0,29000,1,0,29000,116000,87000
01SCS19E280316,AR.MPR-SE018,20ARSE0202,ALL,1,110500,170000,2,0,51000,1,0,29750,119000,89250
01SCS19E280317,AR.PUB-SE033,20ARSE0630,M,1,97500,150000,2,0,30000,1,0,30000,120000,90000
01SCS19E280318,AR.SMD-SD007,20ARSD0301,M,1,211250,325000,2,0,65000,1,0,65000,260000,195000
01SCS19E280319,AR.MDS-RE010,20ARRE0667,L,1,234000,360000,2,0,72000,1,0,72000,288000,216000
01SCS19E280320,BE.RAK-SC014,00BESC0045,L,1,204750,315000,2,0,63000,1,0,63000,252000,189000
01SCS19E280321,AR.MPR-SE002,20ARSE0142,M,1,97500,150000,2,0,45000,1,0,26250,105000,78750
01SCS19E280322,AR.PUB-SE028,20ARSE0108,M,1,204750,315000,2,0,63000,1,0,63000,252000,189000
01SCS19E280323,BSC.AR-RH0024,00ARRH0157,L,1,245000,350000,0,0,0,0,0,70000,350000,280000
01SCS19E280323,BSC.AR-SD0046,00ARSD0245,L,1,44500,159000,0,0,0,0,0,31800,159000,127200
01SCS19E280324,AR.ESB-SD015,20ARSD0334,M,1,91000,140000,2,0,28000,1,0,28000,112000,84000
01SCS19E280325,AR.PUB-SB024,20ARSB0129,M,1,97500,150000,2,0,30000,1,0,30000,120000,90000
01SCS19E280325,AR.PUB-SD019,20ARSD0188,ALL,1,97500,150000,2,0,30000,1,0,30000,120000,90000
01SCS19E280325,ESH.AR-SE0001,00ARSE0003,L,1,44000,135000,0,0,0,0,0,27000,135000,108000
01SCS19E280326,AR.CPT-SE001,20ARSE0353,M,1,94250,145000,2,0,29000,1,0,29000,116000,87000
01SCS19E280326,AR.PUB-SE006,20ARSE0022,M,1,97500,150000,2,0,30000,1,0,30000,120000,90000
01SCS19E280327,AR.TUC-QH027,20ARQH0349,XL,1,97500,150000,2,0,30000,1,0,30000,120000,90000
01SCS19E280328,AR.CLB-SE001,20ARSE0697,ALL,1,185250,285000,2,0,57000,1,0,57000,228000,171000
01SCS19E280329,AR.MKV-RJ001,20ARRJ0142,L,1,91000,140000,0,0,0,0,0,49000,140000,91000
01SCS19E280330,ESH.AR-SE0020,00ARSE0126,M,1,44000,135000,0,0,0,0,0,27000,135000,108000
01SCS19E280331,BSC.AR-SC0039,00ARSC0254,M,1,190000,475000,0,0,0,0,0,95000,475000,380000
01SCS19E280332,AR.MKV-SE004,20ARSE0487,34,1,214500,330000,0,0,0,0,0,115500,330000,214500
01SCS19E280332,AR.PUB-SC008,20ARSC0285,M,1,97500,150000,2,0,30000,1,0,30000,120000,90000
01SCS19E280332,AR.TUC-SA024,20ARSA0152,L,1,87750,135000,2,0,27000,1,0,27000,108000,81000
01SCS19E280333,BSC.AR-SA0014,00ARSA0040,NON,1,47500,140000,0,0,0,0,0,28000,140000,112000
01SCS19E280333,BSC.AR-SC0044,00ARSC0296,NON,1,45000,150000,0,0,0,0,0,30000,150000,120000
01SCS19E280333,ESH.AR-SA0012,00ARSA0094,M,1,44000,135000,0,0,0,0,0,27000,135000,108000
01SCS19E280333,ESH.AR-SB0011,00ARSB0052,M,1,125000,315000,0,0,0,0,0,63000,315000,252000
01SCS19E280334,AR.KNR-RK006,20ARRK0271,L,1,136500,210000,2,0,63000,1,0,36750,147000,110250
01SCS19E280335,AR.PUB-SA003,20ARSA0231,S,1,97500,150000,2,0,30000,1,0,30000,120000,90000
01SCS19E280336,BE.RAK-RL021,00BERL0069,XL,1,211250,325000,2,0,65000,1,0,65000,260000,195000
01SCS19E280337,AR.ESB-SD014,20ARSD0332,XL,1,91000,140000,2,0,28000,1,0,28000,112000,84000
01SCS19E280337,ESH.AR-SD0034,00ARSD0314,XL,1,44000,135000,0,0,0,0,0,27000,135000,108000
01SCS19E280338,BSC.AR-RI0038,00ARRI0214,S,1,262500,375000,0,0,0,0,0,75000,375000,300000
01SCS19E280339,AR.PUB-SD001,20ARSD0082,M,1,204750,315000,2,0,63000,1,0,63000,252000,189000
01SCS19E280340,ESH.AR-SE0037,00ARSE0330,L,1,44000,135000,0,0,0,0,0,27000,135000,108000
01SCS19E280341,AR.CPT-SE005,20ARSE0369,M,1,204750,315000,2,0,63000,1,0,63000,252000,189000
01SCS19E280342,BSC.AR-RL0020,00ARRL0119,L,1,125000,315000,0,0,0,0,0,63000,315000,252000
01SCS19E280343,BSC.AR-RH0009,00ARRH0053,NON,1,98000,140000,0,0,0,0,0,28000,140000,112000
01SCS19E280343,ESH.AR-RJ0026,00ARRJ0228,M,1,220500,315000,0,0,0,0,0,63000,315000,252000
01SCS19E280344,BSC.AR-SE0003,00ARSE0066,M,1,44000,159000,0,0,0,0,0,31800,159000,127200
01SCS19E280345,ESH.AR-SC0007,00ARSC0062,L,1,125000,350000,0,0,0,0,0,70000,350000,280000
01SCS19E280346,AR.MPR-SE005,20ARSE0156,XL,1,97500,150000,2,0,45000,1,0,26250,105000,78750
01SCS19E280347,AR.CPT-SD010,20ARSD0450,M,1,94250,145000,2,0,29000,1,0,29000,116000,87000
01SCS19E280347,AR.MKV-SE011,20ARSE0520,30,1,227500,350000,0,0,0,0,0,122500,350000,227500
01SCS19E280348,BSC.AR-SE0046,00ARSE0400,L,1,44500,159000,0,0,0,0,0,31800,159000,127200
01SCS19E280348,ESH.AR-SD0040,00ARSD0367,M,1,122500,350000,0,0,0,0,0,70000,350000,280000
01SCS19E280349,AR.PUB-SE006,20ARSE0022,M,1,97500,150000,2,0,30000,1,0,30000,120000,90000
01SCS19E280350,AR.REC-SD004,20ARSD0014,M,1,107250,165000,2,0,49500,1,0,28875,115500,86625
01SCS19E280350,BSC.AR-SE0028,00ARSE0279,S,1,130000,375000,0,0,0,0,0,75000,375000,300000
01SCS19E280351,AR.PUB-SE021,20ARSE0080,M,1,159250,245000,2,0,49000,1,0,49000,196000,147000
01SCS19E280351,AR.TUC-SA008,20ARSA0026,ALL,1,81250,125000,2,0,25000,1,0,25000,100000,75000
01SCS19E280352,AR.CPT-SD008,20ARSD0441,S,1,204750,315000,2,0,63000,1,0,63000,252000,189000
01SCS19E280353,AR.MKV-SE021,20ARSE0614,XL,1,97500,150000,0,0,0,0,0,52500,150000,97500
01SCS19E280353,AR.PUB-RH010,20ARRH0026,L,1,97500,150000,2,0,30000,1,0,30000,120000,90000
01SCS19E280353,ESH.AR-SC0015,00ARSC0121,M,1,44000,135000,0,0,0,0,0,27000,135000,108000
01SCS19E280354,ESH.AR-SE0002,00ARSE0005,S,1,44500,135000,0,0,0,0,0,27000,135000,108000
01SCS19E280355,BSC.AR-SD0016,00ARSD0119,M,1,122000,375000,0,0,0,0,0,75000,375000,300000
01SCS19E280356,AR.PUB-SA001,20ARSA0080,L,1,97500,150000,2,0,30000,1,0,30000,120000,90000
01SCS19E280356,ESH.AR-RK0014,00ARRK0187,S,1,112500,350000,0,0,0,0,0,70000,350000,280000
01SCS19E280357,AR.MKV-SE001,20ARSE0473,36,1,214500,330000,0,0,0,0,0,115500,330000,214500
01SCS19E280358,BE.RAK-SA026,00BESA0108,L,1,91000,140000,2,0,28000,1,0,28000,112000,84000
01SCS19E280359,AR.STY-SE002,20ARSE0120,ALL,1,55250,85000,2,0,17000,1,0,17000,68000,51000
01SCS19E280360,BSC.AR-SE0035,00ARSE0338,32,1,125000,365000,0,0,0,0,0,73000,365000,292000
01SCS19E280361,ESH.AR-SC0032,00ARSC0281,M,1,44500,135000,0,0,0,0,0,27000,135000,108000
01SCS19E280362,BSC.AR-SC0001,00ARSC0014,M,1,125000,315000,0,0,0,0,0,63000,315000,252000
01SCS19E280363,AR.CPT-SC012,20ARSC0481,L,1,204750,315000,2,0,63000,1,0,63000,252000,189000
01SCS19E280364,ESH.AR-SD0026,00ARSD0266,S,1,44500,135000,0,0,0,0,0,27000,135000,108000
01SCS19E280365,AR.PCT-SE002,20ARSE0339,L,1,87750,135000,2,0,27000,1,0,27000,108000,81000
01SCS19E280366,AR.PUB-SD001,20ARSD0082,M,1,204750,315000,2,0,63000,1,0,63000,252000,189000
01SCS19E280367,AR.CPT-SD006,20ARSD0433,S,1,200850,309000,2,0,61800,1,0,61800,247200,185400
01SCS19E280368,AR.PCT-SE020,20ARSE0689,L,1,87750,135000,2,0,27000,1,0,27000,108000,81000
01SCS19E280369,BE.RAK-SA025,00BESA0103,L,1,104000,160000,2,0,32000,1,0,32000,128000,96000
01SCS19E280370,AR.SMD-RE002,20ARRE0130,ALL,1,97500,150000,2,0,45000,1,0,26250,105000,78750
01SCS19E280370,ESH.AR-SC0037,00ARSC0302,NON,1,40000,140000,0,0,0,0,0,28000,140000,112000
01SCS19E280371,ESH.AR-SC0006,00ARSC0046,S,1,125000,350000,0,0,0,0,0,70000,350000,280000
01SCS19E280372,AR.MPR-SE013,20ARSE0187,L,1,110500,170000,2,0,51000,1,0,29750,119000,89250
01SCS19E280373,AR.CPT-SB001,20ARSB0082,S,1,204750,315000,2,0,63000,1,0,63000,252000,189000
01SCS19E280373,AR.CPT-SB001,20ARSB0083,M,1,204750,315000,2,0,63000,1,0,63000,252000,189000
01SCS19E280374,AR.ESB-SC004,20ARSC0423,M,1,94250,145000,2,0,29000,1,0,29000,116000,87000
01SCS19E280375,AR.CPT-RE013,20ARRE0718,M,1,94250,145000,2,0,29000,1,0,29000,116000,87000
01SCS19E280375,BSC.AR-SD0004,00ARSD0015,L,1,44000,159000,0,0,0,0,0,31800,159000,127200
01SCS19E280376,AR.ESB-QF004,20ARQF0017,M,1,162500,250000,2,0,50000,1,0,50000,200000,150000
01SCS19E280377,AR.PUB-SE032,20ARSE0325,S,1,204750,315000,2,0,63000,1,0,63000,252000,189000
01SCS19E280378,AR.MPR-SE031,20ARSE0297,L,1,230750,355000,2,0,71000,1,0,71000,284000,213000
01SCS19E280379,AR.PUB-SD017,20ARSD0135,L,1,204750,315000,2,0,63000,1,0,63000,252000,189000
01SCS19E280380,AR.VLD-RK008,20ARRK0327,ALL,1,91000,140000,2,0,42000,1,0,24500,98000,73500
01SCS19E280381,AR.CLB-SE007,20ARSE0703,ALL,1,185250,285000,2,0,57000,1,0,57000,228000,171000
01SCS19E280381,AR.CPT-QL011,20ARQL0166,S,1,204750,315000,2,0,63000,1,0,63000,252000,189000
01SCS19E280382,BSC.AR-RJ0033,00ARRJ0216,NON,1,18000,75000,0,0,0,0,0,15000,75000,60000
01SCS19E280382,BSC.AR-SD0030,00ARSD0175,M,1,44500,159000,0,0,0,0,0,31800,159000,127200
01SCS19E280383,ESH.AR-SC0028,00ARSC0267,L,1,44500,135000,0,0,0,0,0,27000,135000,108000
01SCS19E280384,AR.ESB-SE013,20ARSE0771,L,1,91000,140000,2,0,28000,1,0,28000,112000,84000
01SCS19E280385,ESH.AR-SE0011,00ARSE0043,L,1,44500,135000,0,0,0,0,0,27000,135000,108000
01SCS19E280386,AR.ASH-RJ001,20ARRJ0119,32,1,273000,420000,2,0,210000,1,0,52500,210000,157500
01SCS19E280386,AR.CPT-SD008,20ARSD0443,L,1,204750,315000,2,0,63000,1,0,63000,252000,189000
01SCS19E280386,AR.SMD-SD006,20ARSD0299,XL,1,87750,135000,2,0,27000,1,0,27000,108000,81000
01SCS19E280387,ESH.AR-SB0021,00ARSB0121,L,1,44500,135000,0,0,0,0,0,27000,135000,108000
01SCS19E280388,AR.CLB-SE008,20ARSE0704,ALL,1,185250,285000,2,0,57000,1,0,57000,228000,171000
01SCS19E280389,AR.PUB-SC008,20ARSC0285,M,1,97500,150000,2,0,30000,1,0,30000,120000,90000
01SCS19E280389,AR.SMD-RI002,20ARRI0225,L,1,87750,135000,2,0,40500,1,0,23625,94500,70875
01SCS19E280390,ESH.AR-SB0031,00ARSB0205,M,1,44500,135000,0,0,0,0,0,27000,135000,108000
01SCS19E280391,AR.PUB-SA002,20ARSA0130,L,1,224250,345000,2,0,69000,1,0,69000,276000,207000
01SCS19E280391,ESH.AR-SD0044,00ARSD0398,S,1,125000,315000,0,0,0,0,0,63000,315000,252000
01SCS19E280392,ESH.AR-SD0024,00ARSD0259,M,1,44500,135000,0,0,0,0,0,27000,135000,108000
01SCS19E280393,AR.PUB-SE006,20ARSE0022,M,1,97500,150000,2,0,30000,1,0,30000,120000,90000
01SCS19E280393,AR.PUB-SE033,20ARSE0630,M,1,97500,150000,2,0,30000,1,0,30000,120000,90000
01SCS19E280394,AR.CPT-RL014,20ARRL0311,ALL,1,94250,145000,2,0,29000,1,0,29000,116000,87000
01SCS19E280395,AR.ESB-SC001,20ARSC0305,M,1,204750,315000,2,0,63000,1,0,63000,252000,189000
01SCS19E280396,BSC.AR-SE0035,00ARSE0336,28,1,125000,365000,0,0,0,0,0,73000,365000,292000
01SCS19E280397,AR.CPT-SE001,20ARSE0353,M,1,94250,145000,2,0,29000,1,0,29000,116000,87000
01SCS19E280398,AR.TUC-SB002,20ARSB0030,XL,1,204750,315000,2,0,63000,1,0,63000,252000,189000
01SCS19E280399,AR.ESB-SC003,20ARSC0420,L,1,91000,140000,2,0,28000,1,0,28000,112000,84000
01SCS19E280399,ESH.AR-RJ0003,00ARRJ0020,M,1,43000,135000,0,0,0,0,0,27000,135000,108000
01SCS19E280399,ESH.AR-SE0026,00ARSE0252,M,1,44000,135000,0,0,0,0,0,27000,135000,108000
01SCS19E280400,ESH.AR-SB0006,00ARSB0025,L,1,44500,135000,0,0,0,0,0,27000,135000,108000
01SCS19E280401,AR.MER-RC004,20ARSE0690,ALL,1,97500,150000,2,0,45000,1,0,26250,105000,78750
01SCS19E280402,AR.TUC-RH004,20ARRH0666,L,1,204750,315000,2,0,63000,1,0,63000,252000,189000
01SCS19E280403,AR.PUB-SB022,20ARSB0121,M,1,97500,150000,2,0,30000,1,0,30000,120000,90000
01SCS19E280404,AR.HMR-SB025,20ARSB0416,32,1,194350,299000,2,0,59800,1,0,59800,239200,179400
01SCS19E280404,AR.VRS-SE001,20ARSE0317,32,1,298350,459000,2,0,137700,1,0,80325,321300,240975
01SCS19E280405,AR.PUB-SE023,20ARSE0089,L,1,159250,245000,2,0,49000,1,0,49000,196000,147000
01SCS19E280406,AR.SMD-RH005,20ARRH0744,L,1,211250,325000,2,0,97500,1,0,56875,227500,170625
01SCS19E280406,BSC.AR-SC0048,00ARSC0306,L,1,44500,159000,0,0,0,0,0,31800,159000,127200
01SCS19E280407,BSC.AR-SE0039,00ARSE0355,M,1,52000,155000,0,0,0,0,0,31000,155000,124000
01SCS19E280408,AR.ESB-SE007,20ARSE0263,M,1,94250,145000,2,0,29000,1,0,29000,116000,87000
01SCS19E280408,AR.PUB-SE021,20ARSE0080,M,1,159250,245000,2,0,49000,1,0,49000,196000,147000
01SCS19E280409,AR.ESB-SE006,20ARSE0260,L,1,94250,145000,2,0,29000,1,0,29000,116000,87000
01SCS19E280410,AR.CPT-SE006,20ARSE0372,S,1,204750,315000,2,0,63000,1,0,63000,252000,189000
01SCS19E280410,AR.GTW-SC001,20ARSC0021,S,1,214500,330000,2,0,99000,1,0,57750,231000,173250
01SCS19E280411,AR.PUB-SB024,20ARSB0130,L,1,97500,150000,2,0,30000,1,0,30000,120000,90000
01SCS19E280412,AR.PUB-SB040,20ARSB0525,M,1,204750,315000,2,0,63000,1,0,63000,252000,189000
01SCS19E280413,BE.RAK-RX624,00BERX2666,M,1,110500,170000,2,0,34000,1,0,34000,136000,102000
01SCS19E280414,AR.HLW-SE004,20ARSE0532,M,1,100750,155000,2,0,31000,1,0,31000,124000,93000
01SCS19E280415,AR.CPT-RI006,20ARRI0062,L,1,94250,145000,2,0,29000,1,0,29000,116000,87000
01SCS19E280415,AR.ESB-SE007,20ARSE0264,L,1,94250,145000,2,0,29000,1,0,29000,116000,87000
01SCS19E280416,ESH.AR-SD0018,00ARSD0139,XL,1,125000,315000,0,0,0,0,0,63000,315000,252000
01SCS19E280417,THR.AR-RG0006,00ARRG0052,L,1,415000,415000,0,0,0,0,0,62250,415000,352750
01SCS19E280418,AR.TUC-SA024,20ARSA0152,L,1,87750,135000,2,0,27000,1,0,27000,108000,81000
01SCS19E280419,ESH.AR-SD0019,00ARSD0141,M,1,125000,315000,0,0,0,0,0,63000,315000,252000
01SCS19E280420,AR.TUC-SB012,20ARSB0198,XL,1,204750,315000,2,0,63000,1,0,63000,252000,189000
01SCS19E280421,ESH.AR-SC0017,00ARSC0142,L,1,44000,135000,0,0,0,0,0,27000,135000,108000
01SCS19E280422,AR.PUB-SE032,20ARSE0326,M,1,204750,315000,2,0,63000,1,0,63000,252000,189000
01SCS19E280423,BSC.AR-SD0002,00ARSD0007,L,1,44000,159000,0,0,0,0,0,31800,159000,127200
01SCS19E280424,AR.ESB-SD006,20ARSD0118,L,1,204750,315000,2,0,63000,1,0,63000,252000,189000
01SCS19E280425,AR.ESB-SE021,20ARSE0800,ALL,1,87750,135000,2,0,27000,1,0,27000,108000,81000
01SCS19E280426,AR.PUB-SD015,20ARSD0126,M,1,97500,150000,2,0,30000,1,0,30000,120000,90000
01SCS19E280426,BSC.AR-SE0040,00ARSE0359,M,1,44500,159000,0,0,0,0,0,31800,159000,127200
01SCS19E290001,AR.PUB-SC017,20ARSC0370,L,1,204750,315000,2,0,63000,1,0,63000,252000,189000
01SCS19E290002,AR.TUC-SD017,20ARSD0487,L,1,94250,145000,2,0,29000,1,0,29000,116000,87000
01SCS19E290003,AR.STY-SE013,20ARSE0579,ALL,1,55250,85000,2,0,17000,1,0,17000,68000,51000
01SCS19E290003,AR.STY-SE016,20ARSE0582,ALL,1,55250,85000,2,0,17000,1,0,17000,68000,51000
01SCS19E290004,ESH.AR-SE0031,00ARSE0272,M,1,125000,315000,0,0,0,0,0,63000,315000,252000
01SCS19E290005,AR.TUC-SD004,20ARSD0153,M,1,204750,315000,2,0,63000,1,0,63000,252000,189000
01SCS19E290005,ESH.AR-SC0027,00ARSC0262,M,1,125000,315000,0,0,0,0,0,63000,315000,252000
01SCS19E290006,BSC.AR-SE0046,00ARSE0398,S,1,44500,159000,0,0,0,0,0,31800,159000,127200
01SCS19E290006,ESH.AR-SC0012,00ARSC0088,S,1,44000,135000,0,0,0,0,0,27000,135000,108000
01SCS19E290007,AR.PUB-SB024,20ARSB0130,L,1,97500,150000,2,0,30000,1,0,30000,120000,90000
01SCS19E290008,BSC.AR-SE0015,00ARSE0183,S,1,44000,159000,0,0,0,0,0,31800,159000,127200
01SCS19E290009,AR.ASH-SD002,20ARSD0386,L,1,91000,140000,2,0,70000,1,0,17500,70000,52500
01SCS19E290009,AR.CPT-SD007,20ARSD0439,L,1,204750,315000,2,0,63000,1,0,63000,252000,189000
01SCS19E290009,AR.PUB-SD019,20ARSD0188,ALL,1,97500,150000,2,0,30000,1,0,30000,120000,90000
01SCS19E290009,AR.STY-SE013,20ARSE0579,ALL,1,55250,85000,2,0,17000,1,0,17000,68000,51000
01SCS19E290010,AR.HMR-SD007,20ARSD0545,M,1,243750,375000,2,0,75000,1,0,75000,300000,225000
01SCS19E290010,AR.TUC-SE017,20ARSE0428,L,1,146250,225000,2,0,45000,1,0,45000,180000,135000
01SCS19E290010,ESH.AR-SD0026,00ARSD0267,M,1,44500,135000,0,0,0,0,0,27000,135000,108000
01SCS19E290011,BSC.AR-SE0029,00ARSE0285,L,1,125000,315000,0,0,0,0,0,63000,315000,252000
01SCS19E290012,BSC.AR-SC0001,00ARSC0013,S,1,125000,315000,0,0,0,0,0,63000,315000,252000
01SCS19E290013,BSC.AR-SD0016,00ARSD0119,M,1,122000,375000,0,0,0,0,0,75000,375000,300000
01SCS19E290014,ESH.AR-SD0005,00ARSD0052,XL,1,44000,135000,0,0,0,0,0,27000,135000,108000
01SCS19E290014,ESH.AR-SE0005,00ARSE0020,XL,1,44500,135000,0,0,0,0,0,27000,135000,108000
01SCS19E290015,AR.HMR-SB002,20ARSB0343,XL,1,226850,349000,2,0,69800,1,0,69800,279200,209400
01SCS19E290016,AR.PUB-SE031,20ARSE0324,L,1,204750,315000,2,0,63000,1,0,63000,252000,189000
01SCS19E290017,AR.FHL-SC006,20ARSC0349,XL,1,110500,170000,2,0,34000,1,0,34000,136000,102000
01SCS19E290017,ESH.AR-SC0027,00ARSC0264,XL,1,125000,315000,0,0,0,0,0,63000,315000,252000
01SCS19E290018,ESH.AR-SC0013,00ARSC0105,M,1,44500,135000,0,0,0,0,0,27000,135000,108000
01SCS19E290019,AR.CPT-SD008,20ARSD0442,M,1,204750,315000,2,0,63000,1,0,63000,252000,189000
01SCS19E290020,AR.TUC-RI011,20ARRI0369,XL,1,87750,135000,2,0,27000,1,0,27000,108000,81000
01SCS19E290020,AR.YAS-SE018,20ARSE0768,XL,1,122850,189000,2,0,37800,1,0,37800,151200,113400
01SCS19E290021,BSC.AR-SD0041,00ARSD0224,M,1,44500,159000,0,0,0,0,0,31800,159000,127200
01SCS19E290022,BSC.AR-SD0040,00ARSD0217,L,1,44500,159000,0,0,0,0,0,31800,159000,127200
01SCS19E290023,AR.CPT-SD008,20ARSD0441,S,1,204750,315000,2,0,63000,1,0,63000,252000,189000
01SCS19E290023,AR.PCT-SE017,20ARSE0682,M,1,87750,135000,2,0,27000,1,0,27000,108000,81000
01SCS19E290024,AR.ESB-SB001,20ARSB0021,M,1,204750,315000,2,0,63000,1,0,63000,252000,189000
01SCS19E290025,AR.SMD-SB001,20ARSB0192,M,1,211250,325000,2,0,65000,1,0,65000,260000,195000
01SCS19E290026,ESH.AR-SA0012,00ARSA0093,S,1,44000,135000,0,0,0,0,0,27000,135000,108000
01SCS19E290027,ESH.AR-SE0030,00ARSE0267,S,1,125000,315000,0,0,0,0,0,63000,315000,252000
01SCS19E290028,AR.MKV-SE020,20ARSE0608,S,1,97500,150000,0,0,0,0,0,52500,150000,97500
01SCS19E290029,AR.TUC-SD004,20ARSD0155,XL,1,204750,315000,2,0,63000,1,0,63000,252000,189000
01SCS19E290030,AR.MKV-SE015,20ARSE0592,M,1,22750,350000,0,0,0,0,0,122500,350000,227500
01SCS19E290031,AR.MDS-RL007,20ARRL0380,XL,1,130000,200000,2,0,40000,1,0,40000,160000,120000
01SCS19E290031,BSC.AR-SE0046,00ARSE0400,L,1,44500,159000,0,0,0,0,0,31800,159000,127200
01SCS19E290032,AR.CLK-RH001,20ARRH0736,ALL,1,91000,140000,2,0,28000,1,0,28000,112000,84000
01SCS19E290032,AR.CLK-RH002,20ARRH0737,ALL,1,91000,140000,2,0,28000,1,0,28000,112000,84000
01SCS19E290032,AR.MKV-SA007,20ARSA0202,34,1,243750,375000,0,0,0,0,0,131250,375000,243750
01SCS19E290032,BSC.AR-SE0038,00ARSE0350,S,1,52000,155000,0,0,0,0,0,31000,155000,124000
01SCS19E290032,DKS.AR-SE0002,00ARSE0136,34,1,417272,696000,0,0,0,0,0,104400,696000,591600
01SCS19E290032,ESH.AR-RH0015,00ARRH0088,M,1,43000,135000,0,0,0,0,0,27000,135000,108000
01SCS19E290032,ESH.AR-SA0016,00ARSA0115,NON,1,55000,150000,0,0,0,0,0,30000,150000,120000
01SCS19E290033,AR.SMD-SD013,20ARSD0570,M,1,87750,135000,2,0,27000,1,0,27000,108000,81000
01SCS19E290034,AR.CPT-SE001,20ARSE0355,XL,1,94250,145000,2,0,29000,1,0,29000,116000,87000
01SCS19E290034,AR.MKV-RL007,20ARRL0453,L,1,107250,165000,0,0,0,0,0,57750,165000,107250
01SCS19E290035,ESH.AR-SA0015,00ARSA0110,M,1,122500,350000,0,0,0,0,0,70000,350000,280000
01SCS19E290036,BSC.AR-SE0037,00ARSE0347,M,1,44000,159000,0,0,0,0,0,31800,159000,127200
01SCS19E290037,AR.TUC-SD004,20ARSD0153,M,1,204750,315000,2,0,63000,1,0,63000,252000,189000
01SCS19E290038,ESH.AR-SD0039,00ARSD0347,S,1,122500,350000,0,0,0,0,0,70000,350000,280000
01SCS19E290039,AR.ESB-SE005,20ARSE0254,S,1,94250,145000,2,0,29000,1,0,29000,116000,87000
01SCS19E290039,BSC.AR-SE0011,00ARSE0097,S,1,44500,159000,0,0,0,0,0,31800,159000,127200
01SCS19E290040,AR.STY-SE009,20ARSE0127,ALL,1,55250,85000,2,0,17000,1,0,17000,68000,51000
01SCS19E290040,AR.STY-SE011,20ARSE0577,ALL,1,55250,85000,2,0,17000,1,0,17000,68000,51000
01SCS19E290041,BSC.AR-SC0028,00ARSC0195,S,1,125000,315000,0,0,0,0,0,63000,315000,252000
01SCS19E290042,ESH.AR-SC0021,00ARSC0157,S,1,44000,135000,0,0,0,0,0,27000,135000,108000
01SCS19E290043,BSC.AR-SB0004,00ARSB0048,M,1,44000,135000,0,0,0,0,0,27000,135000,108000
01SCS19E290044,AR.PUB-SE011,20ARSE0043,L,1,97500,150000,2,0,30000,1,0,30000,120000,90000
01SCS19E290045,AR.MKV-SE015,20ARSE0591,S,1,22750,350000,0,0,0,0,0,122500,350000,227500
01SCS19E290045,ARN.AR-RK0002,00ARRK0224,L,1,43000,140000,0,0,0,0,0,42000,140000,98000
01SCS19E290045,BSC.AR-SD0039,00ARSD0213,L,1,125000,315000,0,0,0,0,0,63000,315000,252000
01SCS19E290046,BSC.AR-SE0038,00ARSE0351,M,1,52000,155000,0,0,0,0,0,31000,155000,124000
01SCS19E290047,AR.YD-SB006,20ARSB0513,M,1,195000,300000,2,0,150000,1,0,37500,150000,112500
01SCS19E290048,BSC.AR-SE0046,00ARSE0400,L,1,44500,159000,0,0,0,0,0,31800,159000,127200
01SCS19E290049,AR.PUB-SE032,20ARSE0326,M,1,204750,315000,2,0,63000,1,0,63000,252000,189000
01SCS19E290050,ESH.AR-SB0032,00ARSB0210,L,1,125000,315000,0,0,0,0,0,63000,315000,252000
01SCS19E290051,AR.MKV-SB012,20ARSB0545,L,1,172250,265000,0,0,0,0,0,92750,265000,172250
01SCS19E290051,DKS.AR-SE0001,00ARSE0130,30,1,417272,696000,0,0,0,0,0,104400,696000,591600
01SCS19E290052,AR.MPR-SE014,20ARSE0190,M,1,237250,365000,2,0,73000,1,0,73000,292000,219000
01SCS19E290052,BSC.AR-SD0061,00ARSD0336,NON,1,45000,150000,0,0,0,0,0,30000,150000,120000
01SCS19E290053,AR.PUB-SC008,20ARSC0287,XL,1,97500,150000,2,0,30000,1,0,30000,120000,90000
01SCS19E290054,ESH.AR-RK0011,00ARRK0046,M,1,44500,135000,0,0,0,0,0,27000,135000,108000
01SCS19E290055,AR.PUB-SD031,20ARSD0213,28,1,211250,325000,2,0,65000,1,0,65000,260000,195000
01SCS19E290056,ESH.AR-SE0039,00ARSE0362,S,1,44000,135000,0,0,0,0,0,27000,135000,108000
01SCS19E290057,AR.VRS-SC001,20ARSC0165,XL,1,96850,149000,2,0,44700,1,0,26075,104300,78225
01SCS19E290058,AR.MKV-SE025,20ARSE0625,30,1,214500,330000,0,0,0,0,0,115500,330000,214500
01SCS19E290059,BSC.AR-RL0019,00ARRL0114,M,1,125000,315000,0,0,0,0,0,63000,315000,252000
01SCS19E290060,AR.MKV-RJ012,20ARRJ0195,ALL,1,97500,150000,0,0,0,0,0,52500,150000,97500
01SCS19E290061,AR.STY-SE009,20ARSE0127,ALL,1,55250,85000,2,0,17000,1,0,17000,68000,51000
01SCS19E290062,ESH.AR-SD0040,00ARSD0367,M,1,122500,350000,0,0,0,0,0,70000,350000,280000
01SCS19E290063,AR.CPT-SB001,20ARSB0082,S,1,204750,315000,2,0,63000,1,0,63000,252000,189000
01SCS19E290064,AR.MPR-SE028,20ARSE0231,M,1,230750,355000,2,0,71000,1,0,71000,284000,213000
01SCS19E290065,AR.STY-SA002,20ARSA0061,ALL,1,61750,95000,2,0,19000,1,0,19000,76000,57000
01SCS19E290066,BSC.AR-SB0014,00ARSB0111,M,1,44000,135000,0,0,0,0,0,27000,135000,108000
01SCS19E290067,AR.MKV-RJ028,20ARRJ0226,30,1,214500,330000,0,0,0,0,0,115500,330000,214500
01SCS19E290068,AR.REC-SD026,20ARSD0073,ALL,1,117000,180000,2,0,54000,1,0,31500,126000,94500
01SCS19E290069,ESH.AR-SD0024,00ARSD0259,M,1,44500,135000,0,0,0,0,0,27000,135000,108000
01SCS19E290070,ESH.AR-SD0006,00ARSD0053,S,1,44500,135000,0,0,0,0,0,27000,135000,108000
01SCS19E290071,ESH.AR-SB0006,00ARSB0024,M,1,44500,135000,0,0,0,0,0,27000,135000,108000
01SCS19E290072,ESH.AR-SD0039,00ARSD0348,M,1,122500,350000,0,0,0,0,0,70000,350000,280000
01SCS19E290073,ESH.AR-RK0014,00ARRK0187,S,1,112500,350000,0,0,0,0,0,70000,350000,280000
01SCS19E290074,AR.PUB-SE017,20ARSE0068,XL,1,159250,245000,2,0,49000,1,0,49000,196000,147000
01SCS19E290075,BSC.AR-SE0027,00ARSE0277,L,1,52000,155000,0,0,0,0,0,31000,155000,124000
01SCS19E290076,AR.CPT-RE009,20ARRE0701,S,1,204750,315000,2,0,63000,1,0,63000,252000,189000
01SCS19E290077,ESH.AR-SE0031,00ARSE0273,L,1,125000,315000,0,0,0,0,0,63000,315000,252000
01SCS19E290078,ESH.AR-SC0021,00ARSC0158,M,1,44000,135000,0,0,0,0,0,27000,135000,108000
01SCS19E290078,ESH.AR-SD0039,00ARSD0348,M,1,122500,350000,0,0,0,0,0,70000,350000,280000
01SCS19E290079,AR.ESB-RL010,20ARRL0461,ALL,1,91000,140000,2,0,70000,1,0,17500,70000,52500
01SCS19E290080,ESH.AR-SD0045,00ARSD0406,L,1,125000,315000,0,0,0,0,0,63000,315000,252000
01SCS19E290081,AR.CPT-RE013,20ARRE0720,XL,1,94250,145000,2,0,29000,1,0,29000,116000,87000
01SCS19E290082,AR.TUC-SD004,20ARSD0154,L,1,204750,315000,2,0,63000,1,0,63000,252000,189000
01SCS19E290083,AR.ESB-SE012,20ARSE0283,M,1,198250,305000,2,0,61000,1,0,61000,244000,183000
01SCS19E290084,AR.PUB-SE033,20ARSE0630,M,1,97500,150000,2,0,30000,1,0,30000,120000,90000
01SCS19E290085,AR.MPR-SE010,20ARSE0175,L,1,97500,150000,2,0,45000,1,0,26250,105000,78750
01SCS19E290085,AR.MPR-SE030,20ARSE0293,L,1,230750,355000,2,0,71000,1,0,71000,284000,213000
01SCS19E290086,BSC.AR-SD0028,00ARSD0160,S,1,125000,315000,0,0,0,0,0,63000,315000,252000
01SCS19E290087,BSC.AR-SE0031,00ARSE0294,XL,1,52000,155000,0,0,0,0,0,31000,155000,124000
01SCS19E290087,ESH.AR-SE0005,00ARSE0019,L,1,44500,135000,0,0,0,0,0,27000,135000,108000
01SCS19E290088,AR.MDS-RE009,20ARRE0662,M,1,126750,195000,2,0,39000,1,0,39000,156000,117000
01SCS19E290089,AR.PCT-SE019,20ARSE0686,M,1,87750,135000,2,0,27000,1,0,27000,108000,81000
01SCS19E290090,ESH.AR-SD0026,00ARSD0266,S,1,44500,135000,0,0,0,0,0,27000,135000,108000
01SCS19E290091,AR.PUB-SD031,20ARSD0213,28,1,211250,325000,2,0,65000,1,0,65000,260000,195000
01SCS19E290092,AR.MPR-SE033,20ARSE0304,M,1,230750,355000,2,0,71000,1,0,71000,284000,213000
01SCS19E290093,BSC.AR-SE0046,00ARSE0400,L,1,44500,159000,0,0,0,0,0,31800,159000,127200
01SCS19E290094,ESH.AR-SE0018,00ARSE0118,M,1,44500,135000,0,0,0,0,0,27000,135000,108000
01SCS19E290095,BSC.AR-SC0028,00ARSC0196,M,1,125000,315000,0,0,0,0,0,63000,315000,252000
01SCS19E290095,BSC.AR-SE0011,00ARSE0099,L,1,44500,159000,0,0,0,0,0,31800,159000,127200
01SCS19E290095,BSC.AR-SE0046,00ARSE0399,M,1,44500,159000,0,0,0,0,0,31800,159000,127200
01SCS19E290096,AR.PUB-RI024,20ARRI0308,L,1,97500,150000,2,0,30000,1,0,30000,120000,90000
01SCS19E290096,AR.SMD-RH002,20ARRH0071,M,1,211250,325000,2,0,97500,1,0,56875,227500,170625
01SCS19E290097,AR.BPH-RH007,20ARRH0354,L,1,214500,330000,2,0,165000,1,0,41250,165000,123750
01SCS19E290098,ESH.AR-SD0007,00ARSD0059,L,1,44500,135000,0,0,0,0,0,27000,135000,108000
01SCS19E290099,BSC.AR-SD0059,00ARSD0331,NON,1,45000,140000,0,0,0,0,0,28000,140000,112000
01SCS19E290099,BSC.AR-SD0060,00ARSD0332,NON,1,45000,140000,0,0,0,0,0,28000,140000,112000
01SCS19E290100,AR.ESB-SE006,20ARSE0258,S,1,94250,145000,2,0,29000,1,0,29000,116000,87000
01SCS19E290100,AR.MPR-SE033,20ARSE0305,L,1,230750,355000,2,0,71000,1,0,71000,284000,213000
01SCS19E290100,AR.SMD-QD002,20ARQD0028,L,1,84500,130000,2,0,39000,1,0,22750,91000,68250
01SCS19E290100,ESH.AR-SC0010,00ARSC0082,L,1,44500,135000,0,0,0,0,0,27000,135000,108000
01SCS19E290100,ESH.AR-SC0011,00ARSC0086,L,1,44000,135000,0,0,0,0,0,27000,135000,108000
01SCS19E290101,AR.CPT-RL002,20ARRL0075,M,1,94250,145000,2,0,29000,1,0,29000,116000,87000
01SCS19E290102,BSC.AR-SB0006,00ARSB0071,M,1,44000,135000,0,0,0,0,0,27000,135000,108000
01SCS19E290102,BSC.AR-SC0022,00ARSC0170,M,1,44500,135000,0,0,0,0,0,27000,135000,108000
01SCS19E290103,BSC.AR-RL0019,00ARRL0114,M,1,125000,315000,0,0,0,0,0,63000,315000,252000
01SCS19E290103,BSC.AR-SD0025,00ARSD0148,S,1,44500,159000,0,0,0,0,0,31800,159000,127200
01SCS19E290104,AR.TUC-SA034,20ARSA0266,ALL,1,87750,135000,2,0,27000,1,0,27000,108000,81000
01SCS19E290105,AR.MKV-RL007,20ARRL0452,M,1,107250,165000,0,0,0,0,0,57750,165000,107250
01SCS19E290106,BSC.AR-SA0017,00ARSA0051,S,1,125000,315000,0,0,0,0,0,63000,315000,252000
01SCS19E290106,BSC.AR-SD0035,00ARSD0195,S,1,44500,159000,0,0,0,0,0,31800,159000,127200
01SCS19E290107,AR.TUC-SC006,20ARSC0065,30,1,204750,315000,2,0,63000,1,0,63000,252000,189000
01SCS19E290108,ESH.AR-SE0020,00ARSE0126,M,1,44000,135000,0,0,0,0,0,27000,135000,108000
01SCS19E290109,AR.CLK-RE010,20ARRE0919,ALL,1,84500,130000,2,0,26000,1,0,26000,104000,78000
01SCS19E290110,AR.MPR-SE005,20ARSE0155,L,1,97500,150000,2,0,45000,1,0,26250,105000,78750
01SCS19E290111,AR.TUC-SE005,20ARSE0381,L,1,204750,315000,2,0,63000,1,0,63000,252000,189000
01SCS19E290112,AR.PCT-SE007,20ARSE0348,M,1,87750,135000,2,0,27000,1,0,27000,108000,81000
01SCS19E290113,BSC.AR-SE0001,00ARSE0057,S,1,44500,159000,0,0,0,0,0,31800,159000,127200
01SCS19E290114,ESH.AR-SD0026,00ARSD0267,M,1,44500,135000,0,0,0,0,0,27000,135000,108000
01SCS19E290114,ESH.AR-SE0025,00ARSE0248,M,1,44500,135000,0,0,0,0,0,27000,135000,108000
01SCS19E290115,BNV.AR-RI0005,00ARRI0170,34,1,625000,625000,0,0,0,0,0,93750,625000,531250
01SCS19E290116,ESH.AR-RJ0005,00ARRJ0028,M,1,94500,135000,0,0,0,0,0,27000,135000,108000
01SCS19E290116,ESH.AR-SE0031,00ARSE0273,L,1,125000,315000,0,0,0,0,0,63000,315000,252000
01SCS19E290117,ESH.AR-SC0021,00ARSC0158,M,1,44000,135000,0,0,0,0,0,27000,135000,108000
01SCS19E290118,AR.PUB-RL014,20ARRL0160,L,1,191750,295000,2,0,59000,1,0,59000,236000,177000
01SCS19E290119,AR.CLB-SE007,20ARSE0703,ALL,1,185250,285000,2,0,57000,1,0,57000,228000,171000
01SCS19E290120,ESH.AR-SC0026,00ARSC0237,M,1,44500,135000,0,0,0,0,0,27000,135000,108000
01SCS19E290121,AR.PUB-SA002,20ARSA0129,M,1,224250,345000,2,0,69000,1,0,69000,276000,207000
01SCS19E290122,AR.MPR-SE027,20ARSE0228,L,1,243750,375000,2,0,75000,1,0,75000,300000,225000
01SCS19E290123,ESH.AR-SB0015,00ARSB0062,S,1,125000,315000,0,0,0,0,0,63000,315000,252000
01SCS19E290124,AR.PUB-SE021,20ARSE0080,M,1,159250,245000,2,0,49000,1,0,49000,196000,147000
01SCS19E290124,BSC.AR-RI0007,00ARRI0023,M,1,108500,155000,0,0,0,0,0,31000,155000,124000
01SCS19E290125,ESH.AR-SA0013,00ARSA0098,M,1,44000,135000,0,0,0,0,0,27000,135000,108000
01SCS19E290126,BSC.AR-SA0019,00ARSA0064,M,1,44000,135000,0,0,0,0,0,27000,135000,108000
01SCS19E290127,AR.SMD-QD002,20ARQD0028,L,1,84500,130000,2,0,39000,1,0,22750,91000,68250
01SCS19E290127,AR.TUC-SE013,20ARSE0412,M,1,94250,145000,2,0,29000,1,0,29000,116000,87000
01SCS19E290128,AR.MKV-RJ010,20ARRJ0188,XL,1,91000,140000,0,0,0,0,0,49000,140000,91000
01SCS19E290128,AR.PUB-SE021,20ARSE0082,XL,1,159250,245000,2,0,49000,1,0,49000,196000,147000
01SCS19E290129,AR.PUB-SE032,20ARSE0326,M,1,204750,315000,2,0,63000,1,0,63000,252000,189000
01SCS19E290130,AR.PUB-SE007,20ARSE0026,M,1,97500,150000,2,0,30000,1,0,30000,120000,90000
01SCS19E290131,AR.STY-SE007,20ARSE0125,ALL,1,55250,85000,2,0,17000,1,0,17000,68000,51000
01SCS19E290132,AR.STY-SE010,20ARSE0576,ALL,1,61750,95000,2,0,19000,1,0,19000,76000,57000
01SCS19E290133,AR.CPT-RE009,20ARRE0701,S,1,204750,315000,2,0,63000,1,0,63000,252000,189000
01SCS19E290133,ARN.AR-RK0001,00ARRK0218,S,1,43000,140000,0,0,0,0,0,42000,140000,98000
01SCS19E290134,BSC.AR-SE0038,00ARSE0352,L,1,52000,155000,0,0,0,0,0,31000,155000,124000
01SCS19E290135,ESH.AR-SD0026,00ARSD0267,M,1,44500,135000,0,0,0,0,0,27000,135000,108000
01SCS19E290136,AR.CPT-SE001,20ARSE0353,M,1,94250,145000,2,0,29000,1,0,29000,116000,87000
01SCS19E290137,AR.CPT-QL011,20ARQL0168,L,1,204750,315000,2,0,63000,1,0,63000,252000,189000
01SCS19E290138,AR.TUC-SC006,20ARSC0065,30,1,204750,315000,2,0,63000,1,0,63000,252000,189000
01SCS19E290139,ESH.AR-SD0008,00ARSD0063,L,1,44500,135000,0,0,0,0,0,27000,135000,108000
01SCS19E290140,BSC.AR-RK0019,00ARRK0122,M,1,43000,135000,0,0,0,0,0,27000,135000,108000
01SCS19E290141,BSC.AR-RI0009,00ARRI0032,L,1,94500,135000,0,0,0,0,0,27000,135000,108000
01SCS19E290141,BSC.AR-SE0005,00ARSE0075,L,1,44000,159000,0,0,0,0,0,31800,159000,127200
01SCS19E290142,BSC.AR-SB0004,00ARSB0048,M,1,44000,135000,0,0,0,0,0,27000,135000,108000
01SCS19E290142,BSC.AR-SE0002,00ARSE0062,M,1,44000,159000,0,0,0,0,0,31800,159000,127200
01SCS19E290143,AR.TUC-SE009,20ARSE0397,M,1,204750,315000,2,0,63000,1,0,63000,252000,189000
01SCS19E290144,AR.VLD-SA008,20ARSA0186,ALL,1,94250,145000,2,0,43500,1,0,25375,101500,76125
01SCS19E290145,AR.PUB-RJ013,20ARRJ0034,28,1,211250,325000,2,0,65000,1,0,65000,260000,195000
01SCS19E290146,ESH.AR-SD0036,00ARSD0334,NON,1,50000,150000,0,0,0,0,0,30000,150000,120000
01SCS19E290147,AR.ESB-SD013,20ARSD0325,S,1,91000,140000,2,0,28000,1,0,28000,112000,84000
01SCS19E290147,AR.ESB-SD013,20ARSD0327,L,1,91000,140000,2,0,28000,1,0,28000,112000,84000
01SCS19E290148,AR.ESB-SE006,20ARSE0259,M,1,94250,145000,2,0,29000,1,0,29000,116000,87000
01SCS19E290149,BSC.AR-RJ0020,00ARRJ0117,L,1,44500,135000,0,0,0,0,0,27000,135000,108000
01SCS19E290150,AR.PUB-SD029,20ARSD0207,ALL,1,97500,150000,2,0,30000,1,0,30000,120000,90000
01SCS19E290151,AR.TUC-SC006,20ARSC0065,30,1,204750,315000,2,0,63000,1,0,63000,252000,189000
01SCS19E290152,AR.HMR-SD006,20ARSD0541,M,1,227500,350000,2,0,70000,1,0,70000,280000,210000
01SCS19E290153,ESH.AR-SB0032,00ARSB0210,L,1,125000,315000,0,0,0,0,0,63000,315000,252000
01SCS19E290154,ESH.AR-SD0016,00ARSD0095,M,1,106400,350000,0,0,0,0,0,70000,350000,280000
01SCS19E290155,AR.TUC-SE009,20ARSE0397,M,1,204750,315000,2,0,63000,1,0,63000,252000,189000
01SCS19E290156,AR.CPT-RL002,20ARRL0076,L,1,94250,145000,2,0,29000,1,0,29000,116000,87000
01SCS19E290157,AR.PUB-SC008,20ARSC0285,M,1,97500,150000,2,0,30000,1,0,30000,120000,90000
01SCS19E290157,BSC.AR-SE0050,00ARSE0415,M,1,52000,155000,0,0,0,0,0,31000,155000,124000
01SCS19E290158,BSC.AR-SE0050,00ARSE0416,L,1,52000,155000,0,0,0,0,0,31000,155000,124000
01SCS19E290159,AR.PUB-SE026,20ARSE0100,M,1,204750,315000,2,0,63000,1,0,63000,252000,189000
01SCS19E290160,AR.PUB-SC007,20ARSC0280,S,1,97500,150000,2,0,30000,1,0,30000,120000,90000
01SCS19E290161,AR.ESB-RH012,20ARRH0480,L,1,198250,305000,2,0,61000,1,0,61000,244000,183000
01SCS19E290162,AR.MPR-SE031,20ARSE0297,L,1,230750,355000,2,0,71000,1,0,71000,284000,213000
01SCS19E290163,ESH.AR-SE0039,00ARSE0362,S,2,44000,135000,0,0,0,0,0,27000,270000,216000
01SCS19E290164,AR.STY-SE011,20ARSE0577,ALL,1,55250,85000,2,0,17000,1,0,17000,68000,51000
01SCS19E290164,BSC.AR-SA0017,00ARSA0051,S,1,125000,315000,0,0,0,0,0,63000,315000,252000
01SCS19E290164,BSC.AR-SE0023,00ARSE0215,S,1,52000,180000,0,0,0,0,0,36000,180000,144000
01SCS19E290165,AR.PUB-SB035,20ARSB0466,ALL,1,81250,125000,2,0,25000,1,0,25000,100000,75000
01SCS19E290166,AR.GTW-SA003,20ARSA0304,M,1,94250,145000,2,0,43500,1,0,25375,101500,76125
01SCS19E290166,AR.STY-SE002,20ARSE0120,ALL,1,55250,85000,2,0,17000,1,0,17000,68000,51000
01SCS19E290167,BSC.AR-SB0017,00ARSB0136,S,1,44000,135000,0,0,0,0,0,27000,135000,108000
01SCS19E290168,AR.TUC-RK029,20ARSA0133,S,1,94250,145000,2,0,29000,1,0,29000,116000,87000
01SCS19E290168,AR.TUC-SB003,20ARSB0031,ALL,1,61750,95000,2,0,19000,1,0,19000,76000,57000
01SCS19E290169,AR.CPT-RE009,20ARRE0701,S,1,204750,315000,2,0,63000,1,0,63000,252000,189000
01SCS19E290170,AR.TUC-SD014,20ARSD0474,M,1,94250,145000,2,0,29000,1,0,29000,116000,87000
01SCS19E290171,BSC.AR-SC0006,00ARSC0039,M,1,44000,135000,0,0,0,0,0,27000,135000,108000
01SCS19E290171,BSC.AR-SD0004,00ARSD0015,L,1,44000,159000,0,0,0,0,0,31800,159000,127200
01SCS19E290172,AR.CPT-SC013,20ARSC0484,M,1,94250,145000,2,0,29000,1,0,29000,116000,87000
01SCS19E290173,AR.VLD-SA001,20ARSA0167,L,1,211250,325000,2,0,97500,1,0,56875,227500,170625
01SCS19E290173,AR.YD-RL004,20ARRL0020,ALL,1,91000,140000,2,0,70000,1,0,17500,70000,52500
01SCS19E290174,AR.CPT-SD011,20ARSD0454,M,1,94250,145000,2,0,29000,1,0,29000,116000,87000
01SCS19E290174,AR.MPR-SE009,20ARSE0170,M,1,97500,150000,2,0,45000,1,0,26250,105000,78750
01SCS19E290175,BSC.AR-SE0046,00ARSE0399,M,1,44500,159000,0,0,0,0,0,31800,159000,127200
01SCS19E290176,BE.RAK-SC038,00BESC0164,L,1,91000,140000,2,0,28000,1,0,28000,112000,84000
01SCS19E290177,ESH.AR-SD0040,00ARSD0368,L,1,122500,350000,0,0,0,0,0,70000,350000,280000
01SCS19E290178,AR.TUC-SD021,20ARSD0503,L,1,94250,145000,2,0,29000,1,0,29000,116000,87000
01SCS19E290179,AR.TUC-SA006,20ARSA0023,L,1,87750,135000,2,0,27000,1,0,27000,108000,81000
01SCS19E290180,BSC.AR-RJ0008,00ARRJ0068,M,1,94500,135000,0,0,0,0,0,27000,135000,108000
01SCS19E290181,ESH.AR-RK0005,00ARRK0021,S,1,94500,135000,0,0,0,0,0,27000,135000,108000
01SCS19E290182,ESH.AR-SE0017,00ARSE0115,L,1,44000,135000,0,0,0,0,0,27000,135000,108000
01SCS19E290183,ESH.AR-SD0003,00ARSD0041,S,1,44000,135000,0,0,0,0,0,27000,135000,108000
01SCS19E290184,ESH.AR-SC0008,00ARSC0070,L,1,44500,135000,0,0,0,0,0,27000,135000,108000
01SCS19E290184,ESH.AR-SD0012,00ARSD0078,32,1,145000,375000,0,0,0,0,0,75000,375000,300000
01SCS19E290185,ESH.AR-SB0007,00ARSB0028,M,1,44000,135000,0,0,0,0,0,27000,135000,108000
01SCS19E290186,AR.CPT-SD011,20ARSD0453,S,1,94250,145000,2,0,29000,1,0,29000,116000,87000
01SCS19E290187,AR.TUC-SE012,20ARSE0407,S,1,94250,145000,2,0,29000,1,0,29000,116000,87000
01SCS19E290188,AR.ESB-SC002,20ARSC0309,M,1,204750,315000,2,0,63000,1,0,63000,252000,189000
01SCS19E290189,ESH.AR-RG0004,00ARRG0012,L,1,178500,255000,0,0,0,0,0,51000,255000,204000
01SCS19E290190,THR.AR-RB0002,00ARRB0181,L,1,1030000,1030000,0,0,0,0,0,154500,1030000,875500
01SCS19E290191,BSC.AR-RJ0006,00ARRJ0059,S,1,94500,135000,0,0,0,0,0,27000,135000,108000
01SCS19E290192,ESH.AR-SE0026,00ARSE0251,S,1,44000,135000,0,0,0,0,0,27000,135000,108000
01SCS19E290193,ESH.AR-SC0023,00ARSC0168,XL,1,125000,315000,0,0,0,0,0,63000,315000,252000
01SCS19E290194,BE.RAK-RL029,00BERL0102,S,1,259350,399000,2,0,79800,1,0,79800,319200,239400
01SCS19E290195,AR.PUB-RL018,20ARRL0169,M,1,191750,295000,2,0,59000,1,0,59000,236000,177000
01SCS19E290196,AR.TUC-SE012,20ARSE0408,M,1,94250,145000,2,0,29000,1,0,29000,116000,87000
01SCS19E290197,ESH.AR-SD0026,00ARSD0267,M,1,44500,135000,0,0,0,0,0,27000,135000,108000
01SCS19E290198,BE.RAK-SC026,00BESC0104,XL,1,201500,310000,2,0,62000,1,0,62000,248000,186000
01SCS19E290199,AR.ESB-RE036,20ARRE0795,M,1,65000,100000,2,0,50000,1,0,12500,50000,37500
01SCS19E290200,AR.TUC-SB018,20ARSB0478,M,1,87750,135000,2,0,27000,1,0,27000,108000,81000
01SCS19E290201,BSC.AR-RJ0006,00ARRJ0060,M,1,94500,135000,0,0,0,0,0,27000,135000,108000
01SCS19E290202,ESH.AR-SC0023,00ARSC0166,M,1,125000,315000,0,0,0,0,0,63000,315000,252000
01SCS19E290203,ESH.AR-SD0026,00ARSD0267,M,1,44500,135000,0,0,0,0,0,27000,135000,108000
01SCS19E290204,AR.PUB-SC007,20ARSC0280,S,1,97500,150000,2,0,30000,1,0,30000,120000,90000
01SCS19E290205,AR.PUB-SE011,20ARSE0043,L,1,97500,150000,2,0,30000,1,0,30000,120000,90000
01SCS19E290205,AR.TUC-SE012,20ARSE0409,L,1,94250,145000,2,0,29000,1,0,29000,116000,87000
01SCS19E290206,AR.TUC-SE011,20ARSE0403,S,1,94250,145000,2,0,29000,1,0,29000,116000,87000
01SCS19E290207,ESH.AR-SE0028,00ARSE0259,S,1,44000,135000,0,0,0,0,0,27000,135000,108000
01SCS19E290208,AR.CPT-SD011,20ARSD0455,L,1,94250,145000,2,0,29000,1,0,29000,116000,87000
01SCS19E290209,ESH.AR-SB0021,00ARSB0121,L,1,44500,135000,0,0,0,0,0,27000,135000,108000
01SCS19E290210,AR.ESB-SE010,20ARSE0275,M,1,227500,350000,2,0,70000,1,0,70000,280000,210000
01SCS19E290211,AR.PUB-SC007,20ARSC0281,M,1,97500,150000,2,0,30000,1,0,30000,120000,90000
01SCS19E290212,AR.ESB-SC003,20ARSC0419,M,1,91000,140000,2,0,28000,1,0,28000,112000,84000
01SCS19E290213,AR.TUC-SD014,20ARSD0473,S,1,94250,145000,2,0,29000,1,0,29000,116000,87000
01SCS19E290214,ESH.AR-SD0031,00ARSD0300,M,1,44000,135000,0,0,0,0,0,27000,135000,108000
01SCS19E290215,AR.MPR-SE034,20ARSE0308,M,1,237250,365000,2,0,73000,1,0,73000,292000,219000
01SCS19E290216,AR.HMR-SB025,20ARSB0418,36,1,194350,299000,2,0,59800,1,0,59800,239200,179400
01SCS19E290217,ESH.AR-RK0004,00ARRK0015,L,1,120000,315000,0,0,0,0,0,63000,315000,252000
01SCS19E290218,AR.SMD-QE002,20ARQE0006,M,1,87750,135000,2,0,40500,1,0,23625,94500,70875
01SCS19E290219,AR.PCT-SE012,20ARSE0672,M,1,87750,135000,2,0,27000,1,0,27000,108000,81000
01SCS19E290220,ESH.AR-RJ0005,00ARRJ0028,M,1,94500,135000,0,0,0,0,0,27000,135000,108000
01SCS19E290221,AR.CPT-SC002,20ARSC0247,34,1,227500,350000,2,0,70000,1,0,70000,280000,210000
01SCS19E290222,ESH.AR-SC0025,00ARSC0215,S,1,119000,350000,0,0,0,0,0,70000,350000,280000
01SCS19E290223,AR.TUC-SE012,20ARSE0408,M,1,94250,145000,2,0,29000,1,0,29000,116000,87000
01SCS19E290224,AR.MPR-SE002,20ARSE0143,L,1,97500,150000,2,0,45000,1,0,26250,105000,78750
01SCS19E290224,AR.TUC-SE010,20ARSE0401,L,1,94250,145000,2,0,29000,1,0,29000,116000,87000
01SCS19E290225,AR.BPH-RB010,20ARRB0463,L,1,103350,159000,2,0,47700,1,0,27825,111300,83475
01SCS19E290225,AR.YAS-SE015,20ARSE0754,M,1,122850,189000,2,0,37800,1,0,37800,151200,113400
01SCS19E290226,BSC.AR-SD0016,00ARSD0120,L,1,122000,375000,0,0,0,0,0,75000,375000,300000
01SCS19E290226,BSC.AR-SE0039,00ARSE0354,S,1,52000,155000,0,0,0,0,0,31000,155000,124000
01SCS19E290227,AR.CPT-SE003,20ARSE0361,M,1,94250,145000,2,0,29000,1,0,29000,116000,87000
01SCS19E290227,AR.TUC-SA002,20ARSA0006,M,1,204750,315000,2,0,63000,1,0,63000,252000,189000
01SCS19E290228,BSC.AR-RJ0020,00ARRJ0117,L,1,44500,135000,0,0,0,0,0,27000,135000,108000
01SCS19E290228,BSC.AR-SB0011,00ARSB0098,L,1,44500,135000,0,0,0,0,0,27000,135000,108000
01SCS19E290229,AR.HMR-SB031,20ARSB0441,30,1,96850,149000,2,0,29800,1,0,29800,119200,89400
01SCS19E290230,AR.GTW-SA003,20ARSA0306,XL,1,94250,145000,2,0,43500,1,0,25375,101500,76125
01SCS19E290230,ESH.AR-SC0028,00ARSC0268,XL,1,44500,135000,0,0,0,0,0,27000,135000,108000
01SCS19E290231,BSC.AR-RK0019,00ARRK0122,M,1,43000,135000,0,0,0,0,0,27000,135000,108000
01SCS19E290232,AR.TUC-SE011,20ARSE0404,M,1,94250,145000,2,0,29000,1,0,29000,116000,87000
01SCS19E290233,BSC.AR-SC0045,00ARSC0297,NON,1,45000,150000,0,0,0,0,0,30000,150000,120000
01SCS19E290233,ESH.AR-SA0012,00ARSA0093,S,1,44000,135000,0,0,0,0,0,27000,135000,108000
01SCS19E290234,AR.CPT-SC009,20ARSC0273,M,1,94250,145000,2,0,29000,1,0,29000,116000,87000
01SCS19E290234,BSC.AR-RJ0008,00ARRJ0068,M,1,94500,135000,0,0,0,0,0,27000,135000,108000
01SCS19E290235,ESH.AR-SE0018,00ARSE0117,S,1,44500,135000,0,0,0,0,0,27000,135000,108000
01SCS19E290236,AR.CPT-SC010,20ARSC0473,L,1,204750,315000,2,0,63000,1,0,63000,252000,189000
01SCS19E290236,AR.MKV-SE011,20ARSE0521,32,1,227500,350000,0,0,0,0,0,122500,350000,227500
01SCS19E290237,AR.RDC-RH014,20ARSB0087,S,1,97500,150000,2,0,30000,1,0,30000,120000,90000
01SCS19E290238,AR.FHL-SE002,20ARSE0377,ALL,1,78000,120000,2,0,24000,1,0,24000,96000,72000
01SCS19E290239,AR.CPT-SC008,20ARSC0270,L,1,94250,145000,2,0,29000,1,0,29000,116000,87000
01SCS19E290240,AR.YD-RL004,20ARRL0020,ALL,1,91000,140000,2,0,70000,1,0,17500,70000,52500
01SCS19E290241,AR.MKV-SA002,20ARSA0188,ALL,1,87750,135000,0,0,0,0,0,47250,135000,87750
01SCS19E290242,BSC.AR-SB0007,00ARSB0075,M,1,44500,135000,0,0,0,0,0,27000,135000,108000
01SCS19E290242,BSC.AR-SB0016,00ARSB0131,S,1,44500,135000,0,0,0,0,0,27000,135000,108000
01SCS19E290243,AR.TUC-SD012,20ARSD0466,M,1,94250,145000,2,0,29000,1,0,29000,116000,87000
01SCS19E290243,AR.TUC-SE015,20ARSE0420,M,1,94250,145000,2,0,29000,1,0,29000,116000,87000
01SCS19E290244,AR.HLW-SA006,20ARSA0093,ALL,1,71500,110000,2,0,22000,1,0,22000,88000,66000
01SCS19E290245,AR.SMD-SD016,20ARSD0578,ALL,1,97500,150000,2,0,30000,1,0,30000,120000,90000
01SCS19E290245,BSC.AR-SC0032,00ARSC0219,28,1,135000,375000,0,0,0,0,0,75000,375000,300000
01SCS19E290246,AR.TUC-SA040,20ARSA0272,ALL,1,87750,135000,2,0,27000,1,0,27000,108000,81000
01SCS19E290247,BSC.AR-SE0009,00ARSE0089,S,1,44500,159000,0,0,0,0,0,31800,159000,127200
01SCS19E290248,BSC.AR-SD0028,00ARSD0161,M,1,125000,315000,0,0,0,0,0,63000,315000,252000
01SCS19E290248,ESH.AR-SD0037,00ARSD0335,NON,1,50000,150000,0,0,0,0,0,30000,150000,120000
01SCS19E290249,AR.SMD-SD007,20ARSD0302,L,1,211250,325000,2,0,65000,1,0,65000,260000,195000
01SCS19E290249,BE.RAK-RJ001,00BERJ0002,M,1,201500,310000,2,0,62000,1,0,62000,248000,186000
01SCS19E290250,AR.CPT-SB001,20ARSB0084,L,1,204750,315000,2,0,63000,1,0,63000,252000,189000
01SCS19E290251,AR.YAS-SE015,20ARSE0755,L,1,122850,189000,2,0,37800,1,0,37800,151200,113400
01SCS19E290252,AR.TUC-SB018,20ARSB0478,M,1,87750,135000,2,0,27000,1,0,27000,108000,81000
01SCS19E290253,BSC.AR-SC0027,00ARSC0191,M,1,106400,350000,0,0,0,0,0,70000,350000,280000
01SCS19E290253,BSC.AR-SD0059,00ARSD0331,NON,1,45000,140000,0,0,0,0,0,28000,140000,112000
01SCS19E290254,BSC.AR-RJ0019,00ARRJ0112,M,1,94500,135000,0,0,0,0,0,27000,135000,108000
01SCS19E290255,AR.TUC-SA006,20ARSA0024,XL,1,87750,135000,2,0,27000,1,0,27000,108000,81000
01SCS19E290255,BSC.AR-RJ0014,00ARRJ0093,L,1,94500,135000,0,0,0,0,0,27000,135000,108000
01SCS19E290256,AR.PUB-SD026,20ARSD0202,M,1,97500,150000,2,0,30000,1,0,30000,120000,90000
01SCS19E290256,ESH.AR-SC0010,00ARSC0082,L,1,44500,135000,0,0,0,0,0,27000,135000,108000
01SCS19E290257,BSC.AR-SC0012,00ARSC0075,XL,1,44000,159000,0,0,0,0,0,31800,159000,127200
01SCS19E290258,ESH.AR-RI0016,00ARRI0144,NON,1,65000,185000,0,0,0,0,0,37000,185000,148000
01SCS19E290259,ESH.AR-SD0040,00ARSD0368,L,1,122500,350000,0,0,0,0,0,70000,350000,280000
01SCS19E290260,AR.MKV-SE013,20ARSE0583,S,1,22750,350000,0,0,0,0,0,122500,350000,227500
01SCS19E290261,AR.TUC-SA042,20ARSA0310,ALL,1,100750,155000,2,0,31000,1,0,31000,124000,93000
01SCS19E290262,AR.CPT-SC011,20ARSC0477,L,1,204750,315000,2,0,63000,1,0,63000,252000,189000
01SCS19E290263,AR.MKV-RE036,20ARRE1407,L,1,165750,255000,0,0,0,0,0,89250,255000,165750
01SCS19E290264,ESH.AR-SE0010,00ARSE0039,L,1,44000,135000,0,0,0,0,0,27000,135000,108000
01SCS19E290265,BSC.AR-SD0009,00ARSD0100,M,1,44000,159000,0,0,0,0,0,31800,159000,127200
01SCS19E290266,AR.SMD-SA003,20ARSA0228,M,1,87750,135000,2,0,27000,1,0,27000,108000,81000
01SCS19E290267,ESH.AR-SD0026,00ARSD0268,L,1,44500,135000,0,0,0,0,0,27000,135000,108000
01SCS19E290268,ESH.AR-SD0029,00ARSD0278,NON,1,58000,175000,0,0,0,0,0,35000,175000,140000
01SCS19E290269,AR.TUC-SC003,20ARSC0053,M,1,87750,135000,2,0,27000,1,0,27000,108000,81000
01SCS19E290270,AR.MKV-SE002,20ARSE0476,32,1,214500,330000,0,0,0,0,0,115500,330000,214500
01SCS19E290270,AR.PCT-SE019,20ARSE0686,M,1,87750,135000,2,0,27000,1,0,27000,108000,81000
01SCS19E290270,ESH.AR-SE0039,00ARSE0363,M,1,44000,135000,0,0,0,0,0,27000,135000,108000
01SCS19E290271,AR.MPR-SE040,20ARSE0821,ALL,1,107250,165000,2,0,49500,1,0,28875,115500,86625
01SCS19E290272,AR.TUC-SA038,20ARSA0270,ALL,1,87750,135000,2,0,27000,1,0,27000,108000,81000
01SCS19E290273,BSC.AR-RI0029,00ARRI0138,NON,1,43000,140000,0,0,0,0,0,28000,140000,112000
01SCS19E290274,BSC.AR-SD0063,00ARSD0338,NON,1,60000,180000,0,0,0,0,0,36000,180000,144000
01SCS19E290275,ESH.AR-RK0002,00ARRK0007,L,1,120000,315000,0,0,0,0,0,63000,315000,252000
01SCS19E290276,AR.CLB-SE005,20ARSE0701,ALL,1,185250,285000,2,0,57000,1,0,57000,228000,171000
01SCS19E290277,AR.SMD-SD007,20ARSD0300,S,1,211250,325000,2,0,65000,1,0,65000,260000,195000
01SCS19E290278,AR.TUC-SD006,20ARSD0160,S,1,94250,145000,2,0,29000,1,0,29000,116000,87000
01SCS19E290279,AR.MPR-SE022,20ARSE0207,M,1,243750,375000,2,0,75000,1,0,75000,300000,225000
01SCS19E290279,AR.TUC-SD008,20ARSD0168,ALL,1,81250,125000,2,0,25000,1,0,25000,100000,75000
01SCS19E290280,BSC.AR-SD0041,00ARSD0223,S,1,44500,159000,0,0,0,0,0,31800,159000,127200
01SCS19E290281,AR.PUB-SE032,20ARSE0326,M,1,204750,315000,2,0,63000,1,0,63000,252000,189000
01SCS19E290282,AR.MPR-SE040,20ARSE0821,ALL,1,107250,165000,2,0,49500,1,0,28875,115500,86625
01SCS19E290283,ESH.AR-SD0018,00ARSD0138,L,1,125000,315000,0,0,0,0,0,63000,315000,252000
01SCS19E290284,BSC.AR-SD0004,00ARSD0015,L,1,44000,159000,0,0,0,0,0,31800,159000,127200
01SCS19E290285,AR.PCT-SE019,20ARSE0687,L,1,87750,135000,2,0,27000,1,0,27000,108000,81000
01SCS19E290286,BSC.AR-RL0026,00ARRL0173,XL,1,94500,135000,0,0,0,0,0,27000,135000,108000
01SCS19E290286,BSC.AR-SE0007,00ARSE0082,M,1,44500,159000,0,0,0,0,0,31800,159000,127200
01SCS19E290287,ESH.AR-SB0007,00ARSB0029,L,1,44000,135000,0,0,0,0,0,27000,135000,108000
01SCS19E290288,AR.ESB-RE008,20ARRE0360,XL,1,94250,145000,2,0,72500,1,0,18125,72500,54375
01SCS19E290288,AR.YD-RL018,20ARRL0052,L,1,91000,140000,2,0,70000,1,0,17500,70000,52500
01SCS19E290289,BSC.AR-SD0031,00ARSD0179,S,1,44500,159000,0,0,0,0,0,31800,159000,127200
01SCS19E290290,AR.PUB-SC007,20ARSC0282,L,1,97500,150000,2,0,30000,1,0,30000,120000,90000
01SCS19E290290,AR.TUC-SC003,20ARSC0053,M,1,87750,135000,2,0,27000,1,0,27000,108000,81000
01SCS19E290290,AR.TUC-SD014,20ARSD0474,M,1,94250,145000,2,0,29000,1,0,29000,116000,87000
01SCS19E290291,AR.MPR-SE025,20ARSE0219,M,1,230750,355000,2,0,71000,1,0,71000,284000,213000
01SCS19E290292,AR.CPT-SC013,20ARSC0485,L,1,94250,145000,2,0,29000,1,0,29000,116000,87000
01SCS19E290292,AR.YD-SB005,20ARSB0510,L,1,195000,300000,2,0,90000,1,0,52500,210000,157500
01SCS19E290293,AR.TUC-SE028,20ARSE0811,ALL,1,87750,135000,2,0,27000,1,0,27000,108000,81000
01SCS19E290294,BE.RAK-RK002,00BERK0003,M,1,201500,310000,2,0,62000,1,0,62000,248000,186000
01SCS19E290294,BE.RAK-RL020,00BERL0063,L,1,211250,325000,2,0,65000,1,0,65000,260000,195000
01SCS19E290295,AR.TUC-SA002,20ARSA0005,S,1,204750,315000,2,0,63000,1,0,63000,252000,189000
01SCS19E290296,ESH.AR-SE0026,00ARSE0253,L,1,44000,135000,0,0,0,0,0,27000,135000,108000
01SCS19E290297,AR.MPR-SE015,20ARSE0193,S,1,256750,395000,2,0,79000,1,0,79000,316000,237000
01SCS19E290298,BSC.AR-SE0035,00ARSE0337,30,1,125000,365000,0,0,0,0,0,73000,365000,292000
01SCS19E290299,BSC.AR-SD0009,00ARSD0100,M,1,44000,159000,0,0,0,0,0,31800,159000,127200
01SCS19E290299,BSC.AR-SD0029,00ARSD0171,M,1,44500,159000,0,0,0,0,0,31800,159000,127200
01SCS19E290300,AR.PUB-RG026,20ARRG0132,L,1,97500,150000,2,0,30000,1,0,30000,120000,90000
01SCS19E290300,AR.PUB-SB022,20ARSB0122,L,1,97500,150000,2,0,30000,1,0,30000,120000,90000
01SCS19E290301,AR.TUC-SA002,20ARSA0007,L,1,204750,315000,2,0,63000,1,0,63000,252000,189000
01SCS19E290302,AR.SMD-SD007,20ARSD0303,XL,1,211250,325000,2,0,65000,1,0,65000,260000,195000
01SCS19E290303,BSC.AR-SD0064,00ARSD0340,M,1,125000,315000,0,0,0,0,0,63000,315000,252000
01SCS19E290304,AR.HLW-SE019,20ARSE0567,M,1,217750,335000,2,0,67000,1,0,67000,268000,201000
01SCS19E290305,BSC.AR-SE0031,00ARSE0294,XL,1,52000,155000,0,0,0,0,0,31000,155000,124000
01SCS19E290306,ESH.AR-SE0043,00ARSE0420,L,1,125000,315000,0,0,0,0,0,63000,315000,252000
01SCS19E290307,AR.CPT-RK007,20ARRK0026,XL,1,204750,315000,2,0,63000,1,0,63000,252000,189000
01SCS19E290308,AR.TUC-SE020,20ARSE0639,S,1,204750,315000,2,0,63000,1,0,63000,252000,189000
01SCS19E290309,ESH.AR-SC0003,00ARSC0011,L,1,125000,350000,0,0,0,0,0,70000,350000,280000
01SCS19E290310,AR.YAS-SE013,20ARSE0747,L,1,122850,189000,2,0,37800,1,0,37800,151200,113400
01SCS19E290311,AR.ESB-SE011,20ARSE0279,M,1,227500,350000,2,0,70000,1,0,70000,280000,210000
01SCS19E290311,AR.MKV-SC020,20ARSC0226,M,1,107250,165000,0,0,0,0,0,57750,165000,107250
01SCS19E290311,AR.PCT-SE007,20ARSE0348,M,1,87750,135000,2,0,27000,1,0,27000,108000,81000
01SCS19E290312,AR.ESB-SC001,20ARSC0305,M,1,204750,315000,2,0,63000,1,0,63000,252000,189000
01SCS19E290312,AR.MPR-SE022,20ARSE0208,L,1,243750,375000,2,0,75000,1,0,75000,300000,225000
01SCS19E290312,AR.PUB-SC004,20ARSC0114,ALL,1,48750,75000,2,0,15000,1,0,15000,60000,45000
01SCS19E290312,AR.PUB-SE035,20ARSE0803,ALL,1,97500,150000,0,0,0,0,0,52500,150000,97500
01SCS19E290312,ESH.AR-SA0013,00ARSA0098,M,1,44000,135000,0,0,0,0,0,27000,135000,108000
01SCS19E290313,AR.MPR-SE012,20ARSE0184,XL,1,97500,150000,2,0,45000,1,0,26250,105000,78750
01SCS19E290314,AR.CPT-SD007,20ARSD0438,M,1,204750,315000,2,0,63000,1,0,63000,252000,189000
01SCS19E290315,ESH.AR-SC0003,00ARSC0009,S,1,125000,350000,0,0,0,0,0,70000,350000,280000
01SCS19E290316,AR.TUC-SD011,20ARSD0462,M,1,94250,145000,2,0,29000,1,0,29000,116000,87000
01SCS19E290316,AR.TUC-SE006,20ARSE0384,M,1,204750,315000,2,0,63000,1,0,63000,252000,189000
01SCS19E290317,AR.PUB-RE051,20ARRE0594,S,1,204750,315000,2,0,63000,1,0,63000,252000,189000
01SCS19E290318,AR.CLB-SE002,20ARSE0698,ALL,1,185250,285000,2,0,57000,1,0,57000,228000,171000
01SCS19E290319,AR.MKV-SE011,20ARSE0521,32,1,227500,350000,0,0,0,0,0,122500,350000,227500
01SCS19E290319,ESH.AR-SB0015,00ARSB0062,S,1,125000,315000,0,0,0,0,0,63000,315000,252000
01SCS19E290320,ESH.AR-RK0018,00ARRK0194,NON,1,43000,150000,0,0,0,0,0,30000,150000,120000
01SCS19E290320,ESH.AR-SD0043,00ARSD0396,L,1,125000,315000,0,0,0,0,0,63000,315000,252000
01SCS19E290321,AR.TUC-SE022,20ARSE0647,S,1,152750,235000,2,0,47000,1,0,47000,188000,141000
01SCS19E290322,BE.RAK-SC019,00BESC0069,L,1,201500,310000,2,0,62000,1,0,62000,248000,186000
01SCS19E290323,AR.YAS-SE002,20ARSE0710,L,1,317850,489000,2,0,97800,1,0,97800,391200,293400
01SCS19E290324,AR.TUC-SD014,20ARSD0474,M,1,94250,145000,2,0,29000,1,0,29000,116000,87000
01SCS19E290325,AR.PUB-SE021,20ARSE0080,M,1,159250,245000,2,0,49000,1,0,49000,196000,147000
01SCS19E290326,AR.HLW-SE012,20ARSE0556,M,1,100750,155000,2,0,31000,1,0,31000,124000,93000
01SCS19E290327,AR.CPT-SD003,20ARSD0139,ALL,1,94250,145000,2,0,29000,1,0,29000,116000,87000
01SCS19E290328,DKS.AR-SE0006,00ARSE0149,34,1,417272,696000,0,0,0,0,0,104400,696000,591600
01SCS19E290329,ESH.AR-RK0018,00ARRK0194,NON,1,43000,150000,0,0,0,0,0,30000,150000,120000
01SCS19E290330,AR.ESB-SE021,20ARSE0800,ALL,1,87750,135000,2,0,27000,1,0,27000,108000,81000
01SCS19E290331,AR.TUC-SE012,20ARSE0408,M,1,94250,145000,2,0,29000,1,0,29000,116000,87000
01SCS19E290331,BSC.AR-SA0022,00ARSA0113,NON,1,47500,140000,0,0,0,0,0,28000,140000,112000
01SCS19E290332,DKS.AR-SE0004,00ARSE0141,34,1,417272,696000,0,0,0,0,0,104400,696000,591600
01SCS19E290333,BSC.AR-RI0011,00ARRI0039,M,1,43000,135000,0,0,0,0,0,27000,135000,108000
01SCS19E290334,AR.MKV-SE025,20ARSE0625,30,1,214500,330000,0,0,0,0,0,115500,330000,214500
01SCS19E290335,AR.TUC-SA040,20ARSA0272,ALL,1,87750,135000,2,0,27000,1,0,27000,108000,81000
01SCS19E290336,AR.BPH-RB005,20ARRB0444,XL,1,182000,280000,2,0,140000,1,0,35000,140000,105000
01SCS19E290337,AR.ESB-SB003,20ARSB0101,M,1,100750,155000,2,0,31000,1,0,31000,124000,93000
01SCS19E290338,AR.PUB-SD015,20ARSD0125,S,1,97500,150000,2,0,30000,1,0,30000,120000,90000
01SCS19E290339,AR.PUB-RH027,20ARRH0411,36,1,211250,325000,2,0,65000,1,0,65000,260000,195000
01SCS19E290340,AR.ESB-SE006,20ARSE0259,M,1,94250,145000,2,0,29000,1,0,29000,116000,87000
01SCS19E290341,BSC.AR-SE0048,00ARSE0406,S,1,44000,159000,0,0,0,0,0,31800,159000,127200
01SCS19E290341,ESH.AR-SB0031,00ARSB0206,L,1,44500,135000,0,0,0,0,0,27000,135000,108000
01SCS19E290342,ESH.AR-RK0005,00ARRK0022,M,1,94500,135000,0,0,0,0,0,27000,135000,108000
01SCS19E290342,ESH.AR-SB0022,00ARSB0124,M,1,44000,135000,0,0,0,0,0,27000,135000,108000
01SCS19E290343,BSC.AR-RI0011,00ARRI0038,S,1,43000,135000,0,0,0,0,0,27000,135000,108000
01SCS19E290343,BSC.AR-RL0022,00ARRL0141,S,1,94500,135000,0,0,0,0,0,27000,135000,108000
01SCS19E290344,AR.TUC-SD014,20ARSD0474,M,1,94250,145000,2,0,29000,1,0,29000,116000,87000
01SCS19E290344,BSC.AR-RJ0007,00ARRJ0065,L,1,94500,135000,0,0,0,0,0,27000,135000,108000
01SCS19E290345,AR.ESB-RE022,20ARRE0401,L,1,91000,140000,2,0,70000,1,0,17500,70000,52500
01SCS19E290346,AR.PUB-SE026,20ARSE0102,XL,1,204750,315000,2,0,63000,1,0,63000,252000,189000
01SCS19E290347,BSC.AR-RH0009,00ARRH0053,NON,1,98000,140000,0,0,0,0,0,28000,140000,112000
01SCS19E290347,THR.AR-RG0004,00ARRG0043,M,1,415000,415000,0,0,0,0,0,62250,415000,352750
01SCS19E290348,ESH.AR-SE0013,00ARSE0050,M,1,44500,135000,0,0,0,0,0,27000,135000,108000
01SCS19E290349,AR.CPT-SC002,20ARSC0246,32,1,227500,350000,2,0,70000,1,0,70000,280000,210000
01SCS19E290350,AR.ESB-SB003,20ARSB0101,M,1,100750,155000,2,0,31000,1,0,31000,124000,93000
01SCS19E290350,AR.TUC-SD022,20ARSD0505,S,1,94250,145000,2,0,29000,1,0,29000,116000,87000
01SCS19E290351,AR.CPT-RI003,20ARRI0049,M,1,204750,315000,2,0,63000,1,0,63000,252000,189000
01SCS19E290352,AR.SMD-SB001,20ARSB0194,XL,1,211250,325000,2,0,65000,1,0,65000,260000,195000
01SCS19E290353,AR.PUB-SD032,20ARSD0239,M,1,204750,315000,2,0,63000,1,0,63000,252000,189000
01SCS19E290354,AR.TUC-SD007,20ARSD0165,M,1,185250,285000,2,0,57000,1,0,57000,228000,171000
01SCS19E290355,AR.ESB-SD002,20ARSD0102,L,1,74750,115000,2,0,23000,1,0,23000,92000,69000
01SCS19E290356,AR.CPT-SE002,20ARSE0356,S,1,94250,145000,2,0,29000,1,0,29000,116000,87000
01SCS19E290356,ESH.AR-SA0009,00ARSA0087,S,1,122500,350000,0,0,0,0,0,70000,350000,280000
01SCS19E290357,AR.PUB-SD033,20ARSD0243,M,1,204750,315000,2,0,63000,1,0,63000,252000,189000
01SCS19E290358,AR.PUB-SB024,20ARSB0130,L,1,97500,150000,2,0,30000,1,0,30000,120000,90000
01SCS19E290359,AR.TUC-SA033,20ARSA0265,ALL,1,87750,135000,2,0,27000,1,0,27000,108000,81000
01SCS19E290360,AR.CPT-SB003,20ARSB0506,L,1,94250,145000,2,0,29000,1,0,29000,116000,87000
01SCS19E290360,AR.CPT-SD009,20ARSD0447,L,1,94250,145000,2,0,29000,1,0,29000,116000,87000
01SCS19E290361,BE.RAK-SC027,00BESC0107,M,1,201500,310000,2,0,62000,1,0,62000,248000,186000
01SCS19E290362,AR.PUB-SD026,20ARSD0202,M,1,97500,150000,2,0,30000,1,0,30000,120000,90000
01SCS19E290363,AR.PUB-SB020,20ARSB0075,M,1,159250,245000,2,0,49000,1,0,49000,196000,147000
01SCS19E290364,BSC.AR-SE0027,00ARSE0278,XL,1,52000,155000,0,0,0,0,0,31000,155000,124000
01SCS19E290365,AR.TUC-SD014,20ARSD0474,M,1,94250,145000,2,0,29000,1,0,29000,116000,87000
01SCS19E290366,ESH.AR-SB0032,00ARSB0210,L,1,125000,315000,0,0,0,0,0,63000,315000,252000
01SCS19E290367,AR.TUC-SE009,20ARSE0398,L,1,204750,315000,2,0,63000,1,0,63000,252000,189000
01SCS19E290368,AR.PUB-SC009,20ARSC0290,L,1,97500,150000,2,0,30000,1,0,30000,120000,90000
01SCS19E290368,AR.STY-SE011,20ARSE0577,ALL,1,55250,85000,2,0,17000,1,0,17000,68000,51000
01SCS19E290369,AR.ESB-SB003,20ARSB0102,L,1,100750,155000,2,0,31000,1,0,31000,124000,93000
01SCS19E290370,AR.PUB-SD029,20ARSD0207,ALL,1,97500,150000,2,0,30000,1,0,30000,120000,90000
01SCS19E290370,BE.RAK-SC006,00BESC0015,ALL,1,42250,65000,2,0,13000,1,0,13000,52000,39000
01SCS19E290370,BSC.AR-SD0012,00ARSD0105,NON,1,18000,75000,0,0,0,0,0,15000,75000,60000
01SCS19E290371,AR.ESB-SE011,20ARSE0280,L,1,227500,350000,2,0,70000,1,0,70000,280000,210000
01SCS19E290371,AR.MDS-RI001,20ARRI0091,XL,1,221000,340000,2,0,68000,1,0,68000,272000,204000
01SCS19E290371,AR.STY-SC008,20ARSC0207,ALL,1,77350,119000,2,0,23800,1,0,23800,95200,71400
01SCS19E290371,AR.STY-SE015,20ARSE0581,ALL,1,55250,85000,2,0,17000,1,0,17000,68000,51000
01SCS19E290371,BSC.AR-SD0048,00ARSD0248,NON,1,45000,135000,0,0,0,0,0,27000,135000,108000
01SCS19E290371,BSC.AR-SD0063,00ARSD0338,NON,1,60000,180000,0,0,0,0,0,36000,180000,144000
01SCS19E290372,AR.PUB-SE032,20ARSE0325,S,1,204750,315000,2,0,63000,1,0,63000,252000,189000
01SCS19E290373,AR.GTW-SC001,20ARSC0022,M,1,214500,330000,2,0,99000,1,0,57750,231000,173250
01SCS19E290374,AR.PUB-RE051,20ARRE0595,M,1,204750,315000,2,0,63000,1,0,63000,252000,189000
01SCS19E290375,BSC.AR-RJ0019,00ARRJ0112,M,1,94500,135000,0,0,0,0,0,27000,135000,108000
01SCS19E290376,AR.ESB-SD004,20ARSD0108,S,1,91000,140000,2,0,28000,1,0,28000,112000,84000
01SCS19E290377,ESH.AR-SE0011,00ARSE0043,L,1,44500,135000,0,0,0,0,0,27000,135000,108000
01SCS19E290378,BSC.AR-SC0048,00ARSC0305,M,1,44500,159000,0,0,0,0,0,31800,159000,127200
01SCS19E290379,BE.RAK-SB013,00BESB0064,XL,1,201500,310000,2,0,62000,1,0,62000,248000,186000
01SCS19E290380,AR.PUB-RJ007,20ARRJ0024,S,1,224250,345000,2,0,69000,1,0,69000,276000,207000
01SCS19E290381,AR.TUC-SE009,20ARSE0398,L,1,204750,315000,2,0,63000,1,0,63000,252000,189000
01SCS19E290382,AR.TUC-SA002,20ARSA0005,S,1,204750,315000,2,0,63000,1,0,63000,252000,189000
01SCS19E290383,AR.TUC-SE012,20ARSE0409,L,1,94250,145000,2,0,29000,1,0,29000,116000,87000
01SCS19E290384,BSC.AR-SC0001,00ARSC0013,S,1,125000,315000,0,0,0,0,0,63000,315000,252000
01SCS19E290385,AR.PUB-SD017,20ARSD0135,L,1,204750,315000,2,0,63000,1,0,63000,252000,189000
01SCS19E290386,AR.TUC-SE011,20ARSE0404,M,1,94250,145000,2,0,29000,1,0,29000,116000,87000
01SCS19E290387,AR.PUB-SE004,20ARSE0014,M,1,97500,150000,2,0,30000,1,0,30000,120000,90000
01SCS19E290387,AR.REC-SD033,20ARSD0080,ALL,1,32500,50000,2,0,15000,1,0,8750,35000,26250
01SCS19E290388,AR.CPT-SE006,20ARSE0373,M,1,204750,315000,2,0,63000,1,0,63000,252000,189000
01SCS19E290389,AR.TUC-SD022,20ARSD0506,M,1,94250,145000,2,0,29000,1,0,29000,116000,87000
01SCS19E290390,AR.TUC-SE006,20ARSE0384,M,1,204750,315000,2,0,63000,1,0,63000,252000,189000
01SCS19E290391,AR.MPR-SE006,20ARSE0160,XL,1,97500,150000,2,0,45000,1,0,26250,105000,78750
01SCS19E290391,AR.TUC-SE027,20ARSE0810,ALL,1,87750,135000,2,0,27000,1,0,27000,108000,81000
01SCS19E290391,AR.YD-SD004,20ARSD0271,M,1,91000,140000,2,0,42000,1,0,24500,98000,73500
01SCS19E290392,AR.CPT-SE001,20ARSE0354,L,1,94250,145000,2,0,29000,1,0,29000,116000,87000
01SCS19E290392,AR.CPT-SE002,20ARSE0358,L,1,94250,145000,2,0,29000,1,0,29000,116000,87000
01SCS19E290393,AR.ESB-SC003,20ARSC0421,XL,1,91000,140000,2,0,28000,1,0,28000,112000,84000
01SCS19E290394,BE.RAK-SC018,00BESC0062,S,1,201500,310000,2,0,62000,1,0,62000,248000,186000
01SCS19E290395,AR.TUC-SD021,20ARSD0503,L,1,94250,145000,2,0,29000,1,0,29000,116000,87000
01SCS19E290396,AR.TUC-SE015,20ARSE0421,L,1,94250,145000,2,0,29000,1,0,29000,116000,87000
01SCS19E290397,AR.TUC-SD011,20ARSD0462,M,1,94250,145000,2,0,29000,1,0,29000,116000,87000
01SCS19E290398,AR.TUC-SA002,20ARSA0006,M,1,204750,315000,2,0,63000,1,0,63000,252000,189000
01SCS19E290399,AR.TUC-SD023,20ARSD0510,M,1,204750,315000,2,0,63000,1,0,63000,252000,189000
01SCS19E290400,BSC.AR-SD0028,00ARSD0161,M,1,125000,315000,0,0,0,0,0,63000,315000,252000
01SCS19E290401,AR.MPR-SE025,20ARSE0219,M,1,230750,355000,2,0,71000,1,0,71000,284000,213000
01SCS19E290401,AR.TUC-SD024,20ARSD0513,S,1,204750,315000,2,0,63000,1,0,63000,252000,189000
01SCS19E290402,AR.ESB-SE010,20ARSE0277,XL,1,227500,350000,2,0,70000,1,0,70000,280000,210000
01SCS19E290402,AR.PUB-SD028,20ARSD0206,ALL,1,97500,150000,2,0,30000,1,0,30000,120000,90000
01SCS19E290403,AR.ESB-SE004,20ARSE0251,M,1,94250,145000,2,0,29000,1,0,29000,116000,87000
01SCS19E290403,BE.RAK-SC008,00BESC0017,ALL,1,42250,65000,2,0,13000,1,0,13000,52000,39000
01SCS19E290404,AR.TUC-SE011,20ARSE0404,M,1,94250,145000,2,0,29000,1,0,29000,116000,87000
01SCS19E290405,ESH.AR-SD0044,00ARSD0398,S,1,125000,315000,0,0,0,0,0,63000,315000,252000
01SCS19E290406,AR.RDC-RK008,20ARRK0484,L,1,97500,150000,2,0,30000,1,0,30000,120000,90000
01SCS19E290407,ESH.AR-SA0005,00ARSA0067,S,1,44000,135000,0,0,0,0,0,27000,135000,108000
01SCS19E290408,AR.TUC-SD022,20ARSD0506,M,1,94250,145000,2,0,29000,1,0,29000,116000,87000
01SCS19E290409,AR.ESB-RL011,20ARRL0462,ALL,1,91000,140000,2,0,70000,1,0,17500,70000,52500
01SCS19E290409,AR.ESB-SC016,20ARSC0457,M,1,91000,140000,2,0,28000,1,0,28000,112000,84000
01SCS19E290410,AR.PUB-SE004,20ARSE0014,M,1,97500,150000,2,0,30000,1,0,30000,120000,90000
01SCS19E290410,AR.TUC-SE008,20ARSE0393,L,1,204750,315000,2,0,63000,1,0,63000,252000,189000
01SCS19E290411,AR.PUB-SE031,20ARSE0323,M,1,204750,315000,2,0,63000,1,0,63000,252000,189000
01SCS19E290412,AR.PUB-SE008,20ARSE0030,M,1,97500,150000,2,0,30000,1,0,30000,120000,90000
01SCS19E290413,AR.MKV-RJ029,20ARRJ0445,XL,1,165750,255000,0,0,0,0,0,89250,255000,165750
01SCS19E290414,AR.ESB-RK002,20ARRK0227,S,1,198250,305000,2,0,61000,1,0,61000,244000,183000
01SCS19E290414,ESH.AR-SC0033,00ARSC0284,S,1,44000,135000,0,0,0,0,0,27000,135000,108000
01SCS19E290414,ESH.AR-SD0006,00ARSD0053,S,1,44500,135000,0,0,0,0,0,27000,135000,108000
01SCS19E290415,AR.MPR-SE039,20ARSE0817,S,1,289250,445000,2,0,89000,1,0,89000,356000,267000
01SCS19E290416,AR.PUB-RE051,20ARRE0595,M,1,204750,315000,2,0,63000,1,0,63000,252000,189000
01SCS19E290416,BSC.AR-SC0001,00ARSC0013,S,1,125000,315000,0,0,0,0,0,63000,315000,252000
01SCS19E290417,BE.RAK-SB007,00BESB0031,S,1,243750,375000,2,0,75000,1,0,75000,300000,225000
01SCS19E290418,BSC.AR-SD0056,00ARSD0291,L,1,125000,315000,0,0,0,0,0,63000,315000,252000
01SCS19E290419,AR.MPR-SE026,20ARSE0224,L,1,230750,355000,2,0,71000,1,0,71000,284000,213000
01SCS19E290420,AR.CPT-SE004,20ARSE0365,M,1,204750,315000,2,0,63000,1,0,63000,252000,189000
01SCS19E290421,BSC.AR-SD0039,00ARSD0213,L,1,125000,315000,0,0,0,0,0,63000,315000,252000
01SCS19E290421,BSC.AR-SE0029,00ARSE0284,M,1,125000,315000,0,0,0,0,0,63000,315000,252000
01SCS19E290422,AR.VCS-SC011,20ARSC0415,XL,1,214500,330000,2,0,99000,1,0,57750,231000,173250
01SCS19E290423,ESH.AR-SB0015,00ARSB0062,S,1,125000,315000,0,0,0,0,0,63000,315000,252000
01SCS19E290424,AR.CPT-QI001,20ARQI0002,ALL,1,94250,145000,2,0,29000,1,0,29000,116000,87000
01SCS19E290425,ESH.AR-SE0043,00ARSE0418,S,1,125000,315000,0,0,0,0,0,63000,315000,252000
01SCS19E290426,AR.TUC-SA002,20ARSA0006,M,1,204750,315000,2,0,63000,1,0,63000,252000,189000
01SCS19E290427,AR.TUC-SE005,20ARSE0380,M,1,204750,315000,2,0,63000,1,0,63000,252000,189000
01SCS19E290428,AR.CPT-SE006,20ARSE0373,M,1,204750,315000,2,0,63000,1,0,63000,252000,189000
01SCS19E290429,AR.CPT-SE003,20ARSE0360,S,1,94250,145000,2,0,29000,1,0,29000,116000,87000
01SCS19E290430,ESH.AR-SC0022,00ARSC0161,S,1,125000,315000,0,0,0,0,0,63000,315000,252000
01SCS19E290431,ESH.AR-RJ0003,00ARRJ0020,M,1,43000,135000,0,0,0,0,0,27000,135000,108000
01SCS19E290432,AR.TUC-SB018,20ARSB0477,S,1,87750,135000,2,0,27000,1,0,27000,108000,81000
01SCS19E290432,ESH.AR-RD0006,00ARRD0053,NON,1,37500,115000,0,0,0,0,0,23000,115000,92000
01SCS19E290433,AR.PUB-SD024,20ARSD0195,L,1,97500,150000,2,0,30000,1,0,30000,120000,90000
01SCS19E290434,BSC.AR-RL0022,00ARRL0143,L,1,94500,135000,0,0,0,0,0,27000,135000,108000
01SCS19E290435,AR.TUC-SD023,20ARSD0509,S,1,204750,315000,2,0,63000,1,0,63000,252000,189000
01SCS19E290436,AR.YAS-SE018,20ARSE0765,S,1,122850,189000,2,0,37800,1,0,37800,151200,113400
01SCS19E290437,ESH.AR-SE0011,00ARSE0044,XL,1,44500,135000,0,0,0,0,0,27000,135000,108000
01SCS19E290438,AR.MPR-SE024,20ARSE0215,M,1,230750,355000,2,0,71000,1,0,71000,284000,213000
01SCS19E290439,AR.CPT-SD009,20ARSD0447,L,1,94250,145000,2,0,29000,1,0,29000,116000,87000
01SCS19E290439,AR.TUC-RI012,20ARRI0372,L,1,87750,135000,2,0,27000,1,0,27000,108000,81000
01SCS19E290440,AR.MPR-SE033,20ARSE0305,L,1,230750,355000,2,0,71000,1,0,71000,284000,213000
01SCS19E290440,BSC.AR-SD0018,00ARSD0123,NON,1,45000,150000,0,0,0,0,0,30000,150000,120000
01SCS19E290440,BSC.AR-SE0001,00ARSE0059,L,1,44500,159000,0,0,0,0,0,31800,159000,127200
01SCS19E290441,AR.PCT-SE016,20ARSE0680,M,1,87750,135000,2,0,27000,1,0,27000,108000,81000
01SCS19E290442,ESH.AR-SE0021,00ARSE0231,S,1,44500,135000,0,0,0,0,0,27000,135000,108000
01SCS19E290443,AR.CPT-SE003,20ARSE0360,S,1,94250,145000,2,0,29000,1,0,29000,116000,87000
01SCS19E290444,AR.PUB-RJ030,20ARRJ0386,L,1,97500,150000,2,0,30000,1,0,30000,120000,90000
01SCS19E290445,AR.ESB-SE011,20ARSE0279,M,1,227500,350000,2,0,70000,1,0,70000,280000,210000
01SCS19E290446,ESH.AR-SA0013,00ARSA0098,M,1,44000,135000,0,0,0,0,0,27000,135000,108000
01SCS19E290447,AR.PUB-SE033,20ARSE0631,L,1,97500,150000,2,0,30000,1,0,30000,120000,90000
01SCS19E290447,AR.TUC-SA002,20ARSA0007,L,1,204750,315000,2,0,63000,1,0,63000,252000,189000
01SCS19E290447,AR.TUC-SD014,20ARSD0475,L,1,94250,145000,2,0,29000,1,0,29000,116000,87000
01SCS19E290448,ESH.AR-SD0037,00ARSD0335,NON,1,50000,150000,0,0,0,0,0,30000,150000,120000
01SCS19E290449,AR.MPR-SE002,20ARSE0143,L,1,97500,150000,2,0,45000,1,0,26250,105000,78750
01SCS19E290449,AR.MPR-SE010,20ARSE0174,M,1,97500,150000,2,0,45000,1,0,26250,105000,78750
01SCS19E300001,BSC.AR-SE0039,00ARSE0357,XL,1,52000,155000,0,0,0,0,0,31000,155000,124000
01SCS19E300002,BSC.AR-RJ0006,00ARRJ0061,L,1,94500,135000,0,0,0,0,0,27000,135000,108000
01SCS19E300003,AR.TUC-SE005,20ARSE0379,S,1,204750,315000,2,0,63000,1,0,63000,252000,189000
01SCS19E300004,AR.SMD-RI001,20ARRI0222,XL,1,87750,135000,2,0,40500,1,0,23625,94500,70875
01SCS19E300005,BSC.AR-SA0023,00ARSA0114,NON,1,47500,140000,0,0,0,0,0,28000,140000,112000
01SCS19E300005,ESH.AR-SD0005,00ARSD0050,M,1,44000,135000,0,0,0,0,0,27000,135000,108000
01SCS19E300006,AR.PUB-RK012,20ARRK0454,ALL,1,97500,150000,2,0,30000,1,0,30000,120000,90000
01SCS19E300007,ESH.AR-SE0026,00ARSE0251,S,1,44000,135000,0,0,0,0,0,27000,135000,108000
01SCS19E300008,AR.MKV-RC024,20ARRC0596,ALL,1,78000,120000,0,0,0,0,0,42000,120000,78000
01SCS19E300009,AR.TUC-SE011,20ARSE0403,S,1,94250,145000,2,0,29000,1,0,29000,116000,87000
01SCS19E300009,ESH.AR-SE0043,00ARSE0418,S,1,125000,315000,0,0,0,0,0,63000,315000,252000
01SCS19E300010,AR.TUC-SD022,20ARSD0507,L,1,94250,145000,2,0,29000,1,0,29000,116000,87000
01SCS19E300010,AR.TUC-SE029,20ARSE0812,ALL,1,87750,135000,2,0,27000,1,0,27000,108000,81000
01SCS19E300011,AR.ESB-SB003,20ARSB0102,L,1,100750,155000,2,0,31000,1,0,31000,124000,93000
01SCS19E300012,BSC.AR-SB0008,00ARSB0080,L,1,44500,135000,0,0,0,0,0,27000,135000,108000
01SCS19E300013,ESH.AR-SE0021,00ARSE0231,S,1,44500,135000,0,0,0,0,0,27000,135000,108000
01SCS19E300014,AR.HLW-SE010,20ARSE0551,L,1,100750,155000,2,0,31000,1,0,31000,124000,93000
01SCS19E300015,ESH.AR-SD0024,00ARSD0259,M,1,44500,135000,0,0,0,0,0,27000,135000,108000
01SCS19E300015,ESH.AR-SE0021,00ARSE0232,M,1,44500,135000,0,0,0,0,0,27000,135000,108000
01SCS19E300016,AR.PUB-RL020,20ARRL0197,M,1,97500,150000,2,0,30000,1,0,30000,120000,90000
01SCS19E300016,AR.TUC-SE006,20ARSE0385,L,1,204750,315000,2,0,63000,1,0,63000,252000,189000
01SCS19E300017,AR.ASH-RK002,20ARRK0508,M,1,195000,300000,2,0,90000,1,0,52500,210000,157500
01SCS19E300017,AR.TUC-SD021,20ARSD0501,S,1,94250,145000,2,0,29000,1,0,29000,116000,87000
01SCS19E300017,AR.TUC-SE012,20ARSE0409,L,1,94250,145000,2,0,29000,1,0,29000,116000,87000
01SCS19E300018,AR.PCT-SE019,20ARSE0686,M,1,87750,135000,2,0,27000,1,0,27000,108000,81000
01SCS19E300019,AR.TUC-SE011,20ARSE0404,M,1,94250,145000,2,0,29000,1,0,29000,116000,87000
01SCS19E300020,AR.CPT-SC011,20ARSC0477,L,1,204750,315000,2,0,63000,1,0,63000,252000,189000
01SCS19E300021,ESH.AR-SD0024,00ARSD0259,M,1,44500,135000,0,0,0,0,0,27000,135000,108000
01SCS19E300022,AR.TUC-SE007,20ARSE0389,L,1,204750,315000,2,0,63000,1,0,63000,252000,189000
01SCS19E300023,AR.HLW-SC011,20ARSC0147,XL,1,100750,155000,2,0,46500,1,0,27125,108500,81375
01SCS19E300024,AR.PUB-SC009,20ARSC0290,L,1,97500,150000,2,0,30000,1,0,30000,120000,90000
01SCS19E300025,AR.MPR-SE009,20ARSE0170,M,1,97500,150000,2,0,45000,1,0,26250,105000,78750
01SCS19E300026,AR.TUC-SD022,20ARSD0506,M,1,94250,145000,2,0,29000,1,0,29000,116000,87000
01SCS19E300027,ESH.AR-SC0022,00ARSC0162,M,1,125000,315000,0,0,0,0,0,63000,315000,252000
01SCS19E300028,AR.MDG-SC005,20ARSC0453,ALL,1,97500,150000,2,0,45000,1,0,26250,105000,78750
01SCS19E300029,BSC.AR-SC0028,00ARSC0196,M,1,125000,315000,0,0,0,0,0,63000,315000,252000
01SCS19E300030,AR.MKV-SC021,20ARSC0231,L,1,107250,165000,0,0,0,0,0,57750,165000,107250
01SCS19E300030,AR.PUB-SD010,20ARSD0120,ALL,1,97500,150000,2,0,30000,1,0,30000,120000,90000
01SCS19E300030,ARN.AR-RK0003,00ARRK0228,L,1,120000,315000,0,0,0,0,0,94500,315000,220500
01SCS19E300031,AR.TUC-SE029,20ARSE0812,ALL,1,87750,135000,2,0,27000,1,0,27000,108000,81000
01SCS19E300032,BSC.AR-SD0025,00ARSD0148,S,1,44500,159000,0,0,0,0,0,31800,159000,127200
01SCS19E300033,BSC.AR-SD0016,00ARSD0119,M,1,122000,375000,0,0,0,0,0,75000,375000,300000
01SCS19E300034,AR.TUC-SA002,20ARSA0006,M,1,204750,315000,2,0,63000,1,0,63000,252000,189000
01SCS19E300035,AR.MKV-SE015,20ARSE0594,XL,1,22750,350000,0,0,0,0,0,122500,350000,227500
01SCS19E300035,AR.TUC-SD021,20ARSD0504,XL,1,94250,145000,2,0,29000,1,0,29000,116000,87000
01SCS19E300036,ESH.AR-SE0027,00ARSE0255,S,1,44500,135000,0,0,0,0,0,27000,135000,108000
01SCS19E300037,AR.TUC-SA002,20ARSA0006,M,1,204750,315000,2,0,63000,1,0,63000,252000,189000
01SCS19E300038,BSC.AR-SE0011,00ARSE0097,S,1,44500,159000,0,0,0,0,0,31800,159000,127200
01SCS19E300038,BSC.AR-SE0040,00ARSE0358,S,1,44500,159000,0,0,0,0,0,31800,159000,127200
01SCS19E300039,AR.ESB-SD010,20ARSD0185,L,1,91000,140000,2,0,28000,1,0,28000,112000,84000
01SCS19E300039,AR.TUC-SD006,20ARSD0162,L,1,94250,145000,2,0,29000,1,0,29000,116000,87000
01SCS19E300039,AR.TUC-SE027,20ARSE0810,ALL,1,87750,135000,2,0,27000,1,0,27000,108000,81000
01SCS19E300040,AR.TUC-SA039,20ARSA0271,ALL,1,87750,135000,2,0,27000,1,0,27000,108000,81000
01SCS19E300040,BSC.AR-SE0003,00ARSE0066,M,1,44000,159000,0,0,0,0,0,31800,159000,127200
01SCS19E300041,BSC.AR-SD0060,00ARSD0332,NON,1,45000,140000,0,0,0,0,0,28000,140000,112000
01SCS19E300042,BSC.AR-SD0040,00ARSD0215,S,1,44500,159000,0,0,0,0,0,31800,159000,127200
01SCS19E300043,BSC.AR-SB0015,00ARSB0127,S,1,125000,315000,0,0,0,0,0,63000,315000,252000
01SCS19E300044,BE.RAK-SC018,00BESC0064,L,1,201500,310000,2,0,62000,1,0,62000,248000,186000
01SCS19E300045,AR.ESB-SE004,20ARSE0252,L,1,94250,145000,2,0,29000,1,0,29000,116000,87000
01SCS19E300046,ESH.AR-SC0004,00ARSC0022,M,1,44500,135000,0,0,0,0,0,27000,135000,108000
01SCS19E300047,BSC.AR-SE0029,00ARSE0285,L,1,125000,315000,0,0,0,0,0,63000,315000,252000
01SCS19E300048,BSC.AR-SC0006,00ARSC0040,L,1,44000,135000,0,0,0,0,0,27000,135000,108000
01SCS19E300049,BSC.AR-SD0053,00ARSD0284,M,1,44000,159000,0,0,0,0,0,31800,159000,127200
01SCS19E300050,ESH.AR-RK0014,00ARRK0189,L,1,245000,350000,0,0,0,0,0,70000,350000,280000
01SCS19E300051,AR.ESB-SE004,20ARSE0251,M,1,94250,145000,2,0,29000,1,0,29000,116000,87000
01SCS19E300052,AR.MDS-RE009,20ARRE0662,M,1,126750,195000,2,0,39000,1,0,39000,156000,117000
01SCS19E300053,AR.TUC-SE028,20ARSE0811,ALL,1,87750,135000,2,0,27000,1,0,27000,108000,81000
01SCS19E300054,BSC.AR-RK0009,00ARRK0082,M,1,52000,155000,0,0,0,0,0,31000,155000,124000
01SCS19E300054,BSC.AR-SE0009,00ARSE0089,S,1,44500,159000,0,0,0,0,0,31800,159000,127200
01SCS19E300055,BSC.AR-SE0036,00ARSE0342,30,1,125000,365000,0,0,0,0,0,73000,365000,292000
01SCS19E300055,ESH.AR-SC0027,00ARSC0262,M,1,125000,315000,0,0,0,0,0,63000,315000,252000
01SCS19E300056,BSC.AR-SE0031,00ARSE0293,L,1,52000,155000,0,0,0,0,0,31000,155000,124000
01SCS19E300056,ESH.AR-RK0005,00ARRK0022,M,1,94500,135000,0,0,0,0,0,27000,135000,108000
01SCS19E300057,AR.TUC-RI012,20ARRI0371,M,1,87750,135000,2,0,27000,1,0,27000,108000,81000
01SCS19E300058,AR.MKV-SE003,20ARSE0483,36,1,224250,345000,0,0,0,0,0,120750,345000,224250
01SCS19E300059,AR.CPT-SE003,20ARSE0361,M,1,94250,145000,2,0,29000,1,0,29000,116000,87000
01SCS19E300060,AR.KNR-RK007,20ARRK0274,M,1,152750,235000,2,0,70500,1,0,41125,164500,123375
01SCS19E300061,BSC.AR-SE0049,00ARSE0410,S,1,52000,155000,0,0,0,0,0,31000,155000,124000
01SCS19E300062,BSC.AR-SD0063,00ARSD0338,NON,1,60000,180000,0,0,0,0,0,36000,180000,144000
01SCS19E300063,ESH.AR-SE0005,00ARSE0019,L,1,44500,135000,0,0,0,0,0,27000,135000,108000
01SCS19E300064,AR.PUB-SB033,20ARSB0464,ALL,1,97500,150000,2,0,30000,1,0,30000,120000,90000
01SCS19E300065,AR.YAS-RL003,20ARRL0215,M,1,317850,489000,2,0,97800,1,0,97800,391200,293400
01SCS19E300066,AR.MKV-SD005,20ARSD0235,M,1,172250,265000,0,0,0,0,0,92750,265000,172250
01SCS19E300067,AR.SMD-SB001,20ARSB0192,M,1,211250,325000,2,0,65000,1,0,65000,260000,195000
01SCS19E300068,AR.PUB-RG028,20ARRG0140,L,1,224250,345000,2,0,69000,1,0,69000,276000,207000
01SCS19E300069,AR.SMD-SB001,20ARSB0193,L,1,211250,325000,2,0,65000,1,0,65000,260000,195000
01SCS19E300069,AR.TUC-SC003,20ARSC0054,L,1,87750,135000,2,0,27000,1,0,27000,108000,81000
01SCS19E300070,ESH.AR-SE0001,00ARSE0003,L,1,44000,135000,0,0,0,0,0,27000,135000,108000
01SCS19E300070,ESH.AR-SE0039,00ARSE0364,L,1,44000,135000,0,0,0,0,0,27000,135000,108000
01SCS19E300071,BSC.AR-SD0028,00ARSD0162,L,1,125000,315000,0,0,0,0,0,63000,315000,252000
01SCS19E300072,AR.ESB-SE009,20ARSE0270,S,1,91000,140000,2,0,28000,1,0,28000,112000,84000
01SCS19E300072,AR.MKV-SE009,20ARSE0509,28,1,227500,350000,0,0,0,0,0,122500,350000,227500
01SCS19E300072,BSC.AR-RK0021,00ARRK0204,M,1,145000,395000,0,0,0,0,0,79000,395000,316000
01SCS19E300073,ESH.AR-SD0018,00ARSD0136,S,1,125000,315000,0,0,0,0,0,63000,315000,252000
01SCS19E300074,BSC.AR-SA0005,00ARSA0022,S,1,44000,135000,0,0,0,0,0,27000,135000,108000
01SCS19E300074,ESH.AR-SE0012,00ARSE0045,S,1,44500,135000,0,0,0,0,0,27000,135000,108000
01SCS19E300075,THR.AR-RB0002,00ARRB0181,L,1,1030000,1030000,0,0,0,0,0,154500,1030000,875500
01SCS19E300076,ESH.AR-SD0030,00ARSD0296,M,1,44500,135000,0,0,0,0,0,27000,135000,108000
01SCS19E300077,AR.BPH-RH035,20ARRH0820,XL,1,220350,339000,2,0,169500,1,0,42375,169500,127125
01SCS19E300077,AR.BPH-SD005,20ARSD0374,XL,1,182000,280000,2,0,140000,1,0,35000,140000,105000
01SCS19E300077,AR.MPR-SE040,20ARSE0821,ALL,1,107250,165000,2,0,49500,1,0,28875,115500,86625
01SCS19E300077,AR.PUB-RG026,20ARRG0132,L,1,97500,150000,2,0,30000,1,0,30000,120000,90000
01SCS19E300077,AR.STY-SA010,20ARSA0069,ALL,1,51350,79000,2,0,15800,1,0,15800,63200,47400
01SCS19E300077,AR.YAS-SE014,20ARSE0749,S,1,122850,189000,2,0,37800,1,0,37800,151200,113400
01SCS19E300077,BSC.AR-SD0038,00ARSD0207,S,1,125000,315000,0,0,0,0,0,63000,315000,252000
01SCS19E300077,BSC.AR-SD0039,00ARSD0211,S,1,125000,315000,0,0,0,0,0,63000,315000,252000
01SCS19E300077,ESH.AR-SE0018,00ARSE0117,S,1,44500,135000,0,0,0,0,0,27000,135000,108000
01SCS19E300078,AR.MDS-RL006,20ARRL0375,M,1,117000,180000,2,0,36000,1,0,36000,144000,108000
01SCS19E300079,BSC.AR-SB0010,00ARSB0092,S,1,125000,315000,0,0,0,0,0,63000,315000,252000
01SCS19E300080,BSC.AR-SB0014,00ARSB0111,M,1,44000,135000,0,0,0,0,0,27000,135000,108000
01SCS19E300081,AR.CPT-SE006,20ARSE0374,L,1,204750,315000,2,0,63000,1,0,63000,252000,189000
01SCS19E300082,AR.PUB-SE024,20ARSE0092,M,1,159250,245000,2,0,49000,1,0,49000,196000,147000
01SCS19E300083,AR.STY-SE007,20ARSE0125,ALL,1,55250,85000,2,0,17000,1,0,17000,68000,51000
01SCS19E300084,AR.PUB-SB033,20ARSB0464,ALL,1,97500,150000,2,0,30000,1,0,30000,120000,90000
01SCS19E300084,ESH.AR-SD0031,00ARSD0299,S,1,44000,135000,0,0,0,0,0,27000,135000,108000
01SCS19E300085,AR.TUC-SE020,20ARSE0640,M,1,204750,315000,2,0,63000,1,0,63000,252000,189000
01SCS19E300086,AR.PUB-SE027,20ARSE0105,L,1,204750,315000,2,0,63000,1,0,63000,252000,189000
01SCS19E300087,AR.PUB-RL020,20ARRL0198,L,1,97500,150000,2,0,30000,1,0,30000,120000,90000
01SCS19E300088,BE.RAK-SA026,00BESA0109,XL,1,91000,140000,2,0,28000,1,0,28000,112000,84000
01SCS19E300089,AR.TUC-SD022,20ARSD0506,M,1,94250,145000,2,0,29000,1,0,29000,116000,87000
01SCS19E300090,ESH.AR-SE0016,00ARSE0110,M,1,44000,135000,0,0,0,0,0,27000,135000,108000
01SCS19E300091,AR.ESB-SB001,20ARSB0021,M,1,204750,315000,2,0,63000,1,0,63000,252000,189000
01SCS19E300092,BSC.AR-SD0039,00ARSD0213,L,1,125000,315000,0,0,0,0,0,63000,315000,252000
01SCS19E300093,AR.BPH-SD001,20ARSD0360,XL,1,103350,159000,2,0,47700,1,0,27825,111300,83475
01SCS19E300094,AR.PCT-SE019,20ARSE0686,M,1,87750,135000,2,0,27000,1,0,27000,108000,81000
01SCS19E300095,BSC.AR-SC0025,00ARSC0183,L,1,125000,315000,0,0,0,0,0,63000,315000,252000
01SCS19E300096,AR.BPH-SD006,20ARSD0376,M,1,259350,399000,2,0,199500,1,0,49875,199500,149625
01SCS19E300097,AR.TUC-SE007,20ARSE0388,M,1,204750,315000,2,0,63000,1,0,63000,252000,189000
01SCS19E300098,ESH.AR-RK0015,00ARRK0191,NON,1,43000,150000,0,0,0,0,0,30000,150000,120000
01SCS19E300099,ESH.AR-SD0018,00ARSD0136,S,1,125000,315000,0,0,0,0,0,63000,315000,252000
01SCS19E300100,AR.RDC-RL003,20ARRL0446,ALL,1,81250,125000,2,0,37500,1,0,21875,87500,65625
01SCS19E300101,BSC.AR-SE0050,00ARSE0415,M,1,52000,155000,0,0,0,0,0,31000,155000,124000
01SCS19E300102,AR.REC-RA005,20ARRA0252,L,1,107250,165000,2,0,49500,1,0,28875,115500,86625
01SCS19E300103,BSC.AR-SB0015,00ARSB0127,S,1,125000,315000,0,0,0,0,0,63000,315000,252000
01SCS19E300104,AR.TUC-SB011,20ARSB0039,ALL,1,97500,150000,2,0,30000,1,0,30000,120000,90000
01SCS19E300104,BSC.AR-SE0019,00ARSE0199,S,1,44000,159000,0,0,0,0,0,31800,159000,127200
01SCS19E300105,AR.MPR-SE008,20ARSE0168,XL,1,97500,150000,2,0,45000,1,0,26250,105000,78750
01SCS19E300105,AR.PUB-SE005,20ARSE0018,M,1,97500,150000,2,0,30000,1,0,30000,120000,90000
01SCS19E300106,AR.ESB-SE010,20ARSE0276,L,1,227500,350000,2,0,70000,1,0,70000,280000,210000
01SCS19E300107,ESH.AR-SD0028,00ARSD0276,L,1,44500,135000,0,0,0,0,0,27000,135000,108000
01SCS19E300108,AR.TUC-SA006,20ARSA0024,XL,1,87750,135000,2,0,27000,1,0,27000,108000,81000
01SCS19E300109,AR.TUC-SD014,20ARSD0475,L,1,94250,145000,2,0,29000,1,0,29000,116000,87000
01SCS19E300109,ESH.AR-SB0022,00ARSB0125,L,1,44000,135000,0,0,0,0,0,27000,135000,108000
01SCS19E300109,ESH.AR-SE0004,00ARSE0013,S,1,44500,135000,0,0,0,0,0,27000,135000,108000
01SCS19E300110,AR.ESB-SC019,20ARSC0468,ALL,1,68250,105000,2,0,52500,1,0,13125,52500,39375
01SCS19E300111,AR.TUC-SA002,20ARSA0008,XL,1,204750,315000,2,0,63000,1,0,63000,252000,189000
01SCS19E300112,AR.TUC-SE009,20ARSE0431,XL,1,204750,315000,2,0,63000,1,0,63000,252000,189000
01SCS19E300113,AR.CLK-RH001,20ARRH0736,ALL,1,91000,140000,2,0,28000,1,0,28000,112000,84000
01SCS19E300114,AR.PCT-SE015,20ARSE0678,M,1,87750,135000,2,0,27000,1,0,27000,108000,81000
01SCS19E300114,AR.PCT-SE016,20ARSE0680,M,1,87750,135000,2,0,27000,1,0,27000,108000,81000
01SCS19E300114,BSC.AR-SE0011,00ARSE0098,M,1,44500,159000,0,0,0,0,0,31800,159000,127200
01SCS19E300114,ESH.AR-SD0025,00ARSD0263,M,1,44000,135000,0,0,0,0,0,27000,135000,108000
01SCS19E300115,BSC.AR-SA0004,00ARSA0018,S,1,125000,315000,0,0,0,0,0,63000,315000,252000
01SCS19E300116,AR.PUB-SD033,20ARSD0243,M,1,204750,315000,2,0,63000,1,0,63000,252000,189000
01SCS19E300117,AR.MKV-RG004,20ARRG0090,ALL,1,78000,120000,0,0,0,0,0,42000,120000,78000
01SCS19E300118,ESH.AR-SA0014,00ARSA0103,L,1,44000,135000,0,0,0,0,0,27000,135000,108000
01SCS19E300119,AR.CLK-SA003,20ARSA0052,ALL,1,91000,140000,2,0,28000,1,0,28000,112000,84000
01SCS19E300119,AR.ESB-SE009,20ARSE0271,M,1,91000,140000,2,0,28000,1,0,28000,112000,84000
01SCS19E300120,AR.PUB-SE035,20ARSE0803,ALL,1,97500,150000,0,0,0,0,0,52500,150000,97500
01SCS19E300121,BSC.AR-SC0025,00ARSC0183,L,1,125000,315000,0,0,0,0,0,63000,315000,252000
01SCS19E300122,BSC.AR-SE0002,00ARSE0061,S,1,44000,159000,0,0,0,0,0,31800,159000,127200
01SCS19E300123,BSC.AR-SD0002,00ARSD0005,S,1,44000,159000,0,0,0,0,0,31800,159000,127200
01SCS19E300124,AR.TUC-RK046,20ARRK0197,XL,1,87750,135000,2,0,27000,1,0,27000,108000,81000
01SCS19E300124,BE.RAK-SA022,00BESA0089,XL,1,91000,140000,2,0,28000,1,0,28000,112000,84000
01SCS19E300124,BSC.AR-SD0039,00ARSD0213,L,1,125000,315000,0,0,0,0,0,63000,315000,252000
01SCS19E300125,BSC.AR-SC0023,00ARSC0174,M,1,44500,135000,0,0,0,0,0,27000,135000,108000
01SCS19E300126,AR.TUC-RI002,20ARRI0095,ALL,1,87750,135000,2,0,27000,1,0,27000,108000,81000
01SCS19E300127,BSC.AR-SB0013,00ARSB0106,S,1,44500,135000,0,0,0,0,0,27000,135000,108000
01SCS19E300128,AR.CPT-SC009,20ARSC0273,M,1,94250,145000,2,0,29000,1,0,29000,116000,87000
01SCS19E300129,AR.ESB-RH006,20ARRH0195,ALL,1,91000,140000,2,0,70000,1,0,17500,70000,52500
01SCS19E300130,AR.CLB-SE004,20ARSE0700,ALL,1,185250,285000,2,0,57000,1,0,57000,228000,171000
01SCS19E300131,AR.STY-SA003,20ARSA0062,ALL,1,61750,95000,2,0,19000,1,0,19000,76000,57000
01SCS19E300132,AR.PUB-SC015,20ARSC0362,L,1,97500,150000,2,0,30000,1,0,30000,120000,90000
01SCS19E300133,AR.HLW-SA013,20ARSA0105,M,1,120250,185000,2,0,55500,1,0,32375,129500,97125
01SCS19E300134,AR.CPT-RK007,20ARRK0023,S,1,204750,315000,2,0,63000,1,0,63000,252000,189000
01SCS19E300135,BSC.AR-SE0038,00ARSE0350,S,1,52000,155000,0,0,0,0,0,31000,155000,124000
01SCS19E300136,BSC.AR-SD0063,00ARSD0338,NON,1,60000,180000,0,0,0,0,0,36000,180000,144000
01SCS19E300137,ESH.AR-SD0039,00ARSD0348,M,1,122500,350000,0,0,0,0,0,70000,350000,280000
01SCS19E300138,AR.STY-SC004,20ARSC0203,ALL,1,64350,99000,2,0,19800,1,0,19800,79200,59400
01SCS19E300139,BSC.AR-SC0022,00ARSC0170,M,1,44500,135000,0,0,0,0,0,27000,135000,108000
01SCS19E300140,AR.STY-SE001,20ARSE0119,ALL,1,83850,129000,2,0,25800,1,0,25800,103200,77400
01SCS19E300140,BSC.AR-SB0009,00ARSB0083,M,1,44500,135000,0,0,0,0,0,27000,135000,108000
01SCS19E300141,AR.ESB-SB005,20ARSB0110,L,1,91000,140000,2,0,28000,1,0,28000,112000,84000
01SCS19E300141,ESH.AR-SE0016,00ARSE0110,M,1,44000,135000,0,0,0,0,0,27000,135000,108000
01SCS19E300142,AR.ESB-SE013,20ARSE0769,S,1,91000,140000,2,0,28000,1,0,28000,112000,84000
01SCS19E300142,AR.TUC-SD007,20ARSD0166,L,1,185250,285000,2,0,57000,1,0,57000,228000,171000
01SCS19E300143,AR.TUC-SE015,20ARSE0419,S,1,94250,145000,2,0,29000,1,0,29000,116000,87000
01SCS19E300144,AR.MKV-RE009,20ARRE0851,32,1,117000,180000,2,0,90000,1,0,22500,90000,67500
01SCS19E300144,AR.VLD-SA003,20ARSA0172,A,1,211250,325000,2,0,97500,1,0,56875,227500,170625
01SCS19E300145,AR.CPT-SC006,20ARSC0262,L,1,94250,145000,2,0,29000,1,0,29000,116000,87000
01SCS19E300146,AR.SMD-SD013,20ARSD0570,M,1,87750,135000,2,0,27000,1,0,27000,108000,81000
01SCS19E300146,ESH.AR-SA0006,00ARSA0071,S,1,44500,135000,0,0,0,0,0,27000,135000,108000
01SCS19E300147,AR.CPT-SC004,20ARSC0254,L,1,304850,469000,2,0,93800,1,0,93800,375200,281400
01SCS19E300147,AR.MER-SB004,20ARSB0222,S,1,97500,150000,2,0,45000,1,0,26250,105000,78750
01SCS19E300148,BSC.AR-SA0005,00ARSA0022,S,1,44000,135000,0,0,0,0,0,27000,135000,108000
01SCS19E300148,ESH.AR-SE0037,00ARSE0328,S,1,44000,135000,0,0,0,0,0,27000,135000,108000
01SCS19E300149,AR.ASH-RJ006,20ARRJ0267,S,1,91000,140000,2,0,42000,1,0,24500,98000,73500
01SCS19E300149,ESH.AR-SE0005,00ARSE0017,S,1,44500,135000,0,0,0,0,0,27000,135000,108000
01SCS19E300149,ESH.AR-SE0029,00ARSE0263,S,1,44500,135000,0,0,0,0,0,27000,135000,108000
01SCS19E300150,ESH.AR-SE0001,00ARSE0002,M,1,44000,135000,0,0,0,0,0,27000,135000,108000
01SCS19E300151,AR.CPT-SC014,20ARSC0487,S,1,94250,145000,2,0,29000,1,0,29000,116000,87000
01SCS19E300152,AR.TUC-SE011,20ARSE0404,M,1,94250,145000,2,0,29000,1,0,29000,116000,87000
01SCS19E300153,BSC.AR-SC0049,00ARSC0309,M,1,44500,159000,0,0,0,0,0,31800,159000,127200
01SCS19E300154,AR.HLW-SE010,20ARSE0551,L,1,100750,155000,2,0,31000,1,0,31000,124000,93000
01SCS19E300155,BSC.AR-SD0018,00ARSD0123,NON,1,45000,150000,0,0,0,0,0,30000,150000,120000
01SCS19E300156,AR.REC-RA005,20ARRA0252,L,1,107250,165000,2,0,49500,1,0,28875,115500,86625
01SCS19E300157,AR.SMD-SE003,20ARSE0440,S,1,87750,135000,2,0,27000,1,0,27000,108000,81000
01SCS19E300158,AR.TUC-RL023,20ARRL0347,ALL,1,87750,135000,2,0,27000,1,0,27000,108000,81000
01SCS19E300159,AR.GTW-SA003,20ARSA0305,L,1,94250,145000,2,0,43500,1,0,25375,101500,76125
01SCS19E300160,BSC.AR-RL0020,00ARRL0119,L,1,125000,315000,0,0,0,0,0,63000,315000,252000
01SCS19E300161,AR.STY-SA003,20ARSA0062,ALL,1,61750,95000,2,0,19000,1,0,19000,76000,57000
01SCS19E300161,AR.YAS-SE004,20ARSE0715,S,1,317850,489000,2,0,97800,1,0,97800,391200,293400
01SCS19E300162,ESH.AR-SD0024,00ARSD0259,M,1,44500,135000,0,0,0,0,0,27000,135000,108000
01SCS19E300163,BSC.AR-SE0050,00ARSE0415,M,1,52000,155000,0,0,0,0,0,31000,155000,124000
01SCS19E300164,ESH.AR-SB0031,00ARSB0207,XL,1,44500,135000,0,0,0,0,0,27000,135000,108000
01SCS19E300164,ESH.AR-SC0008,00ARSC0070,L,1,44500,135000,0,0,0,0,0,27000,135000,108000
01SCS19E300164,ESH.AR-SD0001,00ARSD0031,L,1,44500,135000,0,0,0,0,0,27000,135000,108000
01SCS19E300164,ESH.AR-SE0021,00ARSE0232,M,1,44500,135000,0,0,0,0,0,27000,135000,108000
01SCS19E300165,BSC.AR-SB0015,00ARSB0129,L,1,125000,315000,0,0,0,0,0,63000,315000,252000
01SCS19E300166,AR.CPT-SC009,20ARSC0273,M,1,94250,145000,2,0,29000,1,0,29000,116000,87000
01SCS19E300166,AR.ESB-SE007,20ARSE0263,M,1,94250,145000,2,0,29000,1,0,29000,116000,87000
01SCS19E300166,AR.PUB-RI008,20ARRI0123,L,1,191750,295000,2,0,59000,1,0,59000,236000,177000
01SCS19E300167,ESH.AR-SC0021,00ARSC0158,M,1,44000,135000,0,0,0,0,0,27000,135000,108000
01SCS19E300168,AR.MKV-SC022,20ARSC0235,L,1,97500,150000,0,0,0,0,0,52500,150000,97500
01SCS19E300169,AR.ESB-SD015,20ARSD0335,L,1,91000,140000,2,0,28000,1,0,28000,112000,84000
01SCS19E300169,AR.PUB-SE032,20ARSE0327,L,1,204750,315000,2,0,63000,1,0,63000,252000,189000
01SCS19E300170,AR.SMD-SD005,20ARSD0293,M,1,87750,135000,2,0,27000,1,0,27000,108000,81000
01SCS19E300171,ESH.AR-SE0001,00ARSE0003,L,1,44000,135000,0,0,0,0,0,27000,135000,108000
01SCS19E300172,AR.STY-SA003,20ARSA0062,ALL,1,61750,95000,2,0,19000,1,0,19000,76000,57000
01SCS19E300172,AR.TUC-SE015,20ARSE0420,M,1,94250,145000,2,0,29000,1,0,29000,116000,87000
01SCS19E300172,ESH.AR-SE0016,00ARSE0109,S,1,44000,135000,0,0,0,0,0,27000,135000,108000
01SCS19E300173,AR.TRF-RJ001,20ARRJ0056,M,1,97500,150000,2,0,45000,1,0,26250,105000,78750
01SCS19E300173,AR.TUC-RJ002,20ARRJ0106,ALL,1,22750,35000,2,0,7000,1,0,7000,28000,21000
01SCS19E300173,AR.YAS-SE006,20ARSE0721,S,1,382850,589000,2,0,117800,1,0,117800,471200,353400
01SCS19E300173,BSC.AR-SC0043,00ARSC0289,M,1,44000,135000,0,0,0,0,0,27000,135000,108000
01SCS19E300173,ESH.AR-SE0037,00ARSE0329,M,1,44000,135000,0,0,0,0,0,27000,135000,108000
01SCS19E300174,AR.TUC-SD012,20ARSD0466,M,1,94250,145000,2,0,29000,1,0,29000,116000,87000
01SCS19E300174,AR.TUC-SE001,20ARSE0287,ALL,1,146250,225000,2,0,45000,1,0,45000,180000,135000
01SCS19E300174,AR.YD-RL004,20ARRL0020,ALL,1,91000,140000,2,0,70000,1,0,17500,70000,52500
01SCS19E300174,AR.YD-RL007,20ARRL0023,ALL,1,87750,135000,2,0,67500,1,0,16875,67500,50625
01SCS19E300175,BSC.AR-SA0017,00ARSA0052,M,1,125000,315000,0,0,0,0,0,63000,315000,252000
01SCS19E300176,ESH.AR-SB0022,00ARSB0123,S,1,44000,135000,0,0,0,0,0,27000,135000,108000
01SCS19E300177,ESH.AR-SE0031,00ARSE0271,S,1,125000,315000,0,0,0,0,0,63000,315000,252000
01SCS19E300178,AR.SMD-RD003,20ARRD0133,L,1,87750,135000,2,0,40500,1,0,23625,94500,70875
01SCS19E300179,AR.YAS-SE018,20ARSE0766,M,1,122850,189000,2,0,37800,1,0,37800,151200,113400
01SCS19E300180,AR.MKV-RG004,20ARRG0090,ALL,1,78000,120000,0,0,0,0,0,42000,120000,78000
01SCS19E300181,AR.TUC-SD011,20ARSD0462,M,1,94250,145000,2,0,29000,1,0,29000,116000,87000
01SCS19E300182,AR.PUB-SD021,20ARSD0190,ALL,1,97500,150000,2,0,30000,1,0,30000,120000,90000
01SCS19E300182,ESH.AR-SD0032,00ARSD0305,L,1,44500,135000,0,0,0,0,0,27000,135000,108000
01SCS19E300183,AR.TUC-RI012,20ARRI0371,M,1,87750,135000,2,0,27000,1,0,27000,108000,81000
01SCS19E300183,AR.TUC-SB018,20ARSB0478,M,1,87750,135000,2,0,27000,1,0,27000,108000,81000
01SCS19E300183,BSC.AR-SD0026,00ARSD0153,M,1,44500,159000,0,0,0,0,0,31800,159000,127200
01SCS19E300184,AR.PUB-SE003,20ARSE0010,M,1,97500,150000,2,0,30000,1,0,30000,120000,90000
01SCS19E300184,ESH.AR-SD0007,00ARSD0058,M,1,44500,135000,0,0,0,0,0,27000,135000,108000
01SCS19E300185,AR.SMD-RH005,20ARRH0745,XL,1,211250,325000,2,0,97500,1,0,56875,227500,170625
01SCS19E300185,AR.TUC-SD022,20ARSD0508,XL,1,94250,145000,2,0,29000,1,0,29000,116000,87000
01SCS19E300186,BSC.AR-SD0061,00ARSD0336,NON,1,45000,150000,0,0,0,0,0,30000,150000,120000
01SCS19E300187,BSC.AR-RI0030,00ARRI0139,NON,1,98000,140000,0,0,0,0,0,28000,140000,112000
01SCS19E300188,AR.PUB-SB027,20ARSB0141,M,1,97500,150000,2,0,30000,1,0,30000,120000,90000
01SCS19E300188,AR.PUB-SD035,20ARSD0344,S,1,204750,315000,2,0,63000,1,0,63000,252000,189000
01SCS19E300189,AR.ESB-SE007,20ARSE0264,L,1,94250,145000,2,0,29000,1,0,29000,116000,87000
01SCS19E300189,AR.STY-SA003,20ARSA0062,ALL,1,61750,95000,2,0,19000,1,0,19000,76000,57000
01SCS19E300189,BSC.AR-SC0011,00ARSC0066,L,1,44000,159000,0,0,0,0,0,31800,159000,127200
01SCS19E300189,BSC.AR-SD0039,00ARSD0211,S,1,125000,315000,0,0,0,0,0,63000,315000,252000
01SCS19E300190,AR.TUC-RI012,20ARRI0373,XL,1,87750,135000,2,0,27000,1,0,27000,108000,81000
01SCS19E300191,AR.MKV-SE015,20ARSE0593,L,1,22750,350000,0,0,0,0,0,122500,350000,227500
01SCS19E300192,AR.TUC-SE020,20ARSE0640,M,1,204750,315000,2,0,63000,1,0,63000,252000,189000
01SCS19E300193,AR.ESB-SE017,20ARSE0786,M,1,104000,160000,2,0,32000,1,0,32000,128000,96000
01SCS19E300194,AR.PUB-SD015,20ARSD0127,L,1,97500,150000,2,0,30000,1,0,30000,120000,90000
01SCS19E300194,BSC.AR-SB0002,00ARSB0021,L,1,44500,135000,0,0,0,0,0,27000,135000,108000
01SCS19E300195,AR.CPT-SC013,20ARSC0484,M,1,94250,145000,2,0,29000,1,0,29000,116000,87000
01SCS19E300195,BSC.AR-SE0003,00ARSE0066,M,1,44000,159000,0,0,0,0,0,31800,159000,127200
01SCS19E300196,BSC.AR-SC0001,00ARSC0015,L,1,125000,315000,0,0,0,0,0,63000,315000,252000
01SCS19E300197,BSC.AR-SD0058,00ARSD0294,NON,1,50000,150000,0,0,0,0,0,30000,150000,120000
01SCS19E300198,AR.VCS-SC003,20ARSC0382,L,1,97500,150000,2,0,45000,1,0,26250,105000,78750
01SCS19E300199,ESH.AR-SD0011,00ARSD0074,M,1,125000,315000,0,0,0,0,0,63000,315000,252000
01SCS19E300200,BSC.AR-SC0027,00ARSC0191,M,1,106400,350000,0,0,0,0,0,70000,350000,280000
01SCS19E300200,BSC.AR-SE0037,00ARSE0347,M,1,44000,159000,0,0,0,0,0,31800,159000,127200
01SCS19E300201,AR.BPH-RH008,20ARRH0358,L,1,214500,330000,2,0,165000,1,0,41250,165000,123750
01SCS19E300201,ESH.AR-SE0017,00ARSE0114,M,1,44000,135000,0,0,0,0,0,27000,135000,108000
01SCS19E300202,ESH.AR-SE0016,00ARSE0109,S,1,44000,135000,0,0,0,0,0,27000,135000,108000
01SCS19E300202,ESH.AR-SE0027,00ARSE0257,L,1,44500,135000,0,0,0,0,0,27000,135000,108000
01SCS19E300202,ESH.AR-SE0038,00ARSE0334,L,1,44500,135000,0,0,0,0,0,27000,135000,108000
01SCS19E300203,AR.CPT-SE003,20ARSE0362,L,1,94250,145000,2,0,29000,1,0,29000,116000,87000
01SCS19E300204,ESH.AR-SE0003,00ARSE0009,S,1,44500,135000,0,0,0,0,0,27000,135000,108000
01SCS19E300205,AR.TUC-SE010,20ARSE0401,L,1,94250,145000,2,0,29000,1,0,29000,116000,87000
01SCS19E300205,AR.TUC-SE016,20ARSE0424,M,1,146250,225000,2,0,45000,1,0,45000,180000,135000
01SCS19E300205,BSC.AR-SE0049,00ARSE0411,M,1,52000,155000,0,0,0,0,0,31000,155000,124000
01SCS19E300206,AR.SMD-SD005,20ARSD0293,M,1,87750,135000,2,0,27000,1,0,27000,108000,81000
01SCS19E300206,BSC.AR-SE0027,00ARSE0276,M,1,52000,155000,0,0,0,0,0,31000,155000,124000
01SCS19E300206,ESH.AR-SD0042,00ARSD0375,M,1,125000,315000,0,0,0,0,0,63000,315000,252000
01SCS19E300207,AR.PUB-RL020,20ARRL0197,M,1,97500,150000,2,0,30000,1,0,30000,120000,90000
01SCS19E300207,ESH.AR-SE0016,00ARSE0110,M,1,44000,135000,0,0,0,0,0,27000,135000,108000
01SCS19E300208,BSC.AR-SE0050,00ARSE0414,S,1,52000,155000,0,0,0,0,0,31000,155000,124000
01SCS19E300209,BSC.AR-SD0060,00ARSD0332,NON,1,45000,140000,0,0,0,0,0,28000,140000,112000
01SCS19E300210,AR.CPT-SC014,20ARSC0487,S,1,94250,145000,2,0,29000,1,0,29000,116000,87000
01SCS19E300211,AR.PUB-SC007,20ARSC0281,M,1,97500,150000,2,0,30000,1,0,30000,120000,90000
01SCS19E300211,AR.SMD-SD012,20ARSD0567,L,1,87750,135000,2,0,27000,1,0,27000,108000,81000
01SCS19E300212,AR.TUC-SD007,20ARSD0164,S,1,185250,285000,2,0,57000,1,0,57000,228000,171000
01SCS19E300213,AR.TUC-SE011,20ARSE0405,L,1,94250,145000,2,0,29000,1,0,29000,116000,87000
01SCS19E300214,ESH.AR-SE0001,00ARSE0002,M,1,44000,135000,0,0,0,0,0,27000,135000,108000
01SCS19E300215,AR.CPT-RH009,20ARRH0874,L,1,204750,315000,2,0,63000,1,0,63000,252000,189000
01SCS19E300216,AR.PUB-SD011,20ARSD0121,ALL,1,97500,150000,2,0,30000,1,0,30000,120000,90000
01SCS19E300216,ESH.AR-SD0019,00ARSD0140,S,1,125000,315000,0,0,0,0,0,63000,315000,252000
01SCS19E300217,AR.PUB-SE009,20ARSE0034,M,1,97500,150000,2,0,30000,1,0,30000,120000,90000
01SCS19E300217,AR.YD-RL015,20ARRL0039,M,1,91000,140000,2,0,70000,1,0,17500,70000,52500
01SCS19E300218,BSC.AR-SD0028,00ARSD0162,L,1,125000,315000,0,0,0,0,0,63000,315000,252000
01SCS19E300219,AR.PUB-SE032,20ARSE0328,XL,1,204750,315000,2,0,63000,1,0,63000,252000,189000
01SCS19E300220,BSC.AR-SD0018,00ARSD0123,NON,1,45000,150000,0,0,0,0,0,30000,150000,120000
01SCS19E300221,AR.TUC-SE019,20ARSE0636,M,1,204750,315000,2,0,63000,1,0,63000,252000,189000
01SCS19E300222,BSC.AR-RJ0033,00ARRJ0216,NON,1,18000,75000,0,0,0,0,0,15000,75000,60000
01SCS19E300223,AR.TUC-SE026,20ARSE0809,ALL,1,87750,135000,2,0,27000,1,0,27000,108000,81000
01SCS19E300224,AR.TUC-RL018,20ARRL0342,ALL,1,87750,135000,2,0,27000,1,0,27000,108000,81000
01SCS19E300225,AR.TUC-SE015,20ARSE0420,M,1,94250,145000,2,0,29000,1,0,29000,116000,87000
01SCS19E300226,AR.ESB-SE005,20ARSE0254,S,1,94250,145000,2,0,29000,1,0,29000,116000,87000
01SCS19E300226,ESH.AR-SD0016,00ARSD0094,S,1,106400,350000,0,0,0,0,0,70000,350000,280000
01SCS19E300227,AR.PCT-SE015,20ARSE0679,L,1,87750,135000,2,0,27000,1,0,27000,108000,81000
01SCS19E300227,ESH.AR-SD0008,00ARSD0063,L,1,44500,135000,0,0,0,0,0,27000,135000,108000
01SCS19E300228,AR.CLB-SE002,20ARSE0698,ALL,1,185250,285000,2,0,57000,1,0,57000,228000,171000
01SCS19E300229,BSC.AR-SC0048,00ARSC0305,M,1,44500,159000,0,0,0,0,0,31800,159000,127200
01SCS19E300229,BSC.AR-SD0035,00ARSD0195,S,1,44500,159000,0,0,0,0,0,31800,159000,127200
01SCS19E300230,AR.STY-SE004,20ARSE0122,ALL,1,55250,85000,2,0,17000,1,0,17000,68000,51000
01SCS19E300231,AR.MKV-SE003,20ARSE0481,32,1,224250,345000,0,0,0,0,0,120750,345000,224250
01SCS19E300232,AR.HMR-SD007,20ARSD0546,L,1,243750,375000,2,0,75000,1,0,75000,300000,225000
01SCS19E300233,AR.STY-SE011,20ARSE0577,ALL,1,55250,85000,2,0,17000,1,0,17000,68000,51000
01SCS19E300234,AR.STY-SE009,20ARSE0127,ALL,1,55250,85000,2,0,17000,1,0,17000,68000,51000
01SCS19E300235,AR.MPR-SE013,20ARSE0186,M,1,110500,170000,2,0,51000,1,0,29750,119000,89250
01SCS19E300236,AR.PUB-SD017,20ARSD0135,L,1,204750,315000,2,0,63000,1,0,63000,252000,189000
01SCS19E300237,BSC.AR-SE0027,00ARSE0276,M,1,52000,155000,0,0,0,0,0,31000,155000,124000
01SCS19E300238,ESH.AR-RK0017,00ARRK0193,NON,1,43000,150000,0,0,0,0,0,30000,150000,120000
01SCS19E300239,ESH.AR-SB0032,00ARSB0211,XL,1,125000,315000,0,0,0,0,0,63000,315000,252000
01SCS19E300240,AR.CPT-SC009,20ARSC0273,M,1,94250,145000,2,0,29000,1,0,29000,116000,87000
01SCS19E300240,ESH.AR-SE0036,00ARSE0324,S,1,44500,135000,0,0,0,0,0,27000,135000,108000
01SCS19E300241,AR.BPH-RH008,20ARRH0356,S,1,214500,330000,2,0,165000,1,0,41250,165000,123750
01SCS19E300241,ESH.AR-SE0005,00ARSE0017,S,1,44500,135000,0,0,0,0,0,27000,135000,108000
01SCS19E300242,AR.TUC-SE008,20ARSE0393,L,1,204750,315000,2,0,63000,1,0,63000,252000,189000
01SCS19E300243,AR.TUC-RI012,20ARRI0371,M,1,87750,135000,2,0,27000,1,0,27000,108000,81000
01SCS19E300243,AR.TUC-SE011,20ARSE0405,L,1,94250,145000,2,0,29000,1,0,29000,116000,87000
01SCS19E300243,ESH.AR-SB0006,00ARSB0024,M,1,44500,135000,0,0,0,0,0,27000,135000,108000
01SCS19E300243,ESH.AR-SD0002,00ARSD0039,L,1,44500,135000,0,0,0,0,0,27000,135000,108000
01SCS19E300244,BE.RAK-SA024,00BESA0097,M,1,104000,160000,2,0,32000,1,0,32000,128000,96000
01SCS19E300245,AR.PUB-SD004,20ARSD0090,ALL,1,97500,150000,2,0,30000,1,0,30000,120000,90000
01SCS19E300246,AR.TUC-SE005,20ARSE0382,XL,1,204750,315000,2,0,63000,1,0,63000,252000,189000
01SCS19E300247,AR.ESB-SC019,20ARSC0468,ALL,1,68250,105000,2,0,52500,1,0,13125,52500,39375
01SCS19E300248,AR.TUC-SE019,20ARSE0637,L,1,204750,315000,2,0,63000,1,0,63000,252000,189000
01SCS19E300249,AR.SMD-SA003,20ARSA0228,M,1,87750,135000,2,0,27000,1,0,27000,108000,81000
01SCS19E300250,AR.TUC-SD004,20ARSD0154,L,1,204750,315000,2,0,63000,1,0,63000,252000,189000
01SCS19E300251,AR.YD-SB001,20ARSB0088,S,1,195000,300000,2,0,150000,1,0,37500,150000,112500
01SCS19E300252,ESH.AR-RK0014,00ARRK0190,XL,1,112500,350000,0,0,0,0,0,70000,350000,280000
01SCS19E300253,AR.TUC-SE020,20ARSE0641,L,1,204750,315000,2,0,63000,1,0,63000,252000,189000
01SCS19E300254,AR.PUB-SC015,20ARSC0362,L,1,97500,150000,2,0,30000,1,0,30000,120000,90000
01SCS19E300254,ESH.AR-SE0038,00ARSE0334,L,1,44500,135000,0,0,0,0,0,27000,135000,108000
01SCS19E300255,BSC.AR-SA0005,00ARSA0024,L,1,94500,135000,0,0,0,0,0,27000,135000,108000
01SCS19E300255,ESH.AR-SD0032,00ARSD0303,S,1,44500,135000,0,0,0,0,0,27000,135000,108000
01SCS19E300255,ESH.AR-SE0043,00ARSE0418,S,1,125000,315000,0,0,0,0,0,63000,315000,252000
01SCS19E300255,ESH.AR-SE0043,00ARSE0419,M,1,125000,315000,0,0,0,0,0,63000,315000,252000
01SCS19E300256,AR.HLW-SA015,20ARSA0111,L,1,100750,155000,2,0,46500,1,0,27125,108500,81375
01SCS19E300256,ESH.AR-RK0009,00ARRK0038,M,1,44500,135000,0,0,0,0,0,27000,135000,108000
01SCS19E300257,AR.SMD-SD012,20ARSD0567,L,1,87750,135000,2,0,27000,1,0,27000,108000,81000
01SCS19E300257,AR.TUC-SB017,20ARSB0474,M,1,87750,135000,2,0,27000,1,0,27000,108000,81000
01SCS19E300258,AR.PUB-SD010,20ARSD0120,ALL,1,97500,150000,2,0,30000,1,0,30000,120000,90000
01SCS19E300259,AR.PUB-SD030,20ARSD0211,34,1,211250,325000,2,0,65000,1,0,65000,260000,195000
01SCS19E300260,AR.MKV-SE003,20ARSE0481,32,1,224250,345000,0,0,0,0,0,120750,345000,224250
01SCS19E300260,AR.TUC-SE015,20ARSE0420,M,1,94250,145000,2,0,29000,1,0,29000,116000,87000
01SCS19E300261,AR.ASH-RK004,20ARRK0515,S,1,195000,300000,2,0,90000,1,0,52500,210000,157500
01SCS19E300261,AR.PCT-SE019,20ARSE0687,L,1,87750,135000,2,0,27000,1,0,27000,108000,81000
01SCS19E300262,AR.TUC-SE010,20ARSE0401,L,1,94250,145000,2,0,29000,1,0,29000,116000,87000
01SCS19E300262,ESH.AR-SD0028,00ARSD0274,S,1,44500,135000,0,0,0,0,0,27000,135000,108000
01SCS19E300263,AR.MDS-RL002,20ARRL0360,L,1,117000,180000,2,0,36000,1,0,36000,144000,108000
01SCS19E300263,AR.REC-SD009,20ARSD0034,M,1,178750,275000,2,0,82500,1,0,48125,192500,144375
01SCS19E300263,BSC.AR-SE0039,00ARSE0354,S,1,52000,155000,0,0,0,0,0,31000,155000,124000
01SCS19E300264,AR.MPR-SE040,20ARSE0821,ALL,1,107250,165000,2,0,49500,1,0,28875,115500,86625
01SCS19E300265,AR.TUC-SE008,20ARSE0393,L,1,204750,315000,2,0,63000,1,0,63000,252000,189000
01SCS19E300266,ESH.AR-SE0016,00ARSE0110,M,1,44000,135000,0,0,0,0,0,27000,135000,108000
01SCS19E300267,ESH.AR-SE0037,00ARSE0328,S,1,44000,135000,0,0,0,0,0,27000,135000,108000
01SCS19E300268,ESH.AR-SE0017,00ARSE0114,M,1,44000,135000,0,0,0,0,0,27000,135000,108000
01SCS19E300268,ESH.AR-SE0039,00ARSE0363,M,1,44000,135000,0,0,0,0,0,27000,135000,108000
01SCS19E300269,ESH.AR-SE0001,00ARSE0001,S,1,44000,135000,0,0,0,0,0,27000,135000,108000
01SCS19E300270,AR.PUB-SD021,20ARSD0190,ALL,1,97500,150000,2,0,30000,1,0,30000,120000,90000
01SCS19E300270,BSC.AR-SD0039,00ARSD0211,S,1,125000,315000,0,0,0,0,0,63000,315000,252000
01SCS19E300271,AR.TUC-SE029,20ARSE0812,ALL,1,87750,135000,2,0,27000,1,0,27000,108000,81000
01SCS19E300272,BSC.AR-SE0005,00ARSE0073,S,1,44000,159000,0,0,0,0,0,31800,159000,127200
01SCS19E300273,AR.TUC-SE008,20ARSE0392,M,1,204750,315000,2,0,63000,1,0,63000,252000,189000
01SCS19E300274,AR.ESB-RK002,20ARRK0228,M,1,198250,305000,2,0,61000,1,0,61000,244000,183000
01SCS19E300275,AR.HLW-SC010,20ARSC0143,M,1,100750,155000,2,0,46500,1,0,27125,108500,81375
01SCS19E300275,BSC.AR-SE0040,00ARSE0359,M,1,44500,159000,0,0,0,0,0,31800,159000,127200
01SCS19E300276,AR.TUC-SE020,20ARSE0640,M,1,204750,315000,2,0,63000,1,0,63000,252000,189000
01SCS19E300277,BSC.AR-SE0033,00ARSE0316,30,1,125400,365000,0,0,0,0,0,73000,365000,292000
01SCS19E300278,BSC.AR-SE0013,00ARSE0176,M,1,44000,159000,0,0,0,0,0,31800,159000,127200
01SCS19E300278,ESH.AR-RK0005,00ARRK0022,M,1,94500,135000,0,0,0,0,0,27000,135000,108000
01SCS19E300279,BSC.AR-RI0029,00ARRI0138,NON,1,43000,140000,0,0,0,0,0,28000,140000,112000
01SCS19E300279,ESH.AR-SC0013,00ARSC0107,XL,1,44500,135000,0,0,0,0,0,27000,135000,108000
01SCS19E300279,ESH.AR-SE0005,00ARSE0017,S,1,44500,135000,0,0,0,0,0,27000,135000,108000
01SCS19E300280,AR.TUC-SE006,20ARSE0386,XL,1,204750,315000,2,0,63000,1,0,63000,252000,189000
01SCS19E300281,ESH.AR-SD0038,00ARSD0345,L,1,122500,350000,0,0,0,0,0,70000,350000,280000
01SCS19E300282,AR.ASH-RJ007,20ARRJ0272,L,1,91000,140000,2,0,42000,1,0,24500,98000,73500
01SCS19E300283,AR.PUB-SE003,20ARSE0010,M,1,97500,150000,2,0,30000,1,0,30000,120000,90000
01SCS19E300283,ESH.AR-RH0004,00ARRH0038,M,1,94500,135000,0,0,0,0,0,27000,135000,108000
01SCS19E300284,ESH.AR-SC0004,00ARSC0023,L,1,44500,135000,0,0,0,0,0,27000,135000,108000
01SCS19E300285,BSC.AR-SB0017,00ARSB0136,S,1,44000,135000,0,0,0,0,0,27000,135000,108000
01SCS19E300286,AR.ESB-SD006,20ARSD0119,XL,1,204750,315000,2,0,63000,1,0,63000,252000,189000
01SCS19E300286,ESH.AR-RJ0023,00ARRJ0218,NON,1,18000,75000,0,0,0,0,0,15000,75000,60000
01SCS19E300287,BSC.AR-SD0026,00ARSD0154,L,1,44500,159000,0,0,0,0,0,31800,159000,127200
01SCS19E300287,BSC.AR-SD0029,00ARSD0172,L,1,44500,159000,0,0,0,0,0,31800,159000,127200
01SCS19E300287,ESH.AR-SE0027,00ARSE0258,XL,1,44500,135000,0,0,0,0,0,27000,135000,108000
01SCS19E300288,ESH.AR-SD0043,00ARSD0395,M,1,125000,315000,0,0,0,0,0,63000,315000,252000
01SCS19E300289,ESH.AR-SE0027,00ARSE0255,S,1,44500,135000,0,0,0,0,0,27000,135000,108000
01SCS19E300290,ESH.AR-SD0038,00ARSD0343,S,1,122500,350000,0,0,0,0,0,70000,350000,280000
01SCS19E300291,BSC.AR-SC0042,00ARSC0277,M,1,135000,375000,0,0,0,0,0,75000,375000,300000
01SCS19E300292,ESH.AR-SE0027,00ARSE0257,L,1,44500,135000,0,0,0,0,0,27000,135000,108000
01SCS19E300293,AR.CLK-RH001,20ARRH0736,ALL,1,91000,140000,2,0,28000,1,0,28000,112000,84000
01SCS19E300294,AR.CPT-SB001,20ARSB0084,L,1,204750,315000,2,0,63000,1,0,63000,252000,189000
01SCS19E300295,ESH.AR-RK0013,00ARRK0130,M,1,44500,135000,0,0,0,0,0,27000,135000,108000
01SCS19E300295,ESH.AR-SD0032,00ARSD0303,S,1,44500,135000,0,0,0,0,0,27000,135000,108000
01SCS19E300296,AR.MPR-SE030,20ARSE0293,L,1,230750,355000,2,0,71000,1,0,71000,284000,213000
01SCS19E300297,AR.MER-RC004,20ARSE0690,ALL,1,97500,150000,2,0,45000,1,0,26250,105000,78750
01SCS19E300298,ESH.AR-SD0027,00ARSD0271,M,1,44000,135000,0,0,0,0,0,27000,135000,108000
01SCS19E300298,ESH.AR-SD0027,00ARSD0272,L,1,44000,135000,0,0,0,0,0,27000,135000,108000
01SCS19E300299,BE.RAK-RK013,00BERK0040,S,1,256750,395000,2,0,79000,1,0,79000,316000,237000
01SCS19E300300,ESH.AR-SE0027,00ARSE0257,L,1,44500,135000,0,0,0,0,0,27000,135000,108000
01SCS19E300301,BSC.AR-SA0017,00ARSA0052,M,1,125000,315000,0,0,0,0,0,63000,315000,252000
01SCS19E300301,BSC.AR-SD0001,00ARSD0001,S,1,44000,159000,0,0,0,0,0,31800,159000,127200
01SCS19E300302,BSC.AR-SD0052,00ARSD0279,S,1,44500,159000,0,0,0,0,0,31800,159000,127200
01SCS19E300303,BSC.AR-SC0001,00ARSC0013,S,1,125000,315000,0,0,0,0,0,63000,315000,252000
01SCS19E300304,AR.TUC-SE008,20ARSE0392,M,1,204750,315000,2,0,63000,1,0,63000,252000,189000
01SCS19E300305,ESH.AR-SE0010,00ARSE0037,S,1,44000,135000,0,0,0,0,0,27000,135000,108000
01SCS19E300306,ESH.AR-SD0026,00ARSD0268,L,1,44500,135000,0,0,0,0,0,27000,135000,108000
01SCS19E300307,AR.CPT-RL002,20ARRL0076,L,1,94250,145000,2,0,29000,1,0,29000,116000,87000
01SCS19E300308,ESH.AR-SE0037,00ARSE0328,S,1,44000,135000,0,0,0,0,0,27000,135000,108000
01SCS19E300309,BSC.AR-SD0028,00ARSD0160,S,1,125000,315000,0,0,0,0,0,63000,315000,252000
01SCS19E300310,ESH.AR-SB0027,00ARSB0159,S,1,44000,135000,0,0,0,0,0,27000,135000,108000
01SCS19E300311,AR.ESB-SE014,20ARSE0773,S,1,104000,160000,2,0,32000,1,0,32000,128000,96000
01SCS19E300311,AR.PCT-QE016,20ARQE0784,L,1,78000,120000,2,0,60000,1,0,15000,60000,45000
01SCS19E300311,AR.TUC-SD022,20ARSD0508,XL,1,94250,145000,2,0,29000,1,0,29000,116000,87000
01SCS19E300312,BSC.AR-SD0030,00ARSD0174,S,1,44500,159000,0,0,0,0,0,31800,159000,127200
01SCS19E300313,ESH.AR-SC0032,00ARSC0282,L,1,44500,135000,0,0,0,0,0,27000,135000,108000
01SCS19E300314,AR.PUB-SE007,20ARSE0027,L,1,97500,150000,2,0,30000,1,0,30000,120000,90000
01SCS19E300315,AR.TUC-SE016,20ARSE0424,M,1,146250,225000,2,0,45000,1,0,45000,180000,135000
01SCS19E300316,ESH.AR-SE0003,00ARSE0009,S,1,44500,135000,0,0,0,0,0,27000,135000,108000
01SCS19E300317,AR.PUB-RJ042,20ARRJ0518,M,1,97500,150000,2,0,30000,1,0,30000,120000,90000
01SCS19E300317,AR.PUB-SE036,20ARSE0805,M,1,159250,245000,0,0,0,0,0,85750,245000,159250
01SCS19E300317,AR.STY-SE007,20ARSE0125,ALL,1,55250,85000,2,0,17000,1,0,17000,68000,51000
01SCS19E300317,AR.TUC-SB017,20ARSB0475,L,1,87750,135000,2,0,27000,1,0,27000,108000,81000
01SCS19E300318,AR.MPR-SE033,20ARSE0306,XL,1,230750,355000,2,0,71000,1,0,71000,284000,213000
01SCS19E300319,AR.TUC-SD006,20ARSD0162,L,1,94250,145000,2,0,29000,1,0,29000,116000,87000
01SCS19E300320,BSC.AR-SC0033,00ARSC0227,XL,1,125000,315000,0,0,0,0,0,63000,315000,252000
01SCS19E300321,ESH.AR-SD0018,00ARSD0138,L,1,125000,315000,0,0,0,0,0,63000,315000,252000
01SCS19E300322,DKS.AR-SE0008,00ARSE0159,36,1,41727,696000,0,0,0,0,0,104400,696000,591600
01SCS19E300323,AR.MKV-SE016,20ARSE0595,S,1,22750,350000,0,0,0,0,0,122500,350000,227500
01SCS19E300324,AR.MPR-SE025,20ARSE0221,XL,1,230750,355000,2,0,71000,1,0,71000,284000,213000
01SCS19E300325,AR.TUC-SE020,20ARSE0640,M,1,204750,315000,2,0,63000,1,0,63000,252000,189000
01SCS19E300326,BE.RAK-SC020,00BESC0073,M,1,201500,310000,2,0,62000,1,0,62000,248000,186000
01SCS19E300327,BSC.AR-SC0005,00ARSC0035,M,1,44500,159000,0,0,0,0,0,31800,159000,127200
01SCS19E300328,ESH.AR-SD0032,00ARSD0303,S,1,44500,135000,0,0,0,0,0,27000,135000,108000
01SCS19E300329,ESH.AR-SE0037,00ARSE0329,M,1,44000,135000,0,0,0,0,0,27000,135000,108000
01SCS19E300330,AR.MER-RH002,20ARRH0225,XL,1,204750,315000,2,0,94500,1,0,55125,220500,165375
01SCS19E300331,BSC.AR-SD0001,00ARSD0001,S,1,44000,159000,0,0,0,0,0,31800,159000,127200
01SCS19E300332,BSC.AR-SD0063,00ARSD0338,NON,1,60000,180000,0,0,0,0,0,36000,180000,144000
01SCS19E300333,ESH.AR-SE0001,00ARSE0001,S,1,44000,135000,0,0,0,0,0,27000,135000,108000
01SCS19E300334,AR.PUB-RL020,20ARRL0197,M,1,97500,150000,2,0,30000,1,0,30000,120000,90000
01SCS19E300335,AR.GTW-SC003,20ARSC0029,S,1,204750,315000,2,0,94500,1,0,55125,220500,165375
01SCS19E300336,ESH.AR-SC0026,00ARSC0237,M,1,44500,135000,0,0,0,0,0,27000,135000,108000
01SCS19E300337,AR.ESB-SE012,20ARSE0284,L,1,198250,305000,2,0,61000,1,0,61000,244000,183000
01SCS19E300338,ESH.AR-SD0018,00ARSD0137,M,1,125000,315000,0,0,0,0,0,63000,315000,252000
01SCS19E300339,AR.MKV-SD004,20ARSD0232,32,1,117000,180000,0,0,0,0,0,63000,180000,117000
01SCS19E300340,AR.ESB-SB003,20ARSB0102,L,1,100750,155000,2,0,31000,1,0,31000,124000,93000
01SCS19E300341,AR.MPR-SE010,20ARSE0174,M,1,97500,150000,2,0,45000,1,0,26250,105000,78750
01SCS19E300341,BSC.AR-SD0066,00ARSD0356,M,1,44500,159000,0,0,0,0,0,31800,159000,127200
01SCS19E300342,AR.TUC-SE005,20ARSE0380,M,1,204750,315000,2,0,63000,1,0,63000,252000,189000
01SCS19E300343,ESH.AR-SC0024,00ARSC0213,L,1,119000,350000,0,0,0,0,0,70000,350000,280000
01SCS19E300344,BSC.AR-SD0052,00ARSD0279,S,1,44500,159000,0,0,0,0,0,31800,159000,127200
01SCS19E300344,BSC.AR-SE0006,00ARSE0077,S,1,44500,159000,0,0,0,0,0,31800,159000,127200
01SCS19E300345,BSC.AR-SC0049,00ARSC0309,M,1,44500,159000,0,0,0,0,0,31800,159000,127200
01SCS19E300345,BSC.AR-SD0019,00ARSD0124,NON,1,45000,150000,0,0,0,0,0,30000,150000,120000
01SCS19E300346,AR.SMD-SD010,20ARSD0313,34,1,211250,325000,2,0,65000,1,0,65000,260000,195000
01SCS19E300347,AR.SMD-RL001,20ARRL0265,ALL,1,22750,35000,2,0,7000,1,0,7000,28000,21000
01SCS19E300347,ESH.AR-SE0005,00ARSE0017,S,1,44500,135000,0,0,0,0,0,27000,135000,108000
01SCS19E300347,ESH.AR-SE0029,00ARSE0263,S,1,44500,135000,0,0,0,0,0,27000,135000,108000
01SCS19E300348,ESH.AR-SD0038,00ARSD0343,S,1,122500,350000,0,0,0,0,0,70000,350000,280000
01SCS19E300349,AR.TUC-SE020,20ARSE0639,S,1,204750,315000,2,0,63000,1,0,63000,252000,189000
01SCS19E300350,AR.TUC-SD006,20ARSD0161,M,1,94250,145000,2,0,29000,1,0,29000,116000,87000
01SCS19E300351,AR.ESB-SE003,20ARSE0247,M,1,204750,315000,2,0,63000,1,0,63000,252000,189000
01SCS19E300351,AR.TUC-SE025,20ARSE0662,34,1,204750,315000,2,0,63000,1,0,63000,252000,189000
01SCS19E300352,AR.YD-RL017,20ARRL0047,M,1,91000,140000,2,0,70000,1,0,17500,70000,52500
01SCS19E300353,ESH.AR-SE0028,00ARSE0261,L,1,44000,135000,0,0,0,0,0,27000,135000,108000
01SCS19E300354,BSC.AR-SE0049,00ARSE0412,L,1,52000,155000,0,0,0,0,0,31000,155000,124000
01SCS19E300354,ESH.AR-SE0004,00ARSE0015,L,1,44500,135000,0,0,0,0,0,27000,135000,108000
01SCS19E300354,ESH.AR-SE0020,00ARSE0127,L,1,44000,135000,0,0,0,0,0,27000,135000,108000
01SCS19E300355,AR.GTW-SB002,20ARSB0153,M,1,214500,330000,2,0,99000,1,0,57750,231000,173250
01SCS19E300356,BSC.AR-SE0035,00ARSE0336,28,1,125000,365000,0,0,0,0,0,73000,365000,292000
01SCS19E300357,AR.PUB-SD033,20ARSD0244,L,1,204750,315000,2,0,63000,1,0,63000,252000,189000
01SCS19E300358,AR.VCS-SC003,20ARSC0383,XL,1,97500,150000,2,0,45000,1,0,26250,105000,78750
01SCS19E300358,ESH.AR-SE0005,00ARSE0020,XL,1,44500,135000,0,0,0,0,0,27000,135000,108000
01SCS19E300359,BSC.AR-SD0042,00ARSD0228,M,1,44500,159000,0,0,0,0,0,31800,159000,127200
01SCS19E300360,AR.MPR-SE013,20ARSE0187,L,1,110500,170000,2,0,51000,1,0,29750,119000,89250
01SCS19E300361,AR.MKV-SB001,20ARSB0002,M,1,227500,350000,0,0,0,0,0,122500,350000,227500
01SCS19E300362,ESH.AR-SE0003,00ARSE0009,S,1,44500,135000,0,0,0,0,0,27000,135000,108000
01SCS19E300362,ESH.AR-SE0016,00ARSE0109,S,1,44000,135000,0,0,0,0,0,27000,135000,108000
01SCS19E300363,BSC.AR-RL0028,00ARRL0180,L,1,44500,135000,0,0,0,0,0,27000,135000,108000
01SCS19E300364,ESH.AR-SE0027,00ARSE0255,S,1,44500,135000,0,0,0,0,0,27000,135000,108000
01SCS19E300365,AR.STY-SE011,20ARSE0577,ALL,1,55250,85000,2,0,17000,1,0,17000,68000,51000
01SCS19E300366,BSC.AR-SE0003,00ARSE0065,S,1,44000,159000,0,0,0,0,0,31800,159000,127200
01SCS19E300367,AR.CPT-SE003,20ARSE0361,M,1,94250,145000,2,0,29000,1,0,29000,116000,87000
01SCS19E300367,AR.YD-SB005,20ARSB0510,L,1,195000,300000,2,0,90000,1,0,52500,210000,157500
01SCS19E300368,AR.HLW-SA003,20ARSA0090,ALL,1,91000,140000,2,0,28000,1,0,28000,112000,84000
01SCS19E300368,AR.MPR-SE024,20ARSE0215,M,1,230750,355000,2,0,71000,1,0,71000,284000,213000
01SCS19E300369,AR.TUC-SD007,20ARSD0166,L,1,185250,285000,2,0,57000,1,0,57000,228000,171000
01SCS19E300370,AR.MDS-RL002,20ARRL0360,L,1,117000,180000,2,0,36000,1,0,36000,144000,108000
01SCS19E300370,AR.PUB-SE001,20ARSE0002,M,1,97500,150000,2,0,30000,1,0,30000,120000,90000
01SCS19E300371,AR.CPT-RH003,20ARRH0061,ALL,1,94250,145000,2,0,29000,1,0,29000,116000,87000
01SCS19E300371,AR.TUC-SA040,20ARSA0272,ALL,1,87750,135000,2,0,27000,1,0,27000,108000,81000
01SCS19E300372,BSC.AR-SE0027,00ARSE0275,S,1,52000,155000,0,0,0,0,0,31000,155000,124000
01SCS19E300373,AR.PCT-SE015,20ARSE0678,M,1,87750,135000,2,0,27000,1,0,27000,108000,81000
01SCS19E300374,ESH.AR-SB0022,00ARSB0123,S,1,44000,135000,0,0,0,0,0,27000,135000,108000
01SCS19E300375,AR.ESB-SC018,20ARSC0465,M,1,91000,140000,2,0,28000,1,0,28000,112000,84000
01SCS19E300376,AR.PCT-SE002,20ARSE0338,M,1,87750,135000,2,0,27000,1,0,27000,108000,81000
01SCS19E300376,AR.PUB-RL026,20ARRL0430,L,1,97500,150000,2,0,30000,1,0,30000,120000,90000
01SCS19E300376,AR.TUC-SE029,20ARSE0812,ALL,1,87750,135000,2,0,27000,1,0,27000,108000,81000
01SCS19E300377,AR.TUC-SE011,20ARSE0405,L,1,94250,145000,2,0,29000,1,0,29000,116000,87000
01SCS19E300378,BSC.AR-SD0064,00ARSD0340,M,1,125000,315000,0,0,0,0,0,63000,315000,252000
01SCS19E300379,AR.TUC-SE012,20ARSE0410,XL,1,94250,145000,2,0,29000,1,0,29000,116000,87000
01SCS19E300380,ESH.AR-SE0021,00ARSE0232,M,1,44500,135000,0,0,0,0,0,27000,135000,108000
01SCS19E300381,ESH.AR-SE0001,00ARSE0002,M,1,44000,135000,0,0,0,0,0,27000,135000,108000
01SCS19E300381,ESH.AR-SE0001,00ARSE0003,L,1,44000,135000,0,0,0,0,0,27000,135000,108000
01SCS19E300382,BSC.AR-SD0022,00ARSD0128,S,1,44000,159000,0,0,0,0,0,31800,159000,127200
01SCS19E300383,BSC.AR-SD0039,00ARSD0211,S,1,125000,315000,0,0,0,0,0,63000,315000,252000
01SCS19E300384,BSC.AR-SB0018,00ARSB0140,S,1,44500,135000,0,0,0,0,0,27000,135000,108000
01SCS19E300385,AR.CPT-SE001,20ARSE0354,L,1,94250,145000,2,0,29000,1,0,29000,116000,87000
01SCS19E300385,AR.PUB-RL020,20ARRL0199,XL,1,97500,150000,2,0,30000,1,0,30000,120000,90000
01SCS19E300386,AR.TUC-RK030,20ARRK0140,L,1,94250,145000,2,0,29000,1,0,29000,116000,87000
01SCS19E300387,AR.HMR-SD008,20ARSD0548,S,1,198250,305000,2,0,61000,1,0,61000,244000,183000
01SCS19E300387,AR.TUC-RL019,20ARRL0343,ALL,1,87750,135000,2,0,27000,1,0,27000,108000,81000
01SCS19E300388,AR.CPT-SD011,20ARSD0453,S,1,94250,145000,2,0,29000,1,0,29000,116000,87000
01SCS19E300389,AR.MKV-SE024,20ARSE0621,32,1,136500,210000,0,0,0,0,0,73500,210000,136500
01SCS19E300390,ESH.AR-SE0008,00ARSE0029,S,1,44500,135000,0,0,0,0,0,27000,135000,108000
01SCS19E300391,ESH.AR-SA0018,00ARSA0121,M,1,44000,135000,0,0,0,0,0,27000,135000,108000
01SCS19E300392,AR.TUC-SA002,20ARSA0008,XL,1,204750,315000,2,0,63000,1,0,63000,252000,189000
01SCS19E300393,ESH.AR-SD0042,00ARSD0374,S,1,125000,315000,0,0,0,0,0,63000,315000,252000
01SCS19E300393,ESH.AR-SE0016,00ARSE0109,S,1,44000,135000,0,0,0,0,0,27000,135000,108000
01SCS19E300394,AR.MKV-RJ010,20ARRJ0186,M,1,91000,140000,0,0,0,0,0,49000,140000,91000
01SCS19E300394,AR.TUC-SE015,20ARSE0420,M,1,94250,145000,2,0,29000,1,0,29000,116000,87000
01SCS19E300395,AR.SMD-PL007,20ARPL0286,L,1,84500,130000,2,0,39000,1,0,22750,91000,68250
01SCS19E300396,AR.SMD-PL002,20ARPL0266,M,1,84500,130000,2,0,39000,1,0,22750,91000,68250
01SCS19E300397,ESH.AR-SE0017,00ARSE0113,S,1,44000,135000,0,0,0,0,0,27000,135000,108000
01SCS19E300398,ESH.AR-RK0014,00ARRK0188,M,1,112500,350000,0,0,0,0,0,70000,350000,280000
01SCS19E300399,BSC.AR-SD0026,00ARSD0152,S,1,44500,159000,0,0,0,0,0,31800,159000,127200
01SCS19E300400,ESH.AR-SD0025,00ARSD0262,S,1,44000,135000,0,0,0,0,0,27000,135000,108000
01SCS19E300401,AR.ESB-SD016,20ARSD0337,M,1,91000,140000,2,0,28000,1,0,28000,112000,84000
01SCS19E300401,AR.HMR-SD007,20ARSD0545,M,1,243750,375000,2,0,75000,1,0,75000,300000,225000
01SCS19E300402,AR.TUC-SB022,20ARSB0486,ALL,1,87750,135000,2,0,27000,1,0,27000,108000,81000
01SCS19E300403,ESH.AR-SD0001,00ARSD0031,L,1,44500,135000,0,0,0,0,0,27000,135000,108000
01SCS19E300404,AR.PUB-SA003,20ARSA0234,XL,1,97500,150000,2,0,30000,1,0,30000,120000,90000
01SCS19E300405,ESH.AR-SD0032,00ARSD0303,S,1,44500,135000,0,0,0,0,0,27000,135000,108000
01SCS19E300406,AR.ESB-SD013,20ARSD0326,M,1,91000,140000,2,0,28000,1,0,28000,112000,84000
01SCS19E300407,AR.CPT-SD012,20ARSD0460,XL,1,94250,145000,2,0,29000,1,0,29000,116000,87000
01SCS19E300408,AR.PUB-SE032,20ARSE0327,L,1,204750,315000,2,0,63000,1,0,63000,252000,189000
01SCS19E300409,ESH.AR-SE0027,00ARSE0255,S,1,44500,135000,0,0,0,0,0,27000,135000,108000
01SCS19E300410,AR.TUC-SD021,20ARSD0502,M,1,94250,145000,2,0,29000,1,0,29000,116000,87000
01SCS19E300411,AR.CPT-RK007,20ARRK0024,M,1,204750,315000,2,0,63000,1,0,63000,252000,189000
01SCS19E300412,ESH.AR-SD0039,00ARSD0348,M,1,122500,350000,0,0,0,0,0,70000,350000,280000
01SCS19E300413,AR.HLW-SE019,20ARSE0567,M,1,217750,335000,2,0,67000,1,0,67000,268000,201000
01SCS19E300414,AR.TUC-SD017,20ARSD0487,L,1,94250,145000,2,0,29000,1,0,29000,116000,87000
01SCS19E300415,ESH.AR-RK0010,00ARRK0042,M,1,44500,135000,0,0,0,0,0,27000,135000,108000
01SCS19E300416,AR.CPT-SD009,20ARSD0445,S,1,94250,145000,2,0,29000,1,0,29000,116000,87000
01SCS19E300416,AR.PUB-SB034,20ARSB0465,ALL,1,81250,125000,2,0,25000,1,0,25000,100000,75000
01SCS19E300417,AR.MDG-SA003,20ARSA0289,M,1,94250,145000,2,0,43500,1,0,25375,101500,76125
01SCS19E300418,AR.MYA-RK004,20ARRK0013,L,1,220350,339000,2,0,101700,1,0,59325,237300,177975
01SCS19E300419,ESH.AR-SE0006,00ARSE0021,S,1,44000,135000,0,0,0,0,0,27000,135000,108000
01SCS19E300420,AR.STY-RK003,20ARRK0525,ALL,1,61750,95000,2,0,19000,1,0,19000,76000,57000
01SCS19E300421,BSC.AR-SD0056,00ARSD0289,S,1,125000,315000,0,0,0,0,0,63000,315000,252000
01SCS19E300422,ESH.AR-SB0003,00ARSB0008,M,1,44000,135000,0,0,0,0,0,27000,135000,108000
01SCS19E300422,ESH.AR-SB0030,00ARSB0200,S,1,44000,135000,0,0,0,0,0,27000,135000,108000
01SCS19E300423,ESH.AR-SE0003,00ARSE0009,S,1,44500,135000,0,0,0,0,0,27000,135000,108000
01SCS19E300424,ESH.AR-SC0010,00ARSC0082,L,1,44500,135000,0,0,0,0,0,27000,135000,108000
01SCS19E300425,ESH.AR-RH0015,00ARRH0088,M,1,43000,135000,0,0,0,0,0,27000,135000,108000
01SCS19E300426,AR.PUB-SB022,20ARSB0121,M,1,97500,150000,2,0,30000,1,0,30000,120000,90000
01SCS19E300427,BE.RAK-SC020,00BESC0074,L,1,201500,310000,2,0,62000,1,0,62000,248000,186000
01SCS19E300428,ESH.AR-SD0030,00ARSD0295,S,1,44500,135000,0,0,0,0,0,27000,135000,108000
01SCS19E300428,ESH.AR-SE0001,00ARSE0001,S,1,44000,135000,0,0,0,0,0,27000,135000,108000
01SCS19E300429,AR.TUC-SE029,20ARSE0812,ALL,1,87750,135000,2,0,27000,1,0,27000,108000,81000
01SCS19E300430,AR.HLW-SA015,20ARSD0246,S,1,100750,155000,2,0,46500,1,0,27125,108500,81375
01SCS19E300431,ESH.AR-SE0027,00ARSE0256,M,1,44500,135000,0,0,0,0,0,27000,135000,108000
01SCS19E300432,AR.PUB-SD032,20ARSD0240,L,1,204750,315000,2,0,63000,1,0,63000,252000,189000
01SCS19E300433,AR.BPH-RH029,20ARRH0794,M,1,220350,339000,2,0,169500,1,0,42375,169500,127125
01SCS19E300434,ESH.AR-SD0006,00ARSD0054,M,1,44500,135000,0,0,0,0,0,27000,135000,108000
01SCS19E300434,ESH.AR-SE0025,00ARSE0248,M,1,44500,135000,0,0,0,0,0,27000,135000,108000
01SCS19E300435,AR.PUB-SD005,20ARSD0091,ALL,1,97500,150000,2,0,30000,1,0,30000,120000,90000
01SCS19E300436,AR.MKV-QI016,20ARQI0243,30,1,117000,180000,2,0,90000,1,0,22500,90000,67500
01SCS19E300436,AR.YD-SB005,20ARSB0510,L,1,195000,300000,2,0,90000,1,0,52500,210000,157500
01SCS19E300437,AR.PCT-SE002,20ARSE0339,L,1,87750,135000,2,0,27000,1,0,27000,108000,81000
01SCS19E300438,AR.TUC-SD015,20ARSD0479,L,1,145000,145000,2,0,29000,1,0,29000,116000,87000
01SCS19E300439,ESH.AR-SD0038,00ARSD0343,S,1,122500,350000,0,0,0,0,0,70000,350000,280000
01SCS19E300440,BSC.AR-SE0027,00ARSE0275,S,1,52000,155000,0,0,0,0,0,31000,155000,124000
01SCS19E300441,AR.TUC-SA006,20ARSA0024,XL,1,87750,135000,2,0,27000,1,0,27000,108000,81000
01SCS19E300442,AR.MKV-SE005,20ARSE0491,32,1,165750,255000,0,0,0,0,0,89250,255000,165750
01SCS19E300443,AR.TUC-SD006,20ARSD0162,L,1,94250,145000,2,0,29000,1,0,29000,116000,87000
01SCS19E300444,AR.TUC-SD012,20ARSD0466,M,1,94250,145000,2,0,29000,1,0,29000,116000,87000
01SCS19E300444,BSC.AR-SE0013,00ARSE0175,S,1,44000,159000,0,0,0,0,0,31800,159000,127200
01SCS19E300445,AR.STY-SE007,20ARSE0125,ALL,1,55250,85000,2,0,17000,1,0,17000,68000,51000
01SCS19E300446,ESH.AR-SE0037,00ARSE0330,L,1,44000,135000,0,0,0,0,0,27000,135000,108000
01SCS19E300447,AR.PUB-SB027,20ARSB0141,M,1,97500,150000,2,0,30000,1,0,30000,120000,90000
01SCS19E300448,AR.TUC-SD008,20ARSD0168,ALL,1,81250,125000,2,0,25000,1,0,25000,100000,75000
01SCS19E300448,BSC.AR-SE0038,00ARSE0350,S,1,52000,155000,0,0,0,0,0,31000,155000,124000
01SCS19E300449,AR.TUC-SE006,20ARSE0385,L,1,204750,315000,2,0,63000,1,0,63000,252000,189000
01SCS19E300450,AR.MPR-SE025,20ARSE0220,L,1,230750,355000,2,0,71000,1,0,71000,284000,213000
01SCS19E300450,BSC.AR-SD0043,00ARSD0234,XL,1,44500,159000,0,0,0,0,0,31800,159000,127200
01SCS19E300451,BSC.AR-SE0050,00ARSE0414,S,1,52000,155000,0,0,0,0,0,31000,155000,124000
01SCS19E300452,AR.MPR-SE033,20ARSE0304,M,1,230750,355000,2,0,71000,1,0,71000,284000,213000
01SCS19E300453,AR.CPT-SE002,20ARSE0357,M,1,94250,145000,2,0,29000,1,0,29000,116000,87000
01SCS19E300453,AR.TUC-RI012,20ARRI0371,M,1,87750,135000,2,0,27000,1,0,27000,108000,81000
01SCS19E300454,AR.ESB-SD014,20ARSD0330,M,1,91000,140000,2,0,28000,1,0,28000,112000,84000
01SCS19E300455,BSC.AR-SD0039,00ARSD0212,M,1,125000,315000,0,0,0,0,0,63000,315000,252000
01SCS19E300456,AR.STY-SE013,20ARSE0579,ALL,1,55250,85000,2,0,17000,1,0,17000,68000,51000
01SCS19E300457,BSC.AR-SA0017,00ARSA0054,XL,1,125000,315000,0,0,0,0,0,63000,315000,252000
01SCS19E300458,BSC.AR-SE0005,00ARSE0073,S,1,44000,159000,0,0,0,0,0,31800,159000,127200
01SCS19E300459,BSC.AR-SE0039,00ARSE0356,L,1,52000,155000,0,0,0,0,0,31000,155000,124000
01SCS19E300460,ESH.AR-SE0005,00ARSE0019,L,1,44500,135000,0,0,0,0,0,27000,135000,108000
01SCS19E300461,BSC.AR-RL0028,00ARRL0180,L,1,44500,135000,0,0,0,0,0,27000,135000,108000
01SCS19E300462,AR.TUC-SE011,20ARSE0405,L,1,94250,145000,2,0,29000,1,0,29000,116000,87000
01SCS19E300463,ESH.AR-SD0026,00ARSD0268,L,1,44500,135000,0,0,0,0,0,27000,135000,108000
01SCS19E300463,ESH.AR-SE0009,00ARSE0033,S,1,44500,135000,0,0,0,0,0,27000,135000,108000
01SCS19E300464,AR.ESB-SA002,20ARSA0208,M,1,204750,315000,2,0,63000,1,0,63000,252000,189000
01SCS19E300465,AR.TUC-SE005,20ARSE0380,M,1,204750,315000,2,0,63000,1,0,63000,252000,189000
01SCS19E300466,AR.YD-RL015,20ARRL0039,M,1,91000,140000,2,0,70000,1,0,17500,70000,52500
01SCS19E300466,AR.YD-SD004,20ARSD0270,S,1,91000,140000,2,0,42000,1,0,24500,98000,73500
01SCS19E300467,AR.PUB-SD032,20ARSD0240,L,1,204750,315000,2,0,63000,1,0,63000,252000,189000
01SCS19E300468,AR.PCT-SE012,20ARSE0672,M,1,87750,135000,2,0,27000,1,0,27000,108000,81000
01SCS19E300469,AR.MKV-SE025,20ARSE0626,32,1,214500,330000,0,0,0,0,0,115500,330000,214500
01SCS19E300470,BSC.AR-SC0001,00ARSC0013,S,1,125000,315000,0,0,0,0,0,63000,315000,252000
01SCS19E300471,AR.STY-SE001,20ARSE0119,ALL,1,83850,129000,2,0,25800,1,0,25800,103200,77400
01SCS19E300472,ESH.AR-SE0005,00ARSE0018,M,1,44500,135000,0,0,0,0,0,27000,135000,108000
01SCS19E300473,AR.BPH-RK005,20ARRK0057,XL,1,103350,159000,2,0,47700,1,0,27825,111300,83475
01SCS19E300474,AR.TUC-SE007,20ARSE0388,M,1,204750,315000,2,0,63000,1,0,63000,252000,189000
01SCS19E300475,AR.PUB-SE026,20ARSE0100,M,1,204750,315000,2,0,63000,1,0,63000,252000,189000
01SCS19E300476,AR.PUB-SA006,20ARSA0318,M,1,97500,150000,2,0,30000,1,0,30000,120000,90000
01SCS19E300477,BSC.AR-SE0036,00ARSE0341,28,1,125000,365000,0,0,0,0,0,73000,365000,292000
01SCS19E300478,AR.HMR-SE002,20ARSE0831,M,1,90350,139000,2,0,27800,1,0,27800,111200,83400
01SCS19E300479,AR.TUC-SE020,20ARSE0641,L,1,204750,315000,2,0,63000,1,0,63000,252000,189000
01SCS19E300480,AR.TUC-SD023,20ARSD0510,M,1,204750,315000,2,0,63000,1,0,63000,252000,189000
01SCS19E300481,AR.SMD-SE008,20ARSE0465,38,1,97500,150000,2,0,30000,1,0,30000,120000,90000
01SCS19E300482,AR.MPR-SE022,20ARSE0208,L,1,243750,375000,2,0,75000,1,0,75000,300000,225000
01SCS19E300483,AR.PUB-SE026,20ARSE0101,L,1,204750,315000,2,0,63000,1,0,63000,252000,189000
01SCS19E300484,AR.MPR-SE015,20ARSE0194,M,1,256750,395000,2,0,79000,1,0,79000,316000,237000
01SCS19E300485,AR.TUC-SD024,20ARSD0514,M,1,204750,315000,2,0,63000,1,0,63000,252000,189000
01SCS19E300486,AR.ESB-SE012,20ARSE0283,M,1,198250,305000,2,0,61000,1,0,61000,244000,183000
01SCS19E300487,AR.YD-RL007,20ARRL0023,ALL,1,87750,135000,2,0,67500,1,0,16875,67500,50625
01SCS19E300487,BSC.AR-RI0030,00ARRI0139,NON,1,98000,140000,0,0,0,0,0,28000,140000,112000
01SCS19E300488,ESH.AR-SE0001,00ARSE0001,S,1,44000,135000,0,0,0,0,0,27000,135000,108000
01SCS19E300489,BSC.AR-SD0029,00ARSD0171,M,2,44500,159000,0,0,0,0,0,31800,318000,254400
01SCS19E300489,BSC.AR-SD0039,00ARSD0212,M,1,125000,315000,0,0,0,0,0,63000,315000,252000
01SCS19E300490,ESH.AR-SE0016,00ARSE0110,M,1,44000,135000,0,0,0,0,0,27000,135000,108000
01SCS19E300491,ESH.AR-SD0038,00ARSD0343,S,1,122500,350000,0,0,0,0,0,70000,350000,280000
01SCS19E300492,ESH.AR-SE0009,00ARSE0033,S,1,44500,135000,0,0,0,0,0,27000,135000,108000
01SCS19E300493,AR.SMD-RL001,20ARRL0265,ALL,1,22750,35000,2,0,7000,1,0,7000,28000,21000
01SCS19E300493,BSC.AR-SD0022,00ARSD0128,S,1,44000,159000,0,0,0,0,0,31800,159000,127200
01SCS19E300494,AR.YAS-SE011,20ARSE0739,L,1,122850,189000,2,0,37800,1,0,37800,151200,113400
01SCS19E300495,AR.CPT-RI008,20ARRI0069,M,1,94250,145000,2,0,29000,1,0,29000,116000,87000
01SCS19E300496,BSC.AR-SD0006,00ARSD0022,M,1,44000,159000,0,0,0,0,0,31800,159000,127200
01SCS19E300497,ESH.AR-SE0003,00ARSE0010,M,1,44500,135000,0,0,0,0,0,27000,135000,108000
01SCS19E300498,ESH.AR-SC0007,00ARSC0062,L,1,125000,350000,0,0,0,0,0,70000,350000,280000
01SCS19E300499,AR.CPT-SC009,20ARSC0274,L,1,94250,145000,2,0,29000,1,0,29000,116000,87000
01SCS19E300499,ESH.AR-SD0025,00ARSD0263,M,1,44000,135000,0,0,0,0,0,27000,135000,108000
01SCS19E300500,ESH.AR-SD0026,00ARSD0268,L,1,44500,135000,0,0,0,0,0,27000,135000,108000
01SCS19E300501,BSC.AR-SE0039,00ARSE0354,S,1,52000,155000,0,0,0,0,0,31000,155000,124000
01SCS19E300502,BSC.AR-SA0023,00ARSA0114,NON,1,47500,140000,0,0,0,0,0,28000,140000,112000
01SCS19E300503,AR.TUC-SE020,20ARSE0641,L,1,204750,315000,2,0,63000,1,0,63000,252000,189000
01SCS19E300504,ESH.AR-SD0018,00ARSD0138,L,1,125000,315000,0,0,0,0,0,63000,315000,252000
01SCS19E300505,BSC.AR-SD0039,00ARSD0212,M,1,125000,315000,0,0,0,0,0,63000,315000,252000
01SCS19E300505,ESH.AR-SA0017,00ARSA0117,M,1,122500,350000,0,0,0,0,0,70000,350000,280000
01SCS19E300505,ESH.AR-SD0043,00ARSD0396,L,1,125000,315000,0,0,0,0,0,63000,315000,252000
01SCS19E300506,ESH.AR-SB0015,00ARSB0062,S,1,125000,315000,0,0,0,0,0,63000,315000,252000
01SCS19E300507,ESH.AR-SC0027,00ARSC0263,L,1,125000,315000,0,0,0,0,0,63000,315000,252000
01SCS19E300508,AR.PUB-SA007,20ARSA0323,L,1,97500,150000,2,0,30000,1,0,30000,120000,90000
01SCS19E300509,BSC.AR-RL0026,00ARRL0172,L,1,94500,135000,0,0,0,0,0,27000,135000,108000
01SCS19E300510,AR.CPT-RK004,20ARRK0020,ALL,1,77350,119000,2,0,23800,1,0,23800,95200,71400
01SCS19E300511,ESH.AR-SE0037,00ARSE0328,S,1,44000,135000,0,0,0,0,0,27000,135000,108000
01SCS19E300512,ESH.AR-SB0032,00ARSB0210,L,1,125000,315000,0,0,0,0,0,63000,315000,252000
01SCS19E300513,AR.MPR-SE024,20ARSE0217,XL,1,230750,355000,2,0,71000,1,0,71000,284000,213000
01SCS19E300514,ESH.AR-SA0018,00ARSA0121,M,1,44000,135000,0,0,0,0,0,27000,135000,108000
01SCS19E300515,ESH.AR-SE0016,00ARSE0111,L,1,44000,135000,0,0,0,0,0,27000,135000,108000
01SCS19E300516,AR.SMD-RH005,20ARRH0745,XL,1,211250,325000,2,0,97500,1,0,56875,227500,170625
01SCS19E300517,BSC.AR-SE0036,00ARSE0341,28,1,125000,365000,0,0,0,0,0,73000,365000,292000
01SCS19E300518,ESH.AR-SB0011,00ARSB0052,M,1,125000,315000,0,0,0,0,0,63000,315000,252000
01SCS19E300519,ESH.AR-SC0011,00ARSC0086,L,1,44000,135000,0,0,0,0,0,27000,135000,108000
01SCS19E300519,ESH.AR-SD0032,00ARSD0305,L,1,44500,135000,0,0,0,0,0,27000,135000,108000
01SCS19E300520,BNV.AR-RI0003,00ARRI0164,32,1,625000,625000,0,0,0,0,0,93750,625000,531250
01SCS19E300521,BSC.AR-SE0037,00ARSE0349,XL,1,44000,159000,0,0,0,0,0,31800,159000,127200
01SCS19E300522,AR.ESB-SE006,20ARSE0259,M,1,94250,145000,2,0,29000,1,0,29000,116000,87000
01SCS19E300522,BE.RAK-SC010,00BESC0026,XL,1,91000,140000,2,0,28000,1,0,28000,112000,84000
01SCS19E300523,AR.TUC-SD008,20ARSD0168,ALL,1,81250,125000,2,0,25000,1,0,25000,100000,75000
01SCS19E300524,AR.TUC-SD012,20ARSD0466,M,1,94250,145000,2,0,29000,1,0,29000,116000,87000
01SCS19E300524,AR.TUC-SE006,20ARSE0385,L,1,204750,315000,2,0,63000,1,0,63000,252000,189000
01SCS19E300525,AR.TUC-SE020,20ARSE0641,L,1,204750,315000,2,0,63000,1,0,63000,252000,189000
01SCS19E300526,AR.TUC-SD011,20ARSD0461,S,1,94250,145000,2,0,29000,1,0,29000,116000,87000
01SCS19E300526,AR.TUC-SD012,20ARSD0466,M,1,94250,145000,2,0,29000,1,0,29000,116000,87000
01SCS19E300527,BSC.AR-SC0008,00ARSC0051,NON,1,73000,220000,0,0,0,0,0,44000,220000,176000
01SCS19E300528,BSC.AR-SE0013,00ARSE0176,M,1,44000,159000,0,0,0,0,0,31800,159000,127200
01SCS19E300529,BSC.AR-SC0042,00ARSC0278,L,1,135000,375000,0,0,0,0,0,75000,375000,300000
01SCS19E300530,AR.PUB-SE008,20ARSE0031,L,1,97500,150000,2,0,30000,1,0,30000,120000,90000
01SCS19E300531,AR.MKV-SE023,20ARSE0618,ALL,1,42250,65000,0,0,0,0,0,22750,65000,42250
01SCS19E300532,AR.CPT-SE005,20ARSE0368,S,1,204750,315000,2,0,63000,1,0,63000,252000,189000
01SCS19E300532,AR.HMR-SE002,20ARSE0830,S,1,90350,139000,2,0,27800,1,0,27800,111200,83400
01SCS19E300532,AR.MPR-SE025,20ARSE0220,L,1,230750,355000,2,0,71000,1,0,71000,284000,213000
01SCS19E300532,AR.TUC-RJ004,20ARRJ0108,ALL,1,22750,35000,2,0,7000,1,0,7000,28000,21000
01SCS19E300532,ESH.AR-SE0017,00ARSE0113,S,1,44000,135000,0,0,0,0,0,27000,135000,108000
01SCS19E300533,AR.CPT-SC009,20ARSC0274,L,1,94250,145000,2,0,29000,1,0,29000,116000,87000
01SCS19E300533,AR.TUC-SB019,20ARSB0482,L,1,87750,135000,2,0,27000,1,0,27000,108000,81000
01SCS19E300534,BSC.AR-SD0027,00ARSD0156,S,1,125000,315000,0,0,0,0,0,63000,315000,252000
01SCS19E300535,AR.CPT-SC008,20ARSC0269,M,1,94250,145000,2,0,29000,1,0,29000,116000,87000
01SCS19E300535,AR.TUC-SE011,20ARSE0406,XL,1,94250,145000,2,0,29000,1,0,29000,116000,87000
01SCS19E300535,AR.TUC-SE028,20ARSE0811,ALL,1,87750,135000,2,0,27000,1,0,27000,108000,81000
01SCS19E300536,AR.MPR-SE010,20ARSE0174,M,1,97500,150000,2,0,45000,1,0,26250,105000,78750
01SCS19E300537,AR.TUC-SD021,20ARSD0502,M,1,94250,145000,2,0,29000,1,0,29000,116000,87000
01SCS19E300538,AR.VCS-RI005,20ARRI0287,M,1,243750,375000,2,0,112500,1,0,65625,262500,196875
01SCS19E300539,BE.RAK-SC017,00BESC0061,XL,1,201500,310000,2,0,62000,1,0,62000,248000,186000
01SCS19E300540,ESH.AR-SC0023,00ARSC0165,S,1,125000,315000,0,0,0,0,0,63000,315000,252000
01SCS19E300540,ESH.AR-SE0039,00ARSE0363,M,1,44000,135000,0,0,0,0,0,27000,135000,108000
01SCS19E300541,ESH.AR-SD0027,00ARSD0271,M,1,44000,135000,0,0,0,0,0,27000,135000,108000
01SCS19E300542,AR.ESB-RL010,20ARRL0461,ALL,1,91000,140000,2,0,70000,1,0,17500,70000,52500
01SCS19E300542,ESH.AR-SE0038,00ARSE0333,M,1,44500,135000,0,0,0,0,0,27000,135000,108000
01SCS19E300543,AR.CPT-SD012,20ARSD0458,M,1,94250,145000,2,0,29000,1,0,29000,116000,87000
01SCS19E300544,BSC.AR-SD0002,00ARSD0006,M,1,44000,159000,0,0,0,0,0,31800,159000,127200
01SCS19E300545,AR.PUB-SE021,20ARSE0081,L,1,159250,245000,2,0,49000,1,0,49000,196000,147000
01SCS19E300546,AR.CPT-SE002,20ARSE0358,L,1,94250,145000,2,0,29000,1,0,29000,116000,87000
01SCS19E300546,AR.PUB-SC015,20ARSC0362,L,1,97500,150000,2,0,30000,1,0,30000,120000,90000
01SCS19E300546,BSC.AR-SD0052,00ARSD0279,S,1,44500,159000,0,0,0,0,0,31800,159000,127200
01SCS19E300547,AR.PCT-SE017,20ARSE0683,L,1,87750,135000,2,0,27000,1,0,27000,108000,81000
01SCS19E300547,ESH.AR-RK0011,00ARRK0046,M,1,44500,135000,0,0,0,0,0,27000,135000,108000
01SCS19E300548,AR.HMR-SE001,20ARSE0826,S,1,90350,139000,2,0,27800,1,0,27800,111200,83400
01SCS19E300548,BSC.AR-SE0040,00ARSE0358,S,1,44500,159000,0,0,0,0,0,31800,159000,127200
01SCS19E300548,ESH.AR-SE0038,00ARSE0332,S,1,44500,135000,0,0,0,0,0,27000,135000,108000
01SCS19E300549,AR.MPR-SE034,20ARSE0308,M,1,237250,365000,2,0,73000,1,0,73000,292000,219000
01SCS19E300549,ESH.AR-SE0006,00ARSE0022,M,1,44000,135000,0,0,0,0,0,27000,135000,108000
01SCS19E300550,ESH.AR-SD0026,00ARSD0268,L,1,44500,135000,0,0,0,0,0,27000,135000,108000
01SCS19E300551,ESH.AR-SE0039,00ARSE0363,M,1,44000,135000,0,0,0,0,0,27000,135000,108000
01SCS19E300552,AR.PUB-SB036,20ARSB0467,ALL,1,81250,125000,2,0,25000,1,0,25000,100000,75000
01SCS19E300553,AR.ESB-QF011,20ARQF0037,L,1,97500,150000,2,0,75000,1,0,18750,75000,56250
01SCS19E300554,AR.TUC-SA040,20ARSA0272,ALL,1,87750,135000,2,0,27000,1,0,27000,108000,81000
01SCS19E300554,ESH.AR-SD0016,00ARSD0095,M,1,106400,350000,0,0,0,0,0,70000,350000,280000
01SCS19E300554,ESH.AR-SE0009,00ARSE0033,S,1,44500,135000,0,0,0,0,0,27000,135000,108000
01SCS19E300555,AR.TUC-SD021,20ARSD0502,M,1,94250,145000,2,0,29000,1,0,29000,116000,87000
01SCS19E300556,BSC.AR-SD0039,00ARSD0211,S,1,125000,315000,0,0,0,0,0,63000,315000,252000
01SCS19E300556,BSC.AR-SE0050,00ARSE0414,S,1,52000,155000,0,0,0,0,0,31000,155000,124000
01SCS19E300557,BE.RAK-SD016,00BESD0079,XL,1,91000,140000,2,0,28000,1,0,28000,112000,84000
01SCS19E300557,ESH.AR-SC0008,00ARSC0070,L,1,44500,135000,0,0,0,0,0,27000,135000,108000
01SCS19E300558,AR.TUC-SE029,20ARSE0812,ALL,1,87750,135000,2,0,27000,1,0,27000,108000,81000
01SCS19E300559,BSC.AR-SC0030,00ARSC0204,M,1,44000,135000,0,0,0,0,0,27000,135000,108000
01SCS19E300560,AR.PUB-SE031,20ARSE0323,M,1,204750,315000,2,0,63000,1,0,63000,252000,189000
01SCS19E300561,BSC.AR-SD0044,00ARSD0236,M,1,44500,159000,0,0,0,0,0,31800,159000,127200
01SCS19E300562,AR.PUB-SB033,20ARSB0464,ALL,1,97500,150000,2,0,30000,1,0,30000,120000,90000
01SCS19E300563,AR.SMD-QD013,20ARQD0191,M,1,84500,130000,2,0,39000,1,0,22750,91000,68250
01SCS19E300564,BSC.AR-SB0015,00ARSB0130,XL,1,125000,315000,0,0,0,0,0,63000,315000,252000
01SCS19E300565,AR.PUB-SE026,20ARSE0100,M,1,204750,315000,2,0,63000,1,0,63000,252000,189000
01SCS19E300566,AR.ESB-SE020,20ARSE0797,S,1,97500,150000,2,0,30000,1,0,30000,120000,90000
01SCS19E300567,AR.PCT-SE007,20ARSE0348,M,1,87750,135000,2,0,27000,1,0,27000,108000,81000
01SCS19E300568,AR.PUB-SE007,20ARSE0026,M,1,97500,150000,2,0,30000,1,0,30000,120000,90000
01SCS19E300569,BSC.AR-SE0049,00ARSE0410,S,1,52000,155000,0,0,0,0,0,31000,155000,124000
01SCS19E300570,ESH.AR-SE0017,00ARSE0114,M,1,44000,135000,0,0,0,0,0,27000,135000,108000
01SCS19E300571,AR.BPH-RB012,20ARRB0470,M,1,103350,159000,2,0,47700,1,0,27825,111300,83475
01SCS19E300572,AR.HMR-SE017,20ARSE0890,30,1,211250,325000,2,0,65000,1,0,65000,260000,195000
01SCS19E300573,AR.CPT-SC002,20ARSC0246,32,1,227500,350000,2,0,70000,1,0,70000,280000,210000
01SCS19E300574,ESH.AR-SE0027,00ARSE0256,M,1,44500,135000,0,0,0,0,0,27000,135000,108000
01SCS19E300575,ESH.AR-SD0018,00ARSD0137,M,1,125000,315000,0,0,0,0,0,63000,315000,252000
01SCS19E300576,AR.MER-SB004,20ARSB0223,M,1,97500,150000,2,0,45000,1,0,26250,105000,78750
01SCS19E300577,AR.STY-RJ004,20ARRJ0053,ALL,1,55250,85000,2,0,17000,1,0,17000,68000,51000
01SCS19E300577,AR.STY-SE001,20ARSE0119,ALL,1,83850,129000,2,0,25800,1,0,25800,103200,77400
01SCS19E300578,BSC.AR-SE0037,00ARSE0347,M,1,44000,159000,0,0,0,0,0,31800,159000,127200
01SCS19E300578,BSC.AR-SE0046,00ARSE0398,S,1,44500,159000,0,0,0,0,0,31800,159000,127200
01SCS19E300578,ESH.AR-SA0005,00ARSA0067,S,1,44000,135000,0,0,0,0,0,27000,135000,108000
01SCS19E300579,AR.YD-SB005,20ARSB0508,S,1,195000,300000,2,0,90000,1,0,52500,210000,157500
01SCS19E300579,ESH.AR-SE0038,00ARSE0332,S,1,44500,135000,0,0,0,0,0,27000,135000,108000
01SCS19E300580,ESH.AR-SE0026,00ARSE0254,XL,1,44000,135000,0,0,0,0,0,27000,135000,108000
01SCS19E300581,ESH.AR-SE0039,00ARSE0363,M,1,44000,135000,0,0,0,0,0,27000,135000,108000
01SCS19E300582,ESH.AR-SE0036,00ARSE0325,M,1,44500,135000,0,0,0,0,0,27000,135000,108000
01SCS19E300583,BSC.AR-SD0016,00ARSD0118,S,1,122000,375000,0,0,0,0,0,75000,375000,300000
01SCS19E300584,ESH.AR-SB0027,00ARSB0160,M,1,44000,135000,0,0,0,0,0,27000,135000,108000
01SCS19E300584,ESH.AR-SE0028,00ARSE0261,L,1,44000,135000,0,0,0,0,0,27000,135000,108000
01SCS19E300585,AR.HLW-SE022,20ARSE0575,L,1,100750,155000,2,0,31000,1,0,31000,124000,93000
01SCS19E300585,AR.PUB-SB023,20ARSB0126,L,1,97500,150000,2,0,30000,1,0,30000,120000,90000
01SCS19E300586,AR.HMR-SE017,20ARSE0889,28,1,211250,325000,2,0,65000,1,0,65000,260000,195000
01SCS19E300586,AR.MKV-SE025,20ARSE0625,30,1,214500,330000,0,0,0,0,0,115500,330000,214500
01SCS19E300587,AR.HMR-SE010,20ARSE0862,S,1,90350,139000,2,0,27800,1,0,27800,111200,83400
01SCS19E300588,AR.MDS-RL003,20ARRL0362,S,1,117000,180000,2,0,36000,1,0,36000,144000,108000
01SCS19E300589,ESH.AR-SE0010,00ARSE0037,S,1,44000,135000,0,0,0,0,0,27000,135000,108000
01SCS19E300589,ESH.AR-SE0021,00ARSE0231,S,1,44500,135000,0,0,0,0,0,27000,135000,108000
01SCS19E300590,AR.TUC-SE007,20ARSE0388,M,1,204750,315000,2,0,63000,1,0,63000,252000,189000
01SCS19E300591,ESH.AR-SD0024,00ARSD0260,L,1,44500,135000,0,0,0,0,0,27000,135000,108000
01SCS19E300591,ESH.AR-SE0038,00ARSE0333,M,1,44500,135000,0,0,0,0,0,27000,135000,108000
01SCS19E300592,AR.HMR-SD007,20ARSD0546,L,1,243750,375000,2,0,75000,1,0,75000,300000,225000
01SCS19E300593,ESH.AR-SD0018,00ARSD0137,M,1,125000,315000,0,0,0,0,0,63000,315000,252000
01SCS19E300594,ESH.AR-SE0021,00ARSE0231,S,1,44500,135000,0,0,0,0,0,27000,135000,108000
01SCS19E300595,BSC.AR-SC0016,00ARSC0112,S,1,44500,135000,0,0,0,0,0,27000,135000,108000
01SCS19E300595,BSC.AR-SD0013,00ARSD0106,S,1,44500,159000,0,0,0,0,0,31800,159000,127200
01SCS19E300595,ESH.AR-SD0027,00ARSD0270,S,1,44000,135000,0,0,0,0,0,27000,135000,108000
01SCS19E300596,ESH.AR-SE0021,00ARSE0232,M,1,44500,135000,0,0,0,0,0,27000,135000,108000
01SCS19E300597,AR.YAS-RL007,20ARRL0226,S,1,252850,389000,2,0,77800,1,0,77800,311200,233400
01SCS19E300598,BE.RAK-SC036,00BESC0154,L,1,91000,140000,2,0,28000,1,0,28000,112000,84000
01SCS19E300599,AR.REC-SD026,20ARSD0073,ALL,1,117000,180000,2,0,54000,1,0,31500,126000,94500
01SCS19E300600,AR.STY-SE009,20ARSE0127,ALL,1,55250,85000,2,0,17000,1,0,17000,68000,51000
01SCS19E300601,ESH.AR-RH0020,00ARRH0109,L,1,94500,135000,0,0,0,0,0,27000,135000,108000
01SCS19E300602,AR.MPR-SE024,20ARSE0215,M,1,230750,355000,2,0,71000,1,0,71000,284000,213000
01SCS19E300603,AR.TUC-SD011,20ARSD0463,L,1,94250,145000,2,0,29000,1,0,29000,116000,87000
01SCS19E300604,AR.MKV-RJ001,20ARRJ0141,M,1,91000,140000,0,0,0,0,0,49000,140000,91000
01SCS19E300605,BSC.AR-SD0015,00ARSD0114,S,1,122000,375000,0,0,0,0,0,75000,375000,300000
01SCS19E300605,BSC.AR-SD0016,00ARSD0118,S,1,122000,375000,0,0,0,0,0,75000,375000,300000
01SCS19E300605,ESH.AR-SD0018,00ARSD0137,M,1,125000,315000,0,0,0,0,0,63000,315000,252000
01SCS19E300606,AR.PUB-SB023,20ARSB0126,L,1,97500,150000,2,0,30000,1,0,30000,120000,90000
01SCS19E300606,AR.TUC-SE028,20ARSE0811,ALL,1,87750,135000,2,0,27000,1,0,27000,108000,81000
01SCS19E300607,AR.HMR-SE010,20ARSE0863,M,1,90350,139000,2,0,27800,1,0,27800,111200,83400
01SCS19E300607,AR.TUC-SD006,20ARSD0161,M,1,94250,145000,2,0,29000,1,0,29000,116000,87000
01SCS19E300608,AR.GTW-SA003,20ARSA0305,L,1,94250,145000,2,0,43500,1,0,25375,101500,76125
01SCS19E300608,AR.TUC-SD021,20ARSD0502,M,1,94250,145000,2,0,29000,1,0,29000,116000,87000
01SCS19E300609,AR.PUB-SD021,20ARSD0190,ALL,1,97500,150000,2,0,30000,1,0,30000,120000,90000
01SCS19E300610,BSC.AR-SE0001,00ARSE0059,L,1,44500,159000,0,0,0,0,0,31800,159000,127200
01SCS19E300611,AR.PCT-SE017,20ARSE0683,L,1,87750,135000,2,0,27000,1,0,27000,108000,81000
01SCS19E300611,AR.PUB-SE007,20ARSE0026,M,1,97500,150000,2,0,30000,1,0,30000,120000,90000
01SCS19E300611,AR.SMD-QD012,20ARQD0185,M,1,84500,130000,2,0,39000,1,0,22750,91000,68250
01SCS19E300612,AR.HMR-SE018,20ARSE0895,30,1,204750,315000,2,0,63000,1,0,63000,252000,189000
01SCS19E300613,ESH.AR-SE0038,00ARSE0332,S,1,44500,135000,0,0,0,0,0,27000,135000,108000
01SCS19E300614,BSC.AR-SD0022,00ARSD0128,S,1,44000,159000,0,0,0,0,0,31800,159000,127200
01SCS19E300615,AR.TUC-SD008,20ARSD0168,ALL,1,81250,125000,2,0,25000,1,0,25000,100000,75000
01SCS19E300616,AR.CPT-SC010,20ARSC0473,L,1,204750,315000,2,0,63000,1,0,63000,252000,189000
01SCS19E300617,ARN.AR-RK0003,00ARRK0227,M,1,120000,315000,0,0,0,0,0,94500,315000,220500
01SCS19E300617,ESH.AR-SC0021,00ARSC0158,M,1,44000,135000,0,0,0,0,0,27000,135000,108000
01SCS19E300618,AR.PUB-SC012,20ARSC0301,M,1,113750,175000,2,0,35000,1,0,35000,140000,105000
01SCS19E300618,BSC.AR-SA0023,00ARSA0114,NON,1,47500,140000,0,0,0,0,0,28000,140000,112000
01SCS19E300619,BSC.AR-RL0026,00ARRL0172,L,1,94500,135000,0,0,0,0,0,27000,135000,108000
01SCS19E300620,ESH.AR-SD0018,00ARSD0137,M,1,125000,315000,0,0,0,0,0,63000,315000,252000
01SCS19E300621,AR.PUB-SE007,20ARSE0026,M,1,97500,150000,2,0,30000,1,0,30000,120000,90000
01SCS19E300622,ESH.AR-SE0005,00ARSE0019,L,1,44500,135000,0,0,0,0,0,27000,135000,108000
01SCS19E300623,ESH.AR-SE0003,00ARSE0010,M,1,44500,135000,0,0,0,0,0,27000,135000,108000
01SCS19E300624,BSC.AR-RK0005,00ARRK0067,L,1,108500,155000,0,0,0,0,0,31000,155000,124000
01SCS19E300625,BSC.AR-RH0011,00ARRH0055,NON,1,46500,140000,0,0,0,0,0,28000,140000,112000
01SCS19E300625,ESH.AR-SA0018,00ARSA0122,L,1,44000,135000,0,0,0,0,0,27000,135000,108000
01SCS19E300626,BSC.AR-SD0039,00ARSD0211,S,1,125000,315000,0,0,0,0,0,63000,315000,252000
01SCS19E300627,AR.HLW-SE019,20ARSE0568,L,1,217750,335000,2,0,67000,1,0,67000,268000,201000
01SCS19E300628,BSC.AR-SE0046,00ARSE0399,M,1,44500,159000,0,0,0,0,0,31800,159000,127200
01SCS19E300629,ESH.AR-SC0019,00ARSC0151,L,1,125000,315000,0,0,0,0,0,63000,315000,252000
01SCS19E300630,ESH.AR-SD0019,00ARSD0143,XL,1,125000,315000,0,0,0,0,0,63000,315000,252000
01SCS19E300631,AR.ESB-SE003,20ARSE0247,M,1,204750,315000,2,0,63000,1,0,63000,252000,189000
01SCS19E300631,AR.MPR-SE009,20ARSE0169,S,1,97500,150000,2,0,45000,1,0,26250,105000,78750
01SCS19E300632,ESH.AR-SE0007,00ARSE0025,S,1,44500,135000,0,0,0,0,0,27000,135000,108000
01SCS19E300633,ESH.AR-SE0026,00ARSE0252,M,1,44000,135000,0,0,0,0,0,27000,135000,108000
01SCS19E300634,ESH.AR-SC0027,00ARSC0263,L,1,125000,315000,0,0,0,0,0,63000,315000,252000
01SCS19E300635,ESH.AR-RH0001,00ARRH0002,M,1,131000,395000,0,0,0,0,0,79000,395000,316000
01SCS19E300635,ESH.AR-SD0006,00ARSD0053,S,1,44500,135000,0,0,0,0,0,27000,135000,108000
01SCS19E300636,AR.TUC-SD011,20ARSD0462,M,1,94250,145000,2,0,29000,1,0,29000,116000,87000
01SCS19E300637,BSC.AR-SD0004,00ARSD0014,M,1,44000,159000,0,0,0,0,0,31800,159000,127200
01SCS19E300637,BSC.AR-SE0027,00ARSE0276,M,1,52000,155000,0,0,0,0,0,31000,155000,124000
01SCS19E300638,AR.ESB-RK002,20ARRK0228,M,1,198250,305000,2,0,61000,1,0,61000,244000,183000
01SCS19E300639,BSC.AR-SD0002,00ARSD0007,L,1,44000,159000,0,0,0,0,0,31800,159000,127200
01SCS19E300640,BSC.AR-SD0052,00ARSD0280,M,1,44500,159000,0,0,0,0,0,31800,159000,127200
01SCS19E300641,AR.BPH-RD009,20ARRD0337,S,1,182000,280000,2,0,140000,1,0,35000,140000,105000
01SCS19E300642,AR.HMR-SE010,20ARSE0863,M,1,90350,139000,2,0,27800,1,0,27800,111200,83400
01SCS19E300643,AR.HMR-SD008,20ARSD0549,M,1,198250,305000,2,0,61000,1,0,61000,244000,183000
01SCS19E300644,BSC.AR-SE0031,00ARSE0293,L,1,52000,155000,0,0,0,0,0,31000,155000,124000
01SCS19E300644,ESH.AR-RK0014,00ARRK0189,L,1,245000,350000,0,0,0,0,0,70000,350000,280000
01SCS19E300645,AR.TUC-SD024,20ARSD0514,M,1,204750,315000,2,0,63000,1,0,63000,252000,189000
01SCS19E300646,AR.TUC-SD004,20ARSD0154,L,1,204750,315000,2,0,63000,1,0,63000,252000,189000
01SCS19E300647,AR.TUC-SA040,20ARSA0272,ALL,1,87750,135000,2,0,27000,1,0,27000,108000,81000
01SCS19E300647,ESH.AR-SE0027,00ARSE0256,M,1,44500,135000,0,0,0,0,0,27000,135000,108000
01SCS19E300648,ESH.AR-SE0029,00ARSE0264,M,1,44500,135000,0,0,0,0,0,27000,135000,108000
01SCS19E300649,ESH.AR-SE0030,00ARSE0269,L,1,125000,315000,0,0,0,0,0,63000,315000,252000
01SCS19E300650,BSC.AR-SD0052,00ARSD0279,S,1,44500,159000,0,0,0,0,0,31800,159000,127200
01SCS19E300651,BSC.AR-SC0022,00ARSC0169,S,1,44500,135000,0,0,0,0,0,27000,135000,108000
01SCS19E300652,AR.HMR-SE017,20ARSE0889,28,1,211250,325000,2,0,65000,1,0,65000,260000,195000
01SCS19E300653,AR.MKV-SB008,20ARSB0332,M,1,292500,450000,0,0,0,0,0,157500,450000,292500
01SCS19E300654,AR.MKV-SE009,20ARSE0509,28,1,227500,350000,0,0,0,0,0,122500,350000,227500
01SCS19E300654,AR.TUC-SE019,20ARSE0638,XL,1,204750,315000,2,0,63000,1,0,63000,252000,189000
01SCS19E300654,BSC.AR-RI0030,00ARRI0139,NON,1,98000,140000,0,0,0,0,0,28000,140000,112000
01SCS19E300654,ESH.AR-SE0038,00ARSE0332,S,1,44500,135000,0,0,0,0,0,27000,135000,108000
01SCS19E300655,ESH.AR-SA0015,00ARSA0111,L,1,122500,350000,0,0,0,0,0,70000,350000,280000
01SCS19E300656,AR.MPR-SE015,20ARSE0194,M,1,256750,395000,2,0,79000,1,0,79000,316000,237000
01SCS19E300657,AR.MKV-SE020,20ARSE0608,S,1,97500,150000,0,0,0,0,0,52500,150000,97500
01SCS19E300657,AR.PUB-RJ022,20ARRJ0254,ALL,1,97500,150000,2,0,30000,1,0,30000,120000,90000
01SCS19E300658,AR.MPR-SE022,20ARSE0208,L,1,243750,375000,2,0,75000,1,0,75000,300000,225000
01SCS19E300659,AR.PUB-SD010,20ARSD0120,ALL,1,97500,150000,2,0,30000,1,0,30000,120000,90000
01SCS19E300659,BSC.AR-SD0028,00ARSD0162,L,1,125000,315000,0,0,0,0,0,63000,315000,252000
01SCS19E300660,AR.ESB-SE009,20ARSE0270,S,1,91000,140000,2,0,28000,1,0,28000,112000,84000
01SCS19E300660,AR.MPR-SE009,20ARSE0169,S,1,97500,150000,2,0,45000,1,0,26250,105000,78750
01SCS19E300661,BSC.AR-RL0022,00ARRL0141,S,1,94500,135000,0,0,0,0,0,27000,135000,108000
01SCS19E300662,BSC.AR-SE0013,00ARSE0175,S,1,44000,159000,0,0,0,0,0,31800,159000,127200
01SCS19E300662,ESH.AR-RL0016,00ARRL0133,S,1,94500,135000,0,0,0,0,0,27000,135000,108000
01SCS19E300663,AR.ESB-SE003,20ARSE0247,M 1,204750,315000,2,0,63000,1,0,63000,252000,189000
01SCS19E300663,AR.MPR-SE024,20ARSE0215,M,1,230750,355000,2,0,71000,1,0,71000,284000,213000
01SCS19E300664,ESH.AR-SC0024,00ARSC0212,M,1,119000,350000,0,0,0,0,0,70000,350000,280000
01SCS19E300665,AR.CPT-RH007,20ARRH0065,ALL,1,94250,145000,2,0,29000,1,0,29000,116000,87000
01SCS19E300665,ESH.AR-SE0016,00ARSE0111,L,1,44000,135000,0,0,0,0,0,27000,135000,108000
01SCS19E300666,AR.PUB-SD017,20ARSD0134,M,1,204750,315000,2,0,63000,1,0,63000,252000,189000
01SCS19E300667,BSC.AR-SD0004,00ARSD0014,M,1,44000,159000,0,0,0,0,0,31800,159000,127200
01SCS19E310001,BSC.AR-SD0052,00ARSD0279,S,1,44500,159000,0,0,0,0,0,31800,159000,127200
01SCS19E310002,BSC.AR-SE0033,00ARSE0316,30,1,125400,365000,0,0,0,0,0,73000,365000,292000
01SCS19E310003,ESH.AR-SE0026,00ARSE0251,S,1,44000,135000,0,0,0,0,0,27000,135000,108000
01SCS19E310004,AR.TUC-SE015,20ARSE0421,L,1,94250,145000,2,0,29000,1,0,29000,116000,87000
01SCS19E310004,BSC.AR-SE0005,00ARSE0073,S,1,44000,159000,0,0,0,0,0,31800,159000,127200
01SCS19E310005,BE.RAK-SA025,00BESA0104,XL,1,104000,160000,2,0,32000,1,0,32000,128000,96000
01SCS19E310006,ESH.AR-SA0012,00ARSA0094,M,1,44000,135000,0,0,0,0,0,27000,135000,108000
01SCS19E310007,ESH.AR-SE0010,00ARSE0039,L,1,44000,135000,0,0,0,0,0,27000,135000,108000
01SCS19E310008,ESH.AR-SD0031,00ARSD0302,XL,1,44000,135000,0,0,0,0,0,27000,135000,108000
01SCS19E310009,AR.TUC-SD014,20ARSD0475,L,1,94250,145000,2,0,29000,1,0,29000,116000,87000
01SCS19E310009,ESH.AR-SE0033,00ARSE0305,L,1,52000,155000,0,0,0,0,0,31000,155000,124000
01SCS19E310010,AR.TUC-SD009,20ARSD0169,ALL,1,81250,125000,2,0,25000,1,0,25000,100000,75000
01SCS19E310010,BSC.AR-SE0031,00ARSE0293,L,1,52000,155000,0,0,0,0,0,31000,155000,124000
01SCS19E310010,ESH.AR-SD0007,00ARSD0060,XL,1,44500,135000,0,0,0,0,0,27000,135000,108000
01SCS19E310010,ESH.AR-SE0006,00ARSE0024,XL,1,44000,135000,0,0,0,0,0,27000,135000,108000
01SCS19E310011,AR.HMR-SE018,20ARSE0894,28,1,204750,315000,2,0,63000,1,0,63000,252000,189000
01SCS19E310011,ESH.AR-SE0018,00ARSE0117,S,1,44500,135000,0,0,0,0,0,27000,135000,108000
01SCS19E310012,AR.ASH-RB001,20ARRB0689,M,1,100750,155000,2,0,77500,1,0,19375,77500,58125
01SCS19E310013,AR.TUC-SC005,20ARSC0063,34,1,185250,285000,2,0,57000,1,0,57000,228000,171000
01SCS19E310013,ESH.AR-SD0021,00ARSD0166,L,1,125000,315000,0,0,0,0,0,63000,315000,252000
01SCS19E310014,ESH.AR-SE0031,00ARSE0272,M,1,125000,315000,0,0,0,0,0,63000,315000,252000
01SCS19E310015,AR.PUB-RL016,20ARRL0163,ALL,1,97500,150000,2,0,30000,1,0,30000,120000,90000
01SCS19E310016,BSC.AR-SE0050,00ARSE0414,S,1,52000,155000,0,0,0,0,0,31000,155000,124000
01SCS19E310017,ARN.AR-RK0003,00ARRK0226,S,1,120000,315000,0,0,0,0,0,94500,315000,220500
01SCS19E310018,ESH.AR-SC0006,00ARSC0047,M,1,125000,350000,0,0,0,0,0,70000,350000,280000
01SCS19E310019,BSC.AR-SE0027,00ARSE0276,M,1,52000,155000,0,0,0,0,0,31000,155000,124000
01SCS19E310020,AR.CPT-RK007,20ARRK0024,M,1,204750,315000,2,0,63000,1,0,63000,252000,189000
01SCS19E310021,ESH.AR-SE0038,00ARSE0332,S,1,44500,135000,0,0,0,0,0,27000,135000,108000
01SCS19E310022,AR.BPH-SA005,20ARSA0250,ALL,1,103350,159000,2,0,47700,1,0,27825,111300,83475
01SCS19E310022,BSC.AR-SD0013,00ARSD0106,S,1,44500,159000,0,0,0,0,0,31800,159000,127200
01SCS19E310023,ESH.AR-RK0013,00ARRK0129,S,1,44500,135000,0,0,0,0,0,27000,135000,108000
01SCS19E310024,BSC.AR-SD0061,00ARSD0336,NON,1,45000,150000,0,0,0,0,0,30000,150000,120000
01SCS19E310025,AR.ESB-SE002,20ARSE0242,S,1,204750,315000,2,0,63000,1,0,63000,252000,189000
01SCS19E310026,ESH.AR-SD0018,00ARSD0136,S,1,125000,315000,0,0,0,0,0,63000,315000,252000
01SCS19E310027,AR.BPH-RB012,20ARRB0470,M,1,103350,159000,2,0,47700,1,0,27825,111300,83475
01SCS19E310028,BSC.AR-SD0019,00ARSD0124,NON,1,45000,150000,0,0,0,0,0,30000,150000,120000
01SCS19E310029,AR.MPR-SE031,20ARSE0298,XL,1,230750,355000,2,0,71000,1,0,71000,284000,213000
01SCS19E310029,BSC.AR-SD0055,00ARSD0288,NON,1,50000,150000,0,0,0,0,0,30000,150000,120000
01SCS19E310029,ESH.AR-SA0018,00ARSA0121,M,1,44000,135000,0,0,0,0,0,27000,135000,108000
01SCS19E310029,ESH.AR-SD0021,00ARSD0166,L,1,125000,315000,0,0,0,0,0,63000,315000,252000
01SCS19E310030,ESH.AR-SE0037,00ARSE0329,M,1,44000,135000,0,0,0,0,0,27000,135000,108000
01SCS19E310031,ESH.AR-SD0014,00ARSD0086,32,1,145000,375000,0,0,0,0,0,75000,375000,300000
01SCS19E310032,BSC.AR-SC0035,00ARSC0234,L,1,125000,315000,0,0,0,0,0,63000,315000,252000
01SCS19E310032,BSC.AR-SD0012,00ARSD0105,NON,1,18000,75000,0,0,0,0,0,15000,75000,60000
01SCS19E310032,BSC.AR-SE0027,00ARSE0276,M,1,52000,155000,0,0,0,0,0,31000,155000,124000
01SCS19E310033,AR.YAS-RL002,20ARRL0211,S,1,317850,489000,2,0,97800,1,0,97800,391200,293400
01SCS19E310034,BSC.AR-SD0039,00ARSD0212,M,1,125000,315000,0,0,0,0,0,63000,315000,252000
01SCS19E310035,ESH.AR-SD0026,00ARSD0269,XL,1,44500,135000,0,0,0,0,0,27000,135000,108000
01SCS19E310036,AR.TUC-SA033,20ARSA0265,ALL,1,87750,135000,2,0,27000,1,0,27000,108000,81000
01SCS19E310037,AR.PUB-SE031,20ARSE0323,M,1,204750,315000,2,0,63000,1,0,63000,252000,189000
01SCS19E310038,AR.MKV-RJ029,20ARRJ0445,XL,1,165750,255000,0,0,0,0,0,89250,255000,165750
01SCS19E310038,AR.MPR-SE009,20ARSE0172,XL,1,97500,150000,2,0,45000,1,0,26250,105000,78750
01SCS19E310038,BSC.AR-SE0046,00ARSE0401,XL,1,44500,159000,0,0,0,0,0,31800,159000,127200
01SCS19E310039,AR.HMR-SE002,20ARSE0833,XL,1,90350,139000,2,0,27800,1,0,27800,111200,83400
01SCS19E310039,AR.SMD-RH007,20ARRH0753,XL,1,87750,135000,2,0,40500,1,0,23625,94500,70875
01SCS19E310040,ESH.AR-SB0006,00ARSB0024,M,1,44500,135000,0,0,0,0,0,27000,135000,108000
01SCS19E310041,AR.SMD-SB001,20ARSB0192,M,1,211250,325000,2,0,65000,1,0,65000,260000,195000
01SCS19E310041,BSC.AR-SB0014,00ARSB0111,M,1,44000,135000,0,0,0,0,0,27000,135000,108000
01SCS19E310042,AR.ESB-RK002,20ARRK0228,M,1,198250,305000,2,0,61000,1,0,61000,244000,183000
01SCS19E310043,BSC.AR-SD0002,00ARSD0005,S,1,44000,159000,0,0,0,0,0,31800,159000,127200
01SCS19E310043,ESH.AR-SA0001,00ARSA0015,32,1,122500,175000,0,0,0,0,0,35000,175000,140000
01SCS19E310044,AR.FHL-SC005,20ARSC0343,M,1,110500,170000,2,0,34000,1,0,34000,136000,102000
01SCS19E310044,AR.SMD-QD005,20ARQD0099,S,1,84500,130000,2,0,39000,1,0,22750,91000,68250
01SCS19E310044,BSC.AR-SB0007,00ARSB0076,L,1,44500,135000,0,0,0,0,0,27000,135000,108000
01SCS19E310045,ESH.AR-SE0009,00ARSE0033,S,1,44500,135000,0,0,0,0,0,27000,135000,108000
01SCS19E310045,ESH.AR-SE0026,00ARSE0251,S,1,44000,135000,0,0,0,0,0,27000,135000,108000
01SCS19E310046,AR.SMD-SD005,20ARSD0292,S,1,87750,135000,2,0,27000,1,0,27000,108000,81000
01SCS19E310047,AR.HMR-SE001,20ARSE0828,L,1,90350,139000,2,0,27800,1,0,27800,111200,83400
01SCS19E310048,AR.ESB-SC016,20ARSC0457,M,1,91000,140000,2,0,28000,1,0,28000,112000,84000
01SCS19E310048,AR.STY-SE004,20ARSE0122,ALL,1,55250,85000,2,0,17000,1,0,17000,68000,51000
01SCS19E310049,ESH.AR-SD0031,00ARSD0299,S,1,44000,135000,0,0,0,0,0,27000,135000,108000
01SCS19E310049,ESH.AR-SE0028,00ARSE0259,S,1,44000,135000,0,0,0,0,0,27000,135000,108000
01SCS19E310050,BSC.AR-SC0022,00ARSC0169,S,1,44500,135000,0,0,0,0,0,27000,135000,108000
01SCS19E310050,BSC.AR-SD0022,00ARSD0128,S,1,44000,159000,0,0,0,0,0,31800,159000,127200
01SCS19E310051,AR.PCT-SE018,20ARSE0685,L,1,87750,135000,2,0,27000,1,0,27000,108000,81000
01SCS19E310052,AR.ESB-SD011,20ARSD0318,S,1,91000,140000,2,0,28000,1,0,28000,112000,84000
01SCS19E310052,BSC.AR-SE0005,00ARSE0073,S,1,44000,159000,0,0,0,0,0,31800,159000,127200
01SCS19E310053,ESH.AR-SB0015,00ARSB0063,M,1,125000,315000,0,0,0,0,0,63000,315000,252000
01SCS19E310054,BSC.AR-RK0005,00ARRK0067,L,1,108500,155000,0,0,0,0,0,31000,155000,124000
01SCS19E310055,AR.ESB-SE012,20ARSE0284,L,1,198250,305000,2,0,61000,1,0,61000,244000,183000
01SCS19E310056,ESH.AR-SB0032,00ARSB0210,L,1,125000,315000,0,0,0,0,0,63000,315000,252000
01SCS19E310057,AR.BPH-RD008,20ARRH0371,S,1,182000,280000,2,0,140000,1,0,35000,140000,105000
01SCS19E310058,BSC.AR-RH0024,00ARRH0156,M,1,245000,350000,0,0,0,0,0,70000,350000,280000
01SCS19E310059,BSC.AR-SE0006,00ARSE0077,S,1,44500,159000,0,0,0,0,0,31800,159000,127200
01SCS19E310059,BSC.AR-SE0036,00ARSE0341,28,1,125000,365000,0,0,0,0,0,73000,365000,292000
01SCS19E310060,AR.CPT-RK007,20ARRK0024,M,1,204750,315000,2,0,63000,1,0,63000,252000,189000
01SCS19E310061,BSC.AR-SE0050,00ARSE0414,S,1,52000,155000,0,0,0,0,0,31000,155000,124000
01SCS19E310061,ESH.AR-SE0017,00ARSE0113,S,1,44000,135000,0,0,0,0,0,27000,135000,108000
01SCS19E310062,AR.STY-SE011,20ARSE0577,ALL,1,55250,85000,2,0,17000,1,0,17000,68000,51000
01SCS19E310063,BSC.AR-SD0030,00ARSD0175,M,1,44500,159000,0,0,0,0,0,31800,159000,127200
01SCS19E310064,BSC.AR-RH0011,00ARRH0055,NON,1,46500,140000,0,0,0,0,0,28000,140000,112000
01SCS19E310065,ESH.AR-SC0032,00ARSC0282,L,1,44500,135000,0,0,0,0,0,27000,135000,108000
01SCS19E310066,AR.MPR-SE001,20ARSE0140,XL,1,97500,150000,2,0,45000,1,0,26250,105000,78750
01SCS19E310066,AR.YAS-SE011,20ARSE0740,XL,1,122850,189000,2,0,37800,1,0,37800,151200,113400
01SCS19E310066,BSC.AR-SB0011,00ARSB0097,M,1,44500,135000,0,0,0,0,0,27000,135000,108000
01SCS19E310067,ESH.AR-RL0017,00ARRL0137,S,1,94500,135000,0,0,0,0,0,27000,135000,108000
01SCS19E310067,ESH.AR-SE0005,00ARSE0018,M,1,44500,135000,0,0,0,0,0,27000,135000,108000
01SCS19E310068,ESH.AR-SE0027,00ARSE0257,L,1,44500,135000,0,0,0,0,0,27000,135000,108000
01SCS19E310069,ESH.AR-SE0008,00ARSE0031,L,1,44500,135000,0,0,0,0,0,27000,135000,108000
01SCS19E310070,AR.PUB-RG026,20ARRG0133,XL,1,97500,150000,2,0,30000,1,0,30000,120000,90000
01SCS19E310071,AR.YAS-SE002,20ARSE0709,M,1,317850,489000,2,0,97800,1,0,97800,391200,293400
01SCS19E310072,AR.ESB-SB001,20ARSB0022,L,1,204750,315000,2,0,63000,1,0,63000,252000,189000
01SCS19E310073,BSC.AR-SD0022,00ARSD0130,L,1,44000,159000,0,0,0,0,0,31800,159000,127200
01SCS19E310074,ESH.AR-SE0017,00ARSE0114,M,1,44000,135000,0,0,0,0,0,27000,135000,108000
01SCS19E310075,ESH.AR-SB0007,00ARSB0029,L,1,44000,135000,0,0,0,0,0,27000,135000,108000
01SCS19E310076,AR.PUB-RI024,20ARRI0308,L,1,97500,150000,2,0,30000,1,0,30000,120000,90000
01SCS19E310076,AR.SMD-QD014,20ARQD0194,M,1,84500,130000,2,0,39000,1,0,22750,91000,68250
01SCS19E310076,BSC.AR-SD0027,00ARSD0157,M,1,125000,315000,0,0,0,0,0,63000,315000,252000
01SCS19E310076,ESH.AR-SE0004,00ARSE0014,M,1,44500,135000,0,0,0,0,0,27000,135000,108000
01SCS19E310077,BSC.AR-SD0003,00ARSD0010,M,1,44000,159000,0,0,0,0,0,31800,159000,127200
01SCS19E310078,AR.TUC-SD011,20ARSD0462,M,1,94250,145000,2,0,29000,1,0,29000,116000,87000
01SCS19E310079,AR.STY-SE004,20ARSE0122,ALL,1,55250,85000,2,0,17000,1,0,17000,68000,51000
01SCS19E310080,ESH.AR-RL0016,00ARRL0133,S,1,94500,135000,0,0,0,0,0,27000,135000,108000
01SCS19E310081,AR.CPT-SE003,20ARSE0362,L,1,94250,145000,2,0,29000,1,0,29000,116000,87000
01SCS19E310081,AR.TUC-SD017,20ARSD0487,L,1,94250,145000,2,0,29000,1,0,29000,116000,87000
01SCS19E310082,DKS.AR-SE0005,00ARSE0145,36,1,417272,696000,0,0,0,0,0,104400,696000,591600
01SCS19E310083,ESH.AR-SB0030,00ARSB0200,S,1,44000,135000,0,0,0,0,0,27000,135000,108000
01SCS19E310084,ESH.AR-SE0028,00ARSE0260,M,1,44000,135000,0,0,0,0,0,27000,135000,108000
01SCS19E310085,ESH.AR-SC0027,00ARSC0263,L,1,125000,315000,0,0,0,0,0,63000,315000,252000
01SCS19E310086,AR.HMR-SE017,20ARSE0889,28,1,211250,325000,2,0,65000,1,0,65000,260000,195000
01SCS19E310087,AR.HMR-SE017,20ARSE0890,30,1,211250,325000,2,0,65000,1,0,65000,260000,195000
01SCS19E310088,AR.CPT-SE003,20ARSE0362,L,1,94250,145000,2,0,29000,1,0,29000,116000,87000
01SCS19E310088,AR.TUC-SD011,20ARSD0463,L,1,94250,145000,2,0,29000,1,0,29000,116000,87000
01SCS19E310089,AR.PCT-SE019,20ARSE0687,L,1,87750,135000,2,0,27000,1,0,27000,108000,81000
01SCS19E310089,BE.RAK-RK013,00BERK0041,M,1,256750,395000,2,0,79000,1,0,79000,316000,237000
01SCS19E310090,AR.CLK-RH001,20ARRH0736,ALL,1,91000,140000,2,0,28000,1,0,28000,112000,84000
01SCS19E310090,AR.ESB-SE012,20ARSE0283,M,1,198250,305000,2,0,61000,1,0,61000,244000,183000
01SCS19E310091,ESH.AR-SC0010,00ARSC0082,L,1,44500,135000,0,0,0,0,0,27000,135000,108000
01SCS19E310092,BSC.AR-SD0039,00ARSD0211,S,1,125000,315000,0,0,0,0,0,63000,315000,252000
01SCS19E310093,ESH.AR-RK0020,00ARRK0201,L,1,192500,275000,0,0,0,0,0,55000,275000,220000
01SCS19E310094,AR.PUB-SD020,20ARSD0189,ALL,1,97500,150000,2,0,30000,1,0,30000,120000,90000
01SCS19E310095,BSC.AR-RH0024,00ARRH0156,M,1,245000,350000,0,0,0,0,0,70000,350000,280000
01SCS19E310096,BSC.AR-SD0003,00ARSD0010,M,1,44000,159000,0,0,0,0,0,31800,159000,127200
01SCS19E310097,AR.CLK-SA003,20ARSA0052,ALL,1,91000,140000,2,0,28000,1,0,28000,112000,84000
01SCS19E310098,AR.SMD-QH001,20ARQH0423,L,1,87750,135000,2,0,40500,1,0,23625,94500,70875
01SCS19E310099,AR.GTW-SC002,20ARSC0025,S,1,97500,150000,2,0,45000,1,0,26250,105000,78750
01SCS19E310099,BSC.AR-SB0005,00ARSB0061,NON,1,47500,140000,0,0,0,0,0,28000,140000,112000
01SCS19E310099,ESH.AR-RH0015,00ARRH0087,S,1,43000,135000,0,0,0,0,0,27000,135000,108000
01SCS19E310100,AR.PUB-SD025,20ARSD0199,L,1,97500,150000,2,0,30000,1,0,30000,120000,90000
01SCS19E310100,ESH.AR-SB0003,00ARSB0009,L,1,44000,135000,0,0,0,0,0,27000,135000,108000
01SCS19E310100,ESH.AR-SE0021,00ARSE0234,XL,1,44500,135000,0,0,0,0,0,27000,135000,108000
01SCS19E310101,AR.TUC-SA033,20ARSA0265,ALL,1,87750,135000,2,0,27000,1,0,27000,108000,81000
01SCS19E310101,BSC.AR-SA0004,00ARSA0018,S,1,125000,315000,0,0,0,0,0,63000,315000,252000
01SCS19E310102,AR.PCT-SE014,20ARSE0677,L,1,87750,135000,2,0,27000,1,0,27000,108000,81000
01SCS19E310102,AR.PCT-SE016,20ARSE0681,L,1,87750,135000,2,0,27000,1,0,27000,108000,81000
01SCS19E310102,ESH.AR-SC0008,00ARSC0071,XL,1,44500,135000,0,0,0,0,0,27000,135000,108000
01SCS19E310103,AR.STY-RJ004,20ARRJ0053,ALL,1,55250,85000,2,0,17000,1,0,17000,68000,51000
01SCS19E310104,ESH.AR-SD0017,00ARSD0127,NON,1,50000,150000,0,0,0,0,0,30000,150000,120000
01SCS19E310105,AR.BPH-SD002,20ARSD0363,L,1,182000,280000,2,0,140000,1,0,35000,140000,105000
01SCS19E310106,AR.HMR-SE008,20ARSE0856,L,1,90350,139000,2,0,27800,1,0,27800,111200,83400
01SCS19E310106,AR.HMR-SE017,20ARSE0889,28,1,211250,325000,2,0,65000,1,0,65000,260000,195000
01SCS19E310107,BSC.AR-SE0036,00ARSE0343,32,1,125000,365000,0,0,0,0,0,73000,365000,292000
01SCS19E310108,AR.CPT-SC001,20ARSC0243,ALL,1,97500,150000,2,0,30000,1,0,30000,120000,90000
01SCS19E310109,AR.MER-SB001,20ARSB0213,L,1,97500,150000,2,0,45000,1,0,26250,105000,78750
01SCS19E310110,AR.GTW-SA003,20ARSA0304,M,1,94250,145000,2,0,43500,1,0,25375,101500,76125
01SCS19E310111,AR.HLW-SE003,20ARSE0529,M,1,100750,155000,2,0,31000,1,0,31000,124000,93000
01SCS19E310112,AR.TUC-SD021,20ARSD0502,M,1,94250,145000,2,0,29000,1,0,29000,116000,87000
01SCS19E310113,AR.PUB-RK005,20ARRK0376,ALL,1,97500,150000,2,0,30000,1,0,30000,120000,90000
01SCS19E310114,AR.STY-RK003,20ARRK0525,ALL,1,61750,95000,2,0,19000,1,0,19000,76000,57000
01SCS19E310114,ESH.AR-SA0007,00ARSA0076,M,1,44000,135000,0,0,0,0,0,27000,135000,108000
01SCS19E310114,ESH.AR-SE0037,00ARSE0329,M,1,44000,135000,0,0,0,0,0,27000,135000,108000
01SCS19E310115,ESH.AR-SE0006,00ARSE0021,S,1,44000,135000,0,0,0,0,0,27000,135000,108000
01SCS19E310115,ESH.AR-SE0039,00ARSE0364,L,1,44000,135000,0,0,0,0,0,27000,135000,108000
01SCS19E310116,BSC.AR-SD0016,00ARSD0119,M,1,122000,375000,0,0,0,0,0,75000,375000,300000
01SCS19E310117,AR.PCT-SE018,20ARSE0685,L,1,87750,135000,2,0,27000,1,0,27000,108000,81000
01SCS19E310118,AR.STY-SA006,20ARSA0065,ALL,1,61750,95000,2,0,19000,1,0,19000,76000,57000
01SCS19E310119,AR.STY-SE001,20ARSE0119,ALL,1,83850,129000,2,0,25800,1,0,25800,103200,77400
01SCS19E310120,AR.PUB-SE036,20ARSE0804,S,1,159250,245000,0,0,0,0,0,85750,245000,159250
01SCS19E310121,BSC.AR-SD0018,00ARSD0123,NON,1,45000,150000,0,0,0,0,0,30000,150000,120000
01SCS19E310122,AR.HMR-SE001,20ARSE0827,M,1,90350,139000,2,0,27800,1,0,27800,111200,83400
01SCS19E310123,ESH.AR-SE0031,00ARSE0271,S,1,125000,315000,0,0,0,0,0,63000,315000,252000
01SCS19E310124,ESH.AR-SC0028,00ARSC0268,XL,1,44500,135000,0,0,0,0,0,27000,135000,108000
01SCS19E310125,BSC.AR-SB0011,00ARSB0099,XL,1,44500,135000,0,0,0,0,0,27000,135000,108000
01SCS19E310126,AR.MPR-SE024,20ARSE0216,L,1,230750,355000,2,0,71000,1,0,71000,284000,213000
01SCS19E310126,BSC.AR-SC0011,00ARSC0065,M,1,44000,159000,0,0,0,0,0,31800,159000,127200
01SCS19E310126,ESH.AR-SC0016,00ARSC0137,M,1,44000,135000,0,0,0,0,0,27000,135000,108000
01SCS19E310127,AR.SLS-SE021,20ARSE0666,L,1,680000,800000,0,0,0,0,0,120000,800000,680000
01SCS19E310128,AR.PCT-SE016,20ARSE0680,M,1,87750,135000,2,0,27000,1,0,27000,108000,81000
01SCS19E310128,ESH.AR-RL0016,00ARRL0134,M,1,94500,135000,0,0,0,0,0,27000,135000,108000
01SCS19E310128,ESH.AR-SC0020,00ARSC0154,M,1,44000,135000,0,0,0,0,0,27000,135000,108000
01SCS19E310129,AR.MKV-RC024,20ARRC0596,ALL,1,78000,120000,0,0,0,0,0,42000,120000,78000
01SCS19E310129,BE.RAK-SA023,00BESA0094,XL,1,91000,140000,2,0,28000,1,0,28000,112000,84000
01SCS19E310130,AR.YD-SB006,20ARSB0515,XL,1,195000,300000,2,0,150000,1,0,37500,150000,112500
01SCS19E310130,BSC.AR-SE0037,00ARSE0349,XL,1,44000,159000,0,0,0,0,0,31800,159000,127200
01SCS19E310130,BSC.AR-SE0050,00ARSE0417,XL,1,52000,155000,0,0,0,0,0,31000,155000,124000
01SCS19E310130,ESH.AR-SE0017,00ARSE0116,XL,1,44000,135000,0,0,0,0,0,27000,135000,108000
01SCS19E310131,ESH.AR-SB0007,00ARSB0029,L,1,44000,135000,0,0,0,0,0,27000,135000,108000
01SCS19E310132,AR.SMD-SD003,20ARSD0286,L,1,97500,150000,2,0,45000,1,0,26250,105000,78750
01SCS19E310133,AR.MYA-SC002,20ARSC0042,L,1,220350,339000,2,0,101700,1,0,59325,237300,177975
01SCS19E310133,BSC.AR-SE0014,00ARSE0180,M,1,44000,159000,0,0,0,0,0,31800,159000,127200
01SCS19E310133,ESH.AR-SB0027,00ARSB0160,M,1,44000,135000,0,0,0,0,0,27000,135000,108000
01SCS19E310134,BSC.AR-SD0047,00ARSD0247,NON,1,68000,220000,0,0,0,0,0,44000,220000,176000
01SCS19E310135,BSC.AR-SD0039,00ARSD0212,M,1,125000,315000,0,0,0,0,0,63000,315000,252000
01SCS19E310136,ESH.AR-SC0007,00ARSC0062,L,1,125000,350000,0,0,0,0,0,70000,350000,280000
01SCS19E310137,AR.HMR-SE018,20ARSE0894,28,1,204750,315000,2,0,63000,1,0,63000,252000,189000
01SCS19E310138,AR.CPT-SC011,20ARSC0478,XL,1,204750,315000,2,0,63000,1,0,63000,252000,189000
01SCS19E310139,BSC.AR-SD0004,00ARSD0015,L,1,44000,159000,0,0,0,0,0,31800,159000,127200
01SCS19E310140,BSC.AR-SC0014,00ARSC0098,L,1,44000,159000,0,0,0,0,0,31800,159000,127200
01SCS19E310141,AR.PUB-SE007,20ARSE0028,XL,1,97500,150000,2,0,30000,1,0,30000,120000,90000
01SCS19E310142,ESH.AR-SC0001,00ARSC0001,S,1,125000,315000,0,0,0,0,0,63000,315000,252000
01SCS19E310143,AR.PCT-SE002,20ARSE0339,L,1,87750,135000,2,0,27000,1,0,27000,108000,81000
01SCS19E310144,ESH.AR-SE0038,00ARSE0333,M,1,44500,135000,0,0,0,0,0,27000,135000,108000
01SCS19E310145,ESH.AR-SB0022,00ARSB0124,M,1,44000,135000,0,0,0,0,0,27000,135000,108000
01SCS19E310146,BSC.AR-SE0028,00ARSE0280,M,1,130000,375000,0,0,0,0,0,75000,375000,300000
01SCS19E310147,AR.MKV-QH003,20ARQH0199,L,1,156000,240000,2,0,120000,1,0,30000,120000,90000
01SCS19E310147,AR.TRF-RJ007,20ARRJ0080,M,1,97500,150000,2,0,45000,1,0,26250,105000,78750
01SCS19E310147,ESH.AR-SE0016,00ARSE0112,XL,1,44000,135000,0,0,0,0,0,27000,135000,108000
01SCS19E310148,BSC.AR-SD0033,00ARSD0187,S,1,44500,159000,0,0,0,0,0,31800,159000,127200
01SCS19E310149,BSC.AR-SA0019,00ARSA0064,M,1,44000,135000,0,0,0,0,0,27000,135000,108000
01SCS19E310149,BSC.AR-SD0057,00ARSD0293,NON,1,45000,140000,0,0,0,0,0,28000,140000,112000
01SCS19E310149,BSC.AR-SE0019,00ARSE0199,S,1,44000,159000,0,0,0,0,0,31800,159000,127200
01SCS19E310150,AR.ESB-SE017,20ARSE0787,L,1,104000,160000,2,0,32000,1,0,32000,128000,96000
01SCS19E310150,AR.ESB-SE017,20ARSE0788,XL,1,104000,160000,2,0,32000,1,0,32000,128000,96000
01SCS19E310151,AR.CPT-SC004,20ARSC0254,L,1,304850,469000,2,0,93800,1,0,93800,375200,281400
01SCS19E310151,AR.PUB-SE008,20ARSE0031,L,1,97500,150000,2,0,30000,1,0,30000,120000,90000
01SCS19E310151,BSC.AR-SE0048,00ARSE0407,M,1,44000,159000,0,0,0,0,0,31800,159000,127200
01SCS19E310152,AR.MPR-SE017,20ARSE0201,ALL,1,97500,150000,2,0,45000,1,0,26250,105000,78750
01SCS19E310153,AR.PUB-SD017,20ARSD0134,M,1,204750,315000,2,0,63000,1,0,63000,252000,189000
01SCS19E310154,AR.STY-SE013,20ARSE0579,ALL,1,55250,85000,2,0,17000,1,0,17000,68000,51000
01SCS19E310154,BSC.AR-SC0036,00ARSC0240,28,1,135000,375000,0,0,0,0,0,75000,375000,300000
01SCS19E310155,BSC.AR-SD0022,00ARSD0128,S,1,44000,159000,0,0,0,0,0,31800,159000,127200
01SCS19E310156,AR.PCT-SE015,20ARSE0678,M,1,87750,135000,2,0,27000,1,0,27000,108000,81000
01SCS19E310157,BSC.AR-SD0058,00ARSD0294,NON,1,50000,150000,0,0,0,0,0,30000,150000,120000
01SCS19E310158,BSC.AR-SB0017,00ARSB0138,L,1,44000,135000,0,0,0,0,0,27000,135000,108000
01SCS19E310159,BSC.AR-RI0025,00ARRI0134,NON,1,98000,140000,0,0,0,0,0,28000,140000,112000
01SCS19E310159,ESH.AR-SD0043,00ARSD0395,M,1,125000,315000,0,0,0,0,0,63000,315000,252000
01SCS19E310160,BE.RAK-SC027,00BESC0108,L,1,201500,310000,2,0,62000,1,0,62000,248000,186000
01SCS19E310161,AR.HMR-SD008,20ARSD0549,M,1,198250,305000,2,0,61000,1,0,61000,244000,183000
01SCS19E310161,AR.HMR-SE017,20ARSE0890,30,1,211250,325000,2,0,65000,1,0,65000,260000,195000
01SCS19E310161,BSC.AR-SD0006,00ARSD0022,M,1,44000,159000,0,0,0,0,0,31800,159000,127200
01SCS19E310162,AR.MKV-SE002,20ARSE0478,36,1,214500,330000,0,0,0,0,0,115500,330000,214500
01SCS19E310163,ESH.AR-SB0030,00ARSB0200,S,1,44000,135000,0,0,0,0,0,27000,135000,108000
01SCS19E310164,AR.MKV-SE011,20ARSE0523,36,1,227500,350000,0,0,0,0,0,122500,350000,227500
01SCS19E310165,AR.TUC-SE018,20ARSE0430,ALL,1,87750,135000,2,0,27000,1,0,27000,108000,81000
01SCS19E310166,ESH.AR-SE0009,00ARSE0034,M,1,44500,135000,0,0,0,0,0,27000,135000,108000
01SCS19E310167,ESH.AR-SD0038,00ARSD0346,XL,1,122500,350000,0,0,0,0,0,70000,350000,280000
01SCS19E310168,AR.PUB-SD020,20ARSD0189,ALL,1,97500,150000,2,0,30000,1,0,30000,120000,90000
01SCS19E310169,ESH.AR-SE0026,00ARSE0252,M,1,44000,135000,0,0,0,0,0,27000,135000,108000
01SCS19E310170,ESH.AR-RD0012,00ARRD0175,NON,1,52500,75000,0,0,0,0,0,15000,75000,60000
01SCS19E310171,ESH.AR-SE0009,00ARSE0034,M,1,44500,135000,0,0,0,0,0,27000,135000,108000
01SCS19E310172,AR.ESB-SE021,20ARSE0800,ALL,1,87750,135000,2,0,27000,1,0,27000,108000,81000
01SCS19E310172,BE.RAK-RL019,00BERL0057,M,1,211250,325000,2,0,65000,1,0,65000,260000,195000
01SCS19E310172,ESH.AR-SE0033,00ARSE0303,S,1,52000,155000,0,0,0,0,0,31000,155000,124000
01SCS19E310173,ESH.AR-SD0045,00ARSD0404,S,1,125000,315000,0,0,0,0,0,63000,315000,252000
01SCS19E310174,AR.TUC-SB019,20ARSB0482,L,1,87750,135000,2,0,27000,1,0,27000,108000,81000
01SCS19E310174,BSC.AR-SE0015,00ARSE0183,S,1,44000,159000,0,0,0,0,0,31800,159000,127200
01SCS19E310175,ESH.AR-SD0028,00ARSD0275,M,1,44500,135000,0,0,0,0,0,27000,135000,108000
01SCS19E310176,AR.TUC-SD006,20ARSD0161,M,1,94250,145000,2,0,29000,1,0,29000,116000,87000
01SCS19E310177,BSC.AR-SC0001,00ARSC0014,M,1,125000,315000,0,0,0,0,0,63000,315000,252000
01SCS19E310178,AR.CPT-SC001,20ARSC0243,ALL,1,97500,150000,2,0,30000,1,0,30000,120000,90000
01SCS19E310179,BSC.AR-SE0029,00ARSE0283,S,1,125000,315000,0,0,0,0,0,63000,315000,252000
01SCS19E310180,BSC.AR-SE0027,00ARSE0277,L,1,52000,155000,0,0,0,0,0,31000,155000,124000
01SCS19E310181,ESH.AR-RL0016,00ARRL0135,L,1,94500,135000,0,0,0,0,0,27000,135000,108000
01SCS19E310182,BSC.AR-SD0052,00ARSD0279,S,1,44500,159000,0,0,0,0,0,31800,159000,127200
01SCS19E310183,ESH.AR-SE0008,00ARSE0032,XL,1,44500,135000,0,0,0,0,0,27000,135000,108000
01SCS19E310184,AR.ESB-RK010,20ARRK0366,M,1,87750,135000,2,0,27000,1,0,27000,108000,81000
01SCS19E310184,AR.TUC-RK035,20ARRK0157,L,1,94250,145000,2,0,29000,1,0,29000,116000,87000
01SCS19E310184,AR.TUC-SD017,20ARSD0487,L,1,94250,145000,2,0,29000,1,0,29000,116000,87000
01SCS19E310185,AR.STY-SE009,20ARSE0127,ALL,1,55250,85000,2,0,17000,1,0,17000,68000,51000
01SCS19E310185,AR.STY-SE011,20ARSE0577,ALL,1,55250,85000,2,0,17000,1,0,17000,68000,51000
01SCS19E310186,BSC.AR-SB0006,00ARSB0073,XL,1,44000,135000,0,0,0,0,0,27000,135000,108000
01SCS19E310187,AR.PUB-SD025,20ARSD0200,XL,1,97500,150000,2,0,30000,1,0,30000,120000,90000
01SCS19E310188,ESH.AR-SC0032,00ARSC0282,L,1,44500,135000,0,0,0,0,0,27000,135000,108000
01SCS19E310188,ESH.AR-SE0037,00ARSE0330,L,1,44000,135000,0,0,0,0,0,27000,135000,108000
01SCS19E310189,AR.ESB-SD010,20ARSD0184,M,1,91000,140000,2,0,28000,1,0,28000,112000,84000
01SCS19E310189,ESH.AR-RI0016,00ARRI0144,NON,1,65000,185000,0,0,0,0,0,37000,185000,148000
01SCS19E310190,BSC.AR-SD0002,00ARSD0005,S,2,44000,159000,0,0,0,0,0,31800,318000,254400
01SCS19E310191,AR.MPR-SE024,20ARSE0216,L,1,230750,355000,2,0,71000,1,0,71000,284000,213000
01SCS19E310192,ESH.AR-SE0039,00ARSE0364,L,1,44000,135000,0,0,0,0,0,27000,135000,108000
01SCS19E310193,AR.PUB-SE007,20ARSE0027,L,1,97500,150000,2,0,30000,1,0,30000,120000,90000
01SCS19E310194,AR.MKV-SE013,20ARSE0584,M,1,22750,350000,0,0,0,0,0,122500,350000,227500
01SCS19E310195,BSC.AR-SE0008,00ARSE0085,S,1,44000,159000,0,0,0,0,0,31800,159000,127200
01SCS19E310196,AR.CLB-RC006,20ARRC0200,ALL,1,191750,295000,2,0,59000,1,0,59000,236000,177000
01SCS19E310197,ESH.AR-SC0029,00ARSC0269,NON,1,90000,250000,0,0,0,0,0,50000,250000,200000
01SCS19E310198,BSC.AR-SA0022,00ARSA0113,NON,1,47500,140000,0,0,0,0,0,28000,140000,112000
01SCS19E310199,AR.SMD-SE007,20ARSE0462,40,1,97500,150000,2,0,30000,1,0,30000,120000,90000
01SCS19E310200,BSC.AR-SE0038,00ARSE0350,S,1,52000,155000,0,0,0,0,0,31000,155000,124000
01SCS19E310200,ESH.AR-SE0016,00ARSE0111,L,1,44000,135000,0,0,0,0,0,27000,135000,108000
01SCS19E310201,AR.HLW-SE013,20ARSE0560,L,1,100750,155000,2,0,31000,1,0,31000,124000,93000
01SCS19E310201,ESH.AR-SE0027,00ARSE0257,L,1,44500,135000,0,0,0,0,0,27000,135000,108000
01SCS19E310202,AR.TUC-SA040,20ARSA0272,ALL,1,87750,135000,2,0,27000,1,0,27000,108000,81000
01SCS19E310203,AR.KNR-RK008,20ARRK0279,L,1,152750,235000,2,0,70500,1,0,41125,164500,123375
01SCS19E310204,BSC.AR-SD0038,00ARSD0207,S,1,125000,315000,0,0,0,0,0,63000,315000,252000
01SCS19E310205,AR.MKV-RJ029,20ARRJ0445,XL,1,165750,255000,0,0,0,0,0,89250,255000,165750
01SCS19E310206,AR.PCT-SE002,20ARSE0339,L,1,87750,135000,2,0,27000,1,0,27000,108000,81000
01SCS19E310207,AR.VCS-RI005,20ARRI0289,XL,1,243750,375000,2,0,112500,1,0,65625,262500,196875
01SCS19E310208,AR.CLB-SE004,20ARSE0700,ALL,1,185250,285000,2,0,57000,1,0,57000,228000,171000
01SCS19E310209,AR.TUC-SD024,20ARSD0514,M,1,204750,315000,2,0,63000,1,0,63000,252000,189000
01SCS19E310210,ESH.AR-SD0040,00ARSD0368,L,1,122500,350000,0,0,0,0,0,70000,350000,280000
01SCS19E310211,ESH.AR-SE0011,00ARSE0041,S,1,44500,135000,0,0,0,0,0,27000,135000,108000
01SCS19E310212,AR.HLW-SE016,20ARSE0563,ALL,1,87750,135000,2,0,27000,1,0,27000,108000,81000
01SCS19E310213,BSC.AR-SB0015,00ARSB0128,M,1,125000,315000,0,0,0,0,0,63000,315000,252000
01SCS19E310213,BSC.AR-SC0025,00ARSC0183,L,1,125000,315000,0,0,0,0,0,63000,315000,252000
01SCS19E310213,BSC.AR-SD0046,00ARSD0245,L,1,44500,159000,0,0,0,0,0,31800,159000,127200
01SCS19E310214,AR.KNR-RK002,20ARRK0255,M,1,136500,210000,2,0,63000,1,0,36750,147000,110250
01SCS19E310215,BSC.AR-SD0058,00ARSD0294,NON,1,50000,150000,0,0,0,0,0,30000,150000,120000
01SCS19E310216,BSC.AR-SA0020,00ARSA0080,M,1,44000,135000,0,0,0,0,0,27000,135000,108000
01SCS19E310217,BSC.AR-SD0030,00ARSD0175,M,1,44500,159000,0,0,0,0,0,31800,159000,127200
01SCS19E310218,ESH.AR-RJ0023,00ARRJ0218,NON,1,18000,75000,0,0,0,0,0,15000,75000,60000
01SCS19E310218,ESH.AR-SE0039,00ARSE0364,L,1,44000,135000,0,0,0,0,0,27000,135000,108000
01SCS19E310219,AR.ESB-RK002,20ARRK0229,L,1,198250,305000,2,0,61000,1,0,61000,244000,183000
01SCS19E310220,ESH.AR-SD0032,00ARSD0304,M,1,44500,135000,0,0,0,0,0,27000,135000,108000
01SCS19E310220,ESH.AR-SE0016,00ARSE0111,L,1,44000,135000,0,0,0,0,0,27000,135000,108000
01SCS19E310221,ESH.AR-SE0017,00ARSE0114,M,1,44000,135000,0,0,0,0,0,27000,135000,108000
01SCS19E310222,ESH.AR-SE0043,00ARSE0418,S,1,125000,315000,0,0,0,0,0,63000,315000,252000
01SCS19E310223,ESH.AR-SD0029,00ARSD0278,NON,1,58000,175000,0,0,0,0,0,35000,175000,140000
01SCS19E310224,AR.SMD-SE003,20ARSE0441,M,1,87750,135000,2,0,27000,1,0,27000,108000,81000
01SCS19E310225,BSC.AR-SE0037,00ARSE0348,L,1,44000,159000,0,0,0,0,0,31800,159000,127200
01SCS19E310225,ESH.AR-RJ0014,00ARRJ0182,XL,1,44500,135000,0,0,0,0,0,27000,135000,108000
01SCS19E310226,AR.TUC-SD014,20ARSD0475,L,1,94250,145000,2,0,29000,1,0,29000,116000,87000
01SCS19E310227,AR.ASH-SD004,20ARSD0394,M,1,243750,375000,2,0,112500,1,0,65625,262500,196875
01SCS19E310228,BSC.AR-SD0058,00ARSD0294,NON,1,50000,150000,0,0,0,0,0,30000,150000,120000
01SCS19E310229,AR.HMR-SE018,20ARSE0897,34,1,204750,315000,2,0,63000,1,0,63000,252000,189000
01SCS19E310230,AR.ESB-SC021,20ARSC0470,ALL,1,68250,105000,2,0,52500,1,0,13125,52500,39375
01SCS19E310231,AR.MKV-SE015,20ARSE0593,L,1,22750,350000,0,0,0,0,0,122500,350000,227500
01SCS19E310232,AR.MKV-RG004,20ARRG0090,ALL,1,78000,120000,0,0,0,0,0,42000,120000,78000
01SCS19E310233,BSC.AR-SC0005,00ARSC0035,M,1,44500,159000,0,0,0,0,0,31800,159000,127200
01SCS19E310234,AR.PCT-SE015,20ARSE0678,M,1,87750,135000,2,0,27000,1,0,27000,108000,81000
01SCS19E310235,ESH.AR-SB0030,00ARSB0200,S,1,44000,135000,0,0,0,0,0,27000,135000,108000
01SCS19E310236,BSC.AR-SD0002,00ARSD0007,L,1,44000,159000,0,0,0,0,0,31800,159000,127200
01SCS19E310237,AR.MPR-SE024,20ARSE0216,L,1,230750,355000,2,0,71000,1,0,71000,284000,213000
01SCS19E310238,ESH.AR-SE0010,00ARSE0038,M,1,44000,135000,0,0,0,0,0,27000,135000,108000
01SCS19E310239,AR.PUB-RJ042,20ARRJ0518,M,1,97500,150000,2,0,30000,1,0,30000,120000,90000
01SCS19E310240,BSC.AR-SE0006,00ARSE0077,S,1,44500,159000,0,0,0,0,0,31800,159000,127200
01SCS19E310241,AR.HMR-SE007,20ARSE0851,M,1,90350,139000,2,0,27800,1,0,27800,111200,83400
01SCS19E310242,ESH.AR-SE0030,00ARSE0267,S,1,125000,315000,0,0,0,0,0,63000,315000,252000
01SCS19E310243,AR.MKV-SE018,20ARSE0602,S,2,97500,150000,0,0,0,0,0,52500,300000,195000
01SCS19E310243,AR.MKV-SE018,20ARSE0604,L,1,97500,150000,0,0,0,0,0,52500,150000,97500
01SCS19E310243,BSC.AR-RL0028,00ARRL0179,M,1,44500,135000,0,0,0,0,0,27000,135000,108000
01SCS19E310243,ESH.AR-SE0011,00ARSE0041,S,1,44500,135000,0,0,0,0,0,27000,135000,108000
01SCS19E310243,ESH.AR-SE0011,00ARSE0044,XL,1,44500,135000,0,0,0,0,0,27000,135000,108000
01SCS19E310244,AR.PUB-SE024,20ARSE0092,M,1,159250,245000,2,0,49000,1,0,49000,196000,147000
01SCS19E310245,ESH.AR-SD0025,00ARSD0263,M,1,44000,135000,0,0,0,0,0,27000,135000,108000
01SCS19E310245,ESH.AR-SE0031,00ARSE0272,M,1,125000,315000,0,0,0,0,0,63000,315000,252000
01SCS19E310246,ESH.AR-SE0016,00ARSE0111,L,1,44000,135000,0,0,0,0,0,27000,135000,108000
01SCS19E310247,AR.PUB-SA001,20ARSA0081,XL,1,97500,150000,2,0,30000,1,0,30000,120000,90000
01SCS19E310248,AR.MKV-RJ009,20ARRJ0181,M,1,91000,140000,0,0,0,0,0,49000,140000,91000
01SCS19E310249,BSC.AR-SE0038,00ARSE0351,M,1,52000,155000,0,0,0,0,0,31000,155000,124000
01SCS19E310249,BSC.AR-SE0049,00ARSE0411,M,1,52000,155000,0,0,0,0,0,31000,155000,124000
01SCS19E310250,AR.CPT-SC004,20ARSC0253,M,1,304850,469000,2,0,93800,1,0,93800,375200,281400
01SCS19E310251,AR.MER-SB004,20ARSB0224,L,1,97500,150000,2,0,45000,1,0,26250,105000,78750
01SCS19E310252,AR.REC-SD009,20ARSD0035,L,1,178750,275000,2,0,82500,1,0,48125,192500,144375
01SCS19E310252,AR.REC-SD010,20ARSD0038,M,1,178750,275000,2,0,82500,1,0,48125,192500,144375
01SCS19E310253,ESH.AR-SD0027,00ARSD0270,S,1,44000,135000,0,0,0,0,0,27000,135000,108000
01SCS19E310253,ESH.AR-SD0031,00ARSD0299,S,1,44000,135000,0,0,0,0,0,27000,135000,108000
01SCS19E310254,ESH.AR-SD0039,00ARSD0348,M,1,122500,350000,0,0,0,0,0,70000,350000,280000
01SCS19E310255,AR.MPR-SE040,20ARSE0821,ALL,1,107250,165000,2,0,49500,1,0,28875,115500,86625
01SCS19E310256,AR.MKV-SE016,20ARSE0596,M,1,22750,350000,0,0,0,0,0,122500,350000,227500
01SCS19E310256,ESH.AR-SD0019,00ARSD0142,L,1,125000,315000,0,0,0,0,0,63000,315000,252000
01SCS19E310257,AR.MDS-QL016,20ARQL0072,XL,1,104000,160000,2,0,32000,1,0,32000,128000,96000
01SCS19E310258,AR.TUC-RI008,20ARRI0357,XL,1,87750,135000,2,0,27000,1,0,27000,108000,81000
01SCS19E310259,AR.MKV-SE003,20ARSE0481,32,1,224250,345000,0,0,0,0,0,120750,345000,224250
01SCS19E310260,AR.TUC-SE013,20ARSE0413,L,1,94250,145000,2,0,29000,1,0,29000,116000,87000
01SCS19E310261,ESH.AR-SD0006,00ARSD0053,S,1,44500,135000,0,0,0,0,0,27000,135000,108000
01SCS19E310262,AR.CPT-RI010,20ARRI0079,XL,1,204750,315000,2,0,63000,1,0,63000,252000,189000
01SCS19E310263,AR.PUB-SE024,20ARSE0092,M,1,159250,245000,2,0,49000,1,0,49000,196000,147000
01SCS19E310264,BSC.AR-SD0063,00ARSD0338,NON,1,60000,180000,0,0,0,0,0,36000,180000,144000
01SCS19E310265,AR.MKV-SE006,20ARSE0496,32,1,165750,255000,0,0,0,0,0,89250,255000,165750
01SCS19E310265,BSC.AR-SC0032,00ARSC0221,32,1,135000,375000,0,0,0,0,0,75000,375000,300000
01SCS19E310266,BSC.AR-SD0061,00ARSD0336,NON,1,45000,150000,0,0,0,0,0,30000,150000,120000
01SCS19E310267,BSC.AR-SE0029,00ARSE0286,XL,1,125000,315000,0,0,0,0,0,63000,315000,252000
01SCS19E310268,AR.PCT-SE016,20ARSE0681,L,1,87750,135000,2,0,27000,1,0,27000,108000,81000
01SCS19E310269,AR.PUB-SD025,20ARSD0198,M,1,97500,150000,2,0,30000,1,0,30000,120000,90000
01SCS19E310270,AR.TUC-SE016,20ARSE0425,L,1,146250,225000,2,0,45000,1,0,45000,180000,135000
01SCS19E310271,BSC.AR-SD0063,00ARSD0338,NON,1,60000,180000,0,0,0,0,0,36000,180000,144000
01SCS19E310272,ESH.AR-SE0009,00ARSE0034,M,1,44500,135000,0,0,0,0,0,27000,135000,108000
01SCS19E310273,ESH.AR-SE0021,00ARSE0232,M,1,44500,135000,0,0,0,0,0,27000,135000,108000
01SCS19E310274,AR.PUB-SB020,20ARSB0076,L,1,159250,245000,2,0,49000,1,0,49000,196000,147000
01SCS19E310275,AR.MKV-SC012,20ARSC0110,ALL,1,97500,150000,0,0,0,0,0,52500,150000,97500
01SCS19E310276,AR.MKV-RE007,20ARRE0844,ALL,1,91000,140000,2,0,70000,1,0,17500,70000,52500
01SCS19E310277,BSC.AR-SD0018,00ARSD0123,NON,1,45000,150000,0,0,0,0,0,30000,150000,120000
01SCS19E310278,BE.RAK-SB014,00BESB0069,XL,1,91000,140000,2,0,28000,1,0,28000,112000,84000
01SCS19E310279,BSC.AR-SA0004,00ARSA0018,S,1,125000,315000,0,0,0,0,0,63000,315000,252000
01SCS19E310280,BSC.AR-SC0033,00ARSC0226,L,1,125000,315000,0,0,0,0,0,63000,315000,252000
01SCS19E310281,AR.ESB-SD011,20ARSD0319,M,1,91000,140000,2,0,28000,1,0,28000,112000,84000
01SCS19E310282,BSC.AR-SE0049,00ARSE0410,S,1,52000,155000,0,0,0,0,0,31000,155000,124000
01SCS19E310283,AR.ESB-RE049,20ARRE0813,ALL,1,91000,140000,2,0,70000,1,0,17500,70000,52500
01SCS19E310283,AR.ESB-RL011,20ARRL0462,ALL,1,91000,140000,2,0,70000,1,0,17500,70000,52500
01SCS19E310284,BSC.AR-SB0005,00ARSB0061,NON,1,47500,140000,0,0,0,0,0,28000,140000,112000
01SCS19E310285,AR.STY-SA006,20ARSA0065,ALL,1,61750,95000,2,0,19000,1,0,19000,76000,57000
01SCS19E310286,AR.MKV-SE010,20ARSE0516,32,1,227500,350000,0,0,0,0,0,122500,350000,227500
01SCS19E310287,ESH.AR-SC0022,00ARSC0161,S,1,125000,315000,0,0,0,0,0,63000,315000,252000
01SCS19E310288,ESH.AR-SE0038,00ARSE0333,M,1,44500,135000,0,0,0,0,0,27000,135000,108000
01SCS19E310289,AR.MKV-SC014,20ARSC0210,L,1,204750,315000,0,0,0,0,0,110250,315000,204750
01SCS19E310290,ESH.AR-SE0005,00ARSE0018,M,1,44500,135000,0,0,0,0,0,27000,135000,108000
01SCS19E310291,BSC.AR-RL0026,00ARRL0172,L,1,94500,135000,0,0,0,0,0,27000,135000,108000
01SCS19E310292,BE.RAK-SC037,00BESC0160,XL,1,91000,140000,2,0,28000,1,0,28000,112000,84000
01SCS19E310292,BSC.AR-SE0027,00ARSE0277,L,1,52000,155000,0,0,0,0,0,31000,155000,124000
01SCS19E310293,BSC.AR-SB0010,00ARSB0093,M,1,125000,315000,0,0,0,0,0,63000,315000,252000
01SCS19E310294,AR.CPT-SC010,20ARSC0472,M,1,204750,315000,2,0,63000,1,0,63000,252000,189000
01SCS19E310294,AR.HMR-SE018,20ARSE0895,30,1,204750,315000,2,0,63000,1,0,63000,252000,189000
01SCS19E310295,ESH.AR-SE0009,00ARSE0034,M,1,44500,135000,0,0,0,0,0,27000,135000,108000
01SCS19E310296,AR.TUC-SD014,20ARSD0475,L,1,94250,145000,2,0,29000,1,0,29000,116000,87000
01SCS19E310297,AR.MDS-RL002,20ARRL0360,L,1,117000,180000,2,0,36000,1,0,36000,144000,108000
01SCS19E310298,AR.STY-RJ004,20ARRJ0053,ALL,1,55250,85000,2,0,17000,1,0,17000,68000,51000
01SCS19E310299,ESH.AR-SA0012,00ARSA0094,M,1,44000,135000,0,0,0,0,0,27000,135000,108000
01SCS19E310300,AR.GTW-SB002,20ARSB0154,L,1,214500,330000,2,0,99000,1,0,57750,231000,173250
01SCS19E310301,AR.HMR-SE019,20ARSE0899,28,1,211250,325000,0,0,0,0,0,113750,325000,211250
01SCS19E310302,BSC.AR-SD0005,00ARSD0018,M,1,44500,159000,0,0,0,0,0,31800,159000,127200
01SCS19E310303,AR.MER-SE005,20ARSE0696,ALL,1,97500,150000,0,0,0,0,0,52500,150000,97500
01SCS19E310304,ESH.AR-SC0024,00ARSC0213,L,1,119000,350000,0,0,0,0,0,70000,350000,280000
01SCS19E310305,BSC.AR-SD0004,00ARSD0015,L,1,44000,159000,0,0,0,0,0,31800,159000,127200
01SCS19E310305,BSC.AR-SE0050,00ARSE0415,M,1,52000,155000,0,0,0,0,0,31000,155000,124000
01SCS19E310306,AR.MKV-SE025,20ARSE0627,34,1,214500,330000,0,0,0,0,0,115500,330000,214500
01SCS19E310307,BSC.AR-SD0027,00ARSD0157,M,1,125000,315000,0,0,0,0,0,63000,315000,252000
01SCS19E310308,BSC.AR-SD0035,00ARSD0195,S,1,44500,159000,0,0,0,0,0,31800,159000,127200
01SCS19E310309,ESH.AR-RG0003,00ARRG0007,M,1,90000,255000,0,0,0,0,0,51000,255000,204000
01SCS19E310310,AR.YD-RL004,20ARRL0020,ALL,1,91000,140000,2,0,70000,1,0,17500,70000,52500
01SCS19E310311,AR.PUB-SD033,20ARSD0244,L,1,204750,315000,2,0,63000,1,0,63000,252000,189000
01SCS19E310312,AR.VLD-RK016,20ARRK0345,XL,1,211250,325000,2,0,97500,1,0,56875,227500,170625
01SCS19E310313,AR.PUB-SE026,20ARSE0099,S,1,204750,315000,2,0,63000,1,0,63000,252000,189000
01SCS19E310313,BSC.AR-SE0013,00ARSE0175,S,1,44000,159000,0,0,0,0,0,31800,159000,127200
01SCS19E310314,ESH.AR-SE0009,00ARSE0034,M,1,44500,135000,0,0,0,0,0,27000,135000,108000
01SCS19E310315,AR.BPH-RB011,20ARRB0467,L,1,103350,159000,2,0,47700,1,0,27825,111300,83475
01SCS19E310315,BSC.AR-SD0052,00ARSD0280,M,1,44500,159000,0,0,0,0,0,31800,159000,127200
01SCS19E310316,BE.RAK-RL022,00BERL0073,L,1,211250,325000,2,0,65000,1,0,65000,260000,195000
01SCS19E310317,BE.RAK-SC029,00BESC0119,XL,1,211250,325000,2,0,65000,1,0,65000,260000,195000
01SCS19E310318,AR.HLW-SE004,20ARSE0532,M,1,100750,155000,2,0,31000,1,0,31000,124000,93000
01SCS19E310319,BSC.AR-SD0038,00ARSD0209,L,1,125000,315000,0,0,0,0,0,63000,315000,252000
01SCS19E310320,AR.MKV-SA002,20ARSA0188,ALL,1,87750,135000,0,0,0,0,0,47250,135000,87750
01SCS19E310320,AR.STY-RJ009,20ARRJ0112,ALL,1,61750,95000,2,0,19000,1,0,19000,76000,57000
01SCS19E310321,AR.PUB-SE031,20ARSE0324,L,1,204750,315000,2,0,63000,1,0,63000,252000,189000
01SCS19E310322,BSC.AR-SD0028,00ARSD0160,S,1,125000,315000,0,0,0,0,0,63000,315000,252000
01SCS19E310323,BSC.AR-SA0008,00ARSA0034,NON,1,47500,140000,0,0,0,0,0,28000,140000,112000
01SCS19E310324,AR.MDG-SC003,20ARSC0158,M,1,94250,145000,2,0,43500,1,0,25375,101500,76125
01SCS19E310325,ESH.AR-SC0026,00ARSC0238,L,1,44500,135000,0,0,0,0,0,27000,135000,108000
01SCS19E310326,ESH.AR-SE0027,00ARSE0256,M,1,44500,135000,0,0,0,0,0,27000,135000,108000
01SCS19E310327,ESH.AR-SA0010,00ARSA0091,NON,1,53000,155000,0,0,0,0,0,31000,155000,124000
01SCS19E310328,AR.TUC-SE012,20ARSE0410,XL,1,94250,145000,2,0,29000,1,0,29000,116000,87000
01SCS19E310328,BSC.AR-SD0002,00ARSD0006,M,1,44000,159000,0,0,0,0,0,31800,159000,127200
01SCS19E310328,ESH.AR-SE0037,00ARSE0329,M,1,44000,135000,0,0,0,0,0,27000,135000,108000
01SCS19E310329,BSC.AR-SE0038,00ARSE0351,M,1,52000,155000,0,0,0,0,0,31000,155000,124000
01SCS19E310330,BSC.AR-SE0010,00ARSE0093,S,1,44000,159000,0,0,0,0,0,31800,159000,127200
01SCS19E310331,AR.STY-RK003,20ARRK0525,ALL,1,61750,95000,2,0,19000,1,0,19000,76000,57000
01SCS19E310331,AR.STY-SE005,20ARSE0123,ALL,1,55250,85000,2,0,17000,1,0,17000,68000,51000
01SCS19E310332,AR.PUB-SE026,20ARSE0099,S,1,204750,315000,2,0,63000,1,0,63000,252000,189000
01SCS19E310333,AR.TUC-SD024,20ARSD0514,M,1,204750,315000,2,0,63000,1,0,63000,252000,189000
01SCS19E310334,BSC.AR-SE0001,00ARSE0059,L,1,44500,159000,0,0,0,0,0,31800,159000,127200
01SCS19E310335,AR.ESB-RK002,20ARRK0228,M,1,198250,305000,2,0,61000,1,0,61000,244000,183000
01SCS19E310336,AR.PUB-SD032,20ARSD0239,M,1,204750,315000,2,0,63000,1,0,63000,252000,189000
01SCS19E310337,ESH.AR-SE0036,00ARSE0324,S,1,44500,135000,0,0,0,0,0,27000,135000,108000
01SCS19E310338,ESH.AR-SB0011,00ARSB0054,XL,1,125000,315000,0,0,0,0,0,63000,315000,252000
01SCS19E310339,AR.PUB-SB020,20ARSB0076,L,1,159250,245000,2,0,49000,1,0,49000,196000,147000
01SCS19E310340,ESH.AR-SE0017,00ARSE0113,S,1,44000,135000,0,0,0,0,0,27000,135000,108000
01SCS19E310341,AR.FHL-RJ005,20ARRJ0433,M,1,211250,325000,2,0,65000,1,0,65000,260000,195000
01SCS19E310342,ESH.AR-SC0034,00ARSC0293,M,1,125000,315000,0,0,0,0,0,63000,315000,252000
01SCS19E310343,BSC.AR-SE0054,00ARSE0438,S,1,52000,160000,0,0,0,0,0,32000,160000,128000
01SCS19E310344,AR.RDC-RH014,20ARRH0648,M,1,97500,150000,2,0,30000,1,0,30000,120000,90000
01SCS19E310345,AR.BPH-RB011,20ARRB0467,L,-1,103350,159000,2,0,47700,1,0,27825,-111300,-83475
01SCS19E310345,AR.PCT-SE005,20ARSE0344,M,1,87750,135000,2,0,27000,1,0,27000,108000,81000
01SCS19E310346,ESH.AR-SD0027,00ARSD0271,M,1,44000,135000,0,0,0,0,0,27000,135000,108000
01SCS19E310346,ESH.AR-SE0030,00ARSE0268,M,1,125000,315000,0,0,0,0,0,63000,315000,252000
01SCS19E310347,AR.HMR-SE019,20ARSE0899,28,1,211250,325000,0,0,0,0,0,113750,325000,211250
01SCS19E310348,BSC.AR-SE0020,00ARSE0204,M,1,44000,159000,0,0,0,0,0,31800,159000,127200
01SCS19E310348,ESH.AR-SA0001,00ARSA0015,32,1,122500,175000,0,0,0,0,0,35000,175000,140000
01SCS19E310349,BSC.AR-SE0029,00ARSE0283,S,1,125000,315000,0,0,0,0,0,63000,315000,252000
01SCS19E310350,AR.YD-SB005,20ARSB0509,M,1,195000,300000,2,0,90000,1,0,52500,210000,157500
01SCS19E310351,AR.HMR-SE007,20ARSE0850,S,1,90350,139000,2,0,27800,1,0,27800,111200,83400
01SCS19E310352,AR.ESB-SE006,20ARSE0259,M,1,94250,145000,2,0,29000,1,0,29000,116000,87000
01SCS19E310353,AR.PCT-SE019,20ARSE0687,L,1,87750,135000,2,0,27000,1,0,27000,108000,81000
01SCS19E310354,AR.MPR-SE028,20ARSE0231,M,1,230750,355000,2,0,71000,1,0,71000,284000,213000
01SCS19E310355,ESH.AR-SC0023,00ARSC0166,M,1,125000,315000,0,0,0,0,0,63000,315000,252000
01SCS19E310356,AR.MDG-SC003,20ARSC0159,L,1,94250,145000,2,0,43500,1,0,25375,101500,76125
01SCS19E310357,AR.MDS-RL002,20ARRL0360,L,1,117000,180000,2,0,36000,1,0,36000,144000,108000
01SCS19E310358,BSC.AR-SD0022,00ARSD0129,M,1,44000,159000,0,0,0,0,0,31800,159000,127200
01SCS19E310359,ESH.AR-SD0025,00ARSD0262,S,1,44000,135000,0,0,0,0,0,27000,135000,108000
01SCS19E310360,AR.PUB-SD025,20ARSD0198,M,1,97500,150000,2,0,30000,1,0,30000,120000,90000
01SCS19E310361,AR.SMD-RH009,20ARRH0761,XL,1,87750,135000,2,0,40500,1,0,23625,94500,70875
01SCS19E310361,ESH.AR-SD0026,00ARSD0269,XL,1,44500,135000,0,0,0,0,0,27000,135000,108000
01SCS19E310362,AR.TUC-SD014,20ARSD0476,XL,1,94250,145000,2,0,29000,1,0,29000,116000,87000
01SCS19E310363,AR.MKV-SE014,20ARSE0588,M,1,22750,350000,0,0,0,0,0,122500,350000,227500
01SCS19E310364,BSC.AR-SE0001,00ARSE0059,L,1,44500,159000,0,0,0,0,0,31800,159000,127200
01SCS19E310365,ESH.AR-SC0022,00ARSC0162,M,1,125000,315000,0,0,0,0,0,63000,315000,252000
01SCS19E310366,ESH.AR-SE0005,00ARSE0018,M,1,44500,135000,0,0,0,0,0,27000,135000,108000
01SCS19E310367,ESH.AR-SE0031,00ARSE0271,S,1,125000,315000,0,0,0,0,0,63000,315000,252000
01SCS19E310368,ESH.AR-SD0019,00ARSD0142,L,1,125000,315000,0,0,0,0,0,63000,315000,252000
01SCS19E310369,AR.ESB-SD002,20ARSD0102,L,1,74750,115000,2,0,23000,1,0,23000,92000,69000
01SCS19E310370,AR.TUC-SB021,20ARSB0485,ALL,1,87750,135000,2,0,27000,1,0,27000,108000,81000
01SCS19E310370,BSC.AR-SD0057,00ARSD0293,NON,1,45000,140000,0,0,0,0,0,28000,140000,112000
01SCS19E310370,BSC.AR-SD0066,00ARSD0356,M,1,44500,159000,0,0,0,0,0,31800,159000,127200
01SCS19E310371,AR.TUC-RJ004,20ARRJ0108,ALL,1,22750,35000,2,0,7000,1,0,7000,28000,21000
01SCS19E310372,AR.HMR-SE001,20ARSE0827,M,1,90350,139000,2,0,27800,1,0,27800,111200,83400
01SCS19E310373,AR.TUC-SD004,20ARSD0154,L,1,204750,315000,2,0,63000,1,0,63000,252000,189000
01SCS19E310374,BE.RAK-SC020,00BESC0075,XL,1,201500,310000,2,0,62000,1,0,62000,248000,186000
01SCS19E310375,AR.TUC-SA040,20ARSA0272,ALL,1,87750,135000,2,0,27000,1,0,27000,108000,81000
01SCS19E310376,BSC.AR-SD0013,00ARSD0107,M,1,44500,159000,0,0,0,0,0,31800,159000,127200
01SCS19E310377,AR.GTW-SC002,20ARSC0026,M,1,97500,150000,2,0,45000,1,0,26250,105000,78750
01SCS19E310378,BE.RAK-SC052,00BESC0202,L,1,110500,170000,2,0,34000,1,0,34000,136000,102000
01SCS19E310379,AR.HMR-SB021,20ARSB0396,30,1,204750,315000,2,0,63000,1,0,63000,252000,189000
01SCS19E310379,AR.TUC-SD007,20ARSD0166,L,1,185250,285000,2,0,57000,1,0,57000,228000,171000
01SCS19E310380,AR.TUC-SD006,20ARSD0161,M,1,94250,145000,2,0,29000,1,0,29000,116000,87000
01SCS19E310381,AR.CPT-SE002,20ARSE0358,L,1,94250,145000,2,0,29000,1,0,29000,116000,87000
01SCS19E310382,AR.MKV-RJ001,20ARRJ0142,L,1,91000,140000,0,0,0,0,0,49000,140000,91000
01SCS19E310383,AR.YD-RL016,20ARRL0042,S,1,91000,140000,2,0,70000,1,0,17500,70000,52500
01SCS19E310384,AR.CPT-SD007,20ARSD0438,M,1,204750,315000,2,0,63000,1,0,63000,252000,189000
01SCS19E310385,AR.MER-SB002,20ARSB0216,M,1,97500,150000,2,0,45000,1,0,26250,105000,78750
01SCS19E310386,AR.ASH-RJ003,20ARRJ0127,S,1,292500,450000,2,0,225000,1,0,56250,225000,168750
01SCS19E310387,AR.MPR-SE009,20ARSE0170,M,1,97500,150000,2,0,45000,1,0,26250,105000,78750
01SCS19E310388,AR.CPT-SE004,20ARSE0364,S,1,204750,315000,2,0,63000,1,0,63000,252000,189000
01SCS19E310389,AR.PUB-RL016,20ARRL0163,ALL,1,97500,150000,2,0,30000,1,0,30000,120000,90000
01SCS19E310390,ESH.AR-SE0030,00ARSE0269,L,1,125000,315000,0,0,0,0,0,63000,315000,252000
01SCS19E310391,AR.PCT-SE015,20ARSE0678,M,1,87750,135000,2,0,27000,1,0,27000,108000,81000
01SCS19E310392,ESH.AR-SE0028,00ARSE0261,L,1,44000,135000,0,0,0,0,0,27000,135000,108000
01SCS19E310392,ESH.AR-SE0036,00ARSE0326,L,1,44500,135000,0,0,0,0,0,27000,135000,108000
01SCS19E310392,ESH.AR-SE0043,00ARSE0420,L,1,125000,315000,0,0,0,0,0,63000,315000,252000
01SCS19E310393,BSC.AR-SD0025,00ARSD0150,L,1,44500,159000,0,0,0,0,0,31800,159000,127200
01SCS19E310394,AR.FHL-SE001,20ARSE0376,ALL,1,87750,135000,2,0,27000,1,0,27000,108000,81000
01SCS19E310395,AR.HMR-SE001,20ARSE0828,L,1,90350,139000,2,0,27800,1,0,27800,111200,83400
01SCS19E310396,ESH.AR-SD0018,00ARSD0136,S,1,125000,315000,0,0,0,0,0,63000,315000,252000
01SCS19E310397,AR.BPH-RD010,20ARRH0375,S,1,182000,280000,2,0,140000,1,0,35000,140000,105000
01SCS19E310398,AR.PUB-SD017,20ARSD0134,M,1,204750,315000,2,0,63000,1,0,63000,252000,189000
01SCS19E310399,AR.HMR-SE019,20ARSE0899,28,1,211250,325000,0,0,0,0,0,113750,325000,211250
01SCS19E310400,AR.CPT-QI017,20ARQI0048,M,1,104000,160000,2,0,32000,1,0,32000,128000,96000
01SCS19E310401,BSC.AR-SD0022,00ARSD0129,M,1,44000,159000,0,0,0,0,0,31800,159000,127200
01SCS19E310401,BSC.AR-SD0052,00ARSD0280,M,1,44500,159000,0,0,0,0,0,31800,159000,127200
01SCS19E310402,DKS.AR-SE0004,00ARSE0141,34,1,417272,696000,0,0,0,0,0,104400,696000,591600
01SCS19E310403,ESH.AR-SE0038,00ARSE0333,M,1,44500,135000,0,0,0,0,0,27000,135000,108000
01SCS19E310404,BSC.AR-SD0029,00ARSD0171,M,1,44500,159000,0,0,0,0,0,31800,159000,127200
01SCS19E310404,BSC.AR-SD0047,00ARSD0247,NON,1,68000,220000,0,0,0,0,0,44000,220000,176000
01SCS19E310404,ESH.AR-SE0021,00ARSE0233,L,1,44500,135000,0,0,0,0,0,27000,135000,108000
01SCS19E310405,AR.PUB-SE024,20ARSE0091,S,1,159250,245000,2,0,49000,1,0,49000,196000,147000
01SCS19E310406,AR.PUB-SE021,20ARSE0081,L,1,159250,245000,2,0,49000,1,0,49000,196000,147000
01SCS19E310407,AR.PUB-SE001,20ARSE0002,M,1,97500,150000,2,0,30000,1,0,30000,120000,90000
01SCS19E310408,AR.SMD-SD006,20ARSD0298,L,1,87750,135000,2,0,27000,1,0,27000,108000,81000
01SCS19E310409,AR.CPT-RK007,20ARRK0025,L,1,204750,315000,2,0,63000,1,0,63000,252000,189000
01SCS19E310410,ARN.AR-RK0004,00ARRK0230,S,1,150000,450000,0,0,0,0,0,135000,450000,315000
01SCS19E310411,ESH.AR-SD0028,00ARSD0276,L,1,44500,135000,0,0,0,0,0,27000,135000,108000
01SCS19E310412,AR.CPT-SB002,20ARSB0501,M,1,94250,145000,2,0,29000,1,0,29000,116000,87000
01SCS19E310413,AR.TUC-SA033,20ARSA0265,ALL,1,87750,135000,2,0,27000,1,0,27000,108000,81000
01SCS19E310414,AR.ESB-RK002,20ARRK0228,M,1,198250,305000,2,0,61000,1,0,61000,244000,183000
01SCS19E310415,ESH.AR-SC0003,00ARSC0009,S,1,125000,350000,0,0,0,0,0,70000,350000,280000
01SCS19E310416,AR.HLW-SE022,20ARSE0574,M,1,100750,155000,2,0,31000,1,0,31000,124000,93000
01SCS19E310416,CHM.AR-RI0006,00ARRI0185,M,1,379000,379000,0,0,0,0,0,56850,379000,322150
01SCS19E310417,AR.HLW-SE005,20ARSE0534,S,1,100750,155000,2,0,31000,1,0,31000,124000,93000
01SCS19E310418,AR.MER-SB002,20ARSB0217,L,1,97500,150000,2,0,45000,1,0,26250,105000,78750
01SCS19E310419,ESH.AR-SE0026,00ARSE0252,M,1,44000,135000,0,0,0,0,0,27000,135000,108000
01SCS19E310420,AR.MDG-SC001,20ARSC0153,L,1,94250,145000,2,0,43500,1,0,25375,101500,76125
01SCS19E310420,AR.MDG-SC002,20ARSC0156,L,1,94250,145000,2,0,43500,1,0,25375,101500,76125
01SCS19E310420,CHM.AR-RI0006,00ARRI0185,M,1,379000,379000,0,0,0,0,0,56850,379000,322150
01SCS19E310421,BSC.AR-SC0048,00ARSC0305,M,1,44500,159000,0,0,0,0,0,31800,159000,127200
01SCS19E310422,AR.TUC-SD006,20ARSD0161,M,1,94250,145000,2,0,29000,1,0,29000,116000,87000
01SCS19E310423,BSC.AR-SE0046,00ARSE0398,S,1,44500,159000,0,0,0,0,0,31800,159000,127200
01SCS19E310424,AR.TUC-SE005,20ARSE0380,M,1,204750,315000,2,0,63000,1,0,63000,252000,189000
01SCS19E310425,BSC.AR-SC0018,00ARSC0125,M,1,44500,159000,0,0,0,0,0,31800,159000,127200
01SCS19E310425,BSC.AR-SE0026,00ARSE0227,S,1,44000,159000,0,0,0,0,0,31800,159000,127200
01SCS19E310426,AR.PUB-RL005,20ARRL0125,L,1,97500,150000,2,0,30000,1,0,30000,120000,90000
01SCS19E310426,BSC.AR-SD0022,00ARSD0129,M,1,44000,159000,0,0,0,0,0,31800,159000,127200
01SCS19E310427,AR.PCT-SE015,20ARSE0679,L,1,87750,135000,2,0,27000,1,0,27000,108000,81000
01SCS19E310428,BSC.AR-SE0009,00ARSE0089,S,1,44500,159000,0,0,0,0,0,31800,159000,127200
01SCS19E310429,ESH.AR-SA0017,00ARSA0117,M,1,122500,350000,0,0,0,0,0,70000,350000,280000
01SCS19E310430,DKS.AR-SE0006,00ARSE0150,36,1,417272,696000,0,0,0,0,0,104400,696000,591600
01SCS19E310431,AR.SMD-SD013,20ARSD0571,L,1,87750,135000,2,0,27000,1,0,27000,108000,81000
01SCS19E310432,ESH.AR-SE0025,00ARSE0248,M,1,44500,135000,0,0,0,0,0,27000,135000,108000
01SCS19E310433,AR.MDS-RL002,20ARRL0359,M,1,117000,180000,2,0,36000,1,0,36000,144000,108000
01SCS19E310434,AR.TUC-SE026,20ARSE0809,ALL,1,87750,135000,2,0,27000,1,0,27000,108000,81000
01SCS19E310434,ESH.AR-RH0008,00ARRH0060,NON,1,45000,150000,0,0,0,0,0,30000,150000,120000
01SCS19E310435,BSC.AR-SA0009,00ARSA0035,NON,1,47500,140000,0,0,0,0,0,28000,140000,112000
01SCS19E310436,AR.TUC-SD011,20ARSD0464,XL,1,94250,145000,2,0,29000,1,0,29000,116000,87000
01SCS19E310437,BSC.AR-SD0018,00ARSD0123,NON,1,45000,150000,0,0,0,0,0,30000,150000,120000
01SCS19E310438,AR.PUB-SD028,20ARSD0206,ALL,1,97500,150000,2,0,30000,1,0,30000,120000,90000
01SCS19E310439,BSC.AR-SD0039,00ARSD0214,XL,1,125000,315000,0,0,0,0,0,63000,315000,252000
01SCS19E310440,BSC.AR-SD0042,00ARSD0228,M,1,44500,159000,0,0,0,0,0,31800,159000,127200
01SCS19E310441,AR.MKV-SC023,20ARSC0237,S,1,312000,480000,0,0,0,0,0,168000,480000,312000
01SCS19E310442,AR.BPH-RB012,20ARRB0472,XL,1,103350,159000,2,0,47700,1,0,27825,111300,83475
01SCS19E310442,AR.BPH-RL002,20ARRL0072,XL,1,103350,159000,2,0,47700,1,0,27825,111300,83475
01SCS19E310443,BSC.AR-SD0007,00ARSD0025,S,1,44500,159000,0,0,0,0,0,31800,159000,127200
01SCS19E310444,ESH.AR-SE0037,00ARSE0330,L,1,44000,135000,0,0,0,0,0,27000,135000,108000
01SCS19E310445,ESH.AR-RK0005,00ARRK0023,L,1,94500,135000,0,0,0,0,0,27000,135000,108000
01SCS19E310446,BSC.AR-SE0027,00ARSE0277,L,1,52000,155000,0,0,0,0,0,31000,155000,124000
01SCS19E310447,ESH.AR-SE0003,00ARSE0010,M,1,44500,135000,0,0,0,0,0,27000,135000,108000
01SCS19E310448,ESH.AR-SE0018,00ARSE0119,L,1,44500,135000,0,0,0,0,0,27000,135000,108000
01SCS19E310449,AR.HMR-SE019,20ARSE0901,32,1,211250,325000,0,0,0,0,0,113750,325000,211250
01SCS19E310450,AR.YAS-SE003,20ARSE0713,M,1,317850,489000,2,0,97800,1,0,97800,391200,293400
01SCS19E310451,AR.CPT-SB001,20ARSB0084,L,1,204750,315000,2,0,63000,1,0,63000,252000,189000
01SCS19E310452,AR.CPT-SB001,20ARSB0085,XL,1,204750,315000,2,0,63000,1,0,63000,252000,189000
01SCS19E310452,AR.STY-RJ004,20ARRJ0053,ALL,1,55250,85000,2,0,17000,1,0,17000,68000,51000
01SCS19E310453,AR.SMD-SE003,20ARSE0440,S,1,87750,135000,2,0,27000,1,0,27000,108000,81000
01SCS19E310454,BSC.AR-SE0005,00ARSE0073,S,1,44000,159000,0,0,0,0,0,31800,159000,127200
01SCS19E310455,AR.ESB-SC002,20ARSC0309,M,1,204750,315000,2,0,63000,1,0,63000,252000,189000
01SCS19E310456,AR.MPR-SE024,20ARSE0216,L,1,230750,355000,2,0,71000,1,0,71000,284000,213000
01SCS19E310457,AR.PUB-SD022,20ARSD0191,ALL,1,97500,150000,2,0,30000,1,0,30000,120000,90000
01SCS19E310457,AR.PUB-SE014,20ARSE0054,M,1,159250,245000,2,0,49000,1,0,49000,196000,147000
01SCS19E310458,AR.MER-SE004,20ARSE0695,ALL,1,9750,15000,0,0,0,0,0,5250,15000,9750
01SCS19E310459,AR.TUC-SA038,20ARSA0270,ALL,1,87750,135000,2,0,27000,1,0,27000,108000,81000
01SCS19E310460,AR.TUC-SB021,20ARSB0485,ALL,1,87750,135000,2,0,27000,1,0,27000,108000,81000
01SCS19E310460,ESH.AR-SD0036,00ARSD0334,NON,1,50000,150000,0,0,0,0,0,30000,150000,120000
01SCS19E310461,AR.MER-SB006,20ARSB0231,M,1,97500,150000,2,0,45000,1,0,26250,105000,78750
01SCS19E310462,AR.CPT-SE006,20ARSE0374,L,1,204750,315000,2,0,63000,1,0,63000,252000,189000
01SCS19E310463,AR.ESB-RK002,20ARRK0229,L,1,198250,305000,2,0,61000,1,0,61000,244000,183000
01SCS19E310464,ESH.AR-SE0021,00ARSE0233,L,1,44500,135000,0,0,0,0,0,27000,135000,108000
01SCS19E310465,AR.PUB-SE027,20ARSE0106,XL,1,204750,315000,2,0,63000,1,0,63000,252000,189000
01SCS19E310466,AR.CPT-SC010,20ARSC0474,XL,1,204750,315000,2,0,63000,1,0,63000,252000,189000
01SCS19E310467,ARN.AR-RK0005,00ARRK0234,28,1,110000,350000,0,0,0,0,0,105000,350000,245000
01SCS19E310467,ESH.AR-SE0036,00ARSE0324,S,1,44500,135000,0,0,0,0,0,27000,135000,108000
01SCS19E310468,AR.CPT-RI003,20ARRI0049,M,1,204750,315000,2,0,63000,1,0,63000,252000,189000
01SCS19E310469,AR.PUB-SE034,20ARSE0634,XL,1,191750,295000,2,0,59000,1,0,59000,236000,177000
01SCS19E310470,AR.HMR-SB001,20ARSB0338,L,1,237250,365000,2,0,73000,1,0,73000,292000,219000
01SCS19E310471,AR.YD-SB005,20ARSB0509,M,1,195000,300000,2,0,90000,1,0,52500,210000,157500
01SCS19E310471,AR.YD-SB006,20ARSB0513,M,1,195000,300000,2,0,150000,1,0,37500,150000,112500
01SCS19E310472,ESH.AR-SE0010,00ARSE0037,S,1,44000,135000,0,0,0,0,0,27000,135000,108000
01SCS19E310473,AR.PUB-SB033,20ARSB0464,ALL,1,97500,150000,2,0,30000,1,0,30000,120000,90000
01SCS19E310474,ESH.AR-SE0013,00ARSE0050,M,1,44500,135000,0,0,0,0,0,27000,135000,108000
01SCS19E310475,BSC.AR-SB0011,00ARSB0097,M,1,44500,135000,0,0,0,0,0,27000,135000,108000
01SCS19E310475,ESH.AR-SB0022,00ARSB0124,M,1,44000,135000,0,0,0,0,0,27000,135000,108000
01SCS19E310476,ESH.AR-SD0028,00ARSD0274,S,1,44500,135000,0,0,0,0,0,27000,135000,108000
01SCS19E310477,AR.TUC-SB017,20ARSB0475,L,1,87750,135000,2,0,27000,1,0,27000,108000,81000
01SCS19E310477,ESH.AR-SE0037,00ARSE0330,L,1,44000,135000,0,0,0,0,0,27000,135000,108000
01SCS19E310478,AR.MDS-RL007,20ARRL0378,M,1,130000,200000,2,0,40000,1,0,40000,160000,120000
01SCS19E310479,BSC.AR-SA0004,00ARSA0019,M,1,125000,315000,0,0,0,0,0,63000,315000,252000
01SCS19E310480,AR.HMR-SE018,20ARSE0894,28,1,204750,315000,2,0,63000,1,0,63000,252000,189000
01SCS19E310480,BSC.AR-SE0025,00ARSE0223,S,1,44500,159000,0,0,0,0,0,31800,159000,127200
01SCS19E310481,ESH.AR-SE0029,00ARSE0263,S,1,44500,135000,0,0,0,0,0,27000,135000,108000
01SCS19E310482,AR.PUB-SE008,20ARSE0031,L,1,97500,150000,2,0,30000,1,0,30000,120000,90000
01SCS19E310483,AR.MKV-SD001,20ARSD0219,M,1,97500,150000,0,0,0,0,0,52500,150000,97500
01SCS19E310484,BSC.AR-SC0046,00ARSC0298,NON,1,45000,150000,0,0,0,0,0,30000,150000,120000
01SCS19E310485,AR.CPS-SC007,20ARSC0007,ALL,1,130000,200000,2,0,60000,1,0,35000,140000,105000
01SCS19E310485,AR.TUC-SB004,20ARSB0032,ALL,1,61750,95000,2,0,19000,1,0,19000,76000,57000
01SCS19E310485,ESH.AR-RJ0028,00ARRJ0236,NON,1,45000,135000,0,0,0,0,0,27000,135000,108000
01SCS19E310486,AR.CPT-SE003,20ARSE0362,L,1,94250,145000,2,0,29000,1,0,29000,116000,87000
01SCS19E310487,AR.MPR-SE013,20ARSE0186,M,1,110500,170000,2,0,51000,1,0,29750,119000,89250
01SCS19E310488,AR.TUC-SA040,20ARSA0272,ALL,1,87750,135000,2,0,27000,1,0,27000,108000,81000
01SCS19E310489,BSC.AR-SD0055,00ARSD0288,NON,1,50000,150000,0,0,0,0,0,30000,150000,120000
01SCS19E310490,ESH.AR-SA0005,00ARSA0069,L,1,44000,135000,0,0,0,0,0,27000,135000,108000
01SCS19E310491,AR.CPT-SC008,20ARSC0268,S,1,94250,145000,2,0,29000,1,0,29000,116000,87000
01SCS19E310491,AR.PUB-RI008,20ARRI0123,L,1,191750,295000,2,0,59000,1,0,59000,236000,177000
01SCS19E310491,AR.TUC-SB021,20ARSB0485,ALL,1,87750,135000,2,0,27000,1,0,27000,108000,81000
01SCS19E310491,ESH.AR-SE0038,00ARSE0334,L,1,44500,135000,0,0,0,0,0,27000,135000,108000
01SCS19E310492,BSC.AR-RL0022,00ARRL0142,M,1,94500,135000,0,0,0,0,0,27000,135000,108000
01SCS19E310493,AR.MKV-SE014,20ARSE0590,XL,1,22750,350000,0,0,0,0,0,122500,350000,227500
01SCS19E310494,DKS.AR-SE0008,00ARSE0158,34,1,41727,696000,0,0,0,0,0,104400,696000,591600
01SCS19E310495,BSC.AR-SA0017,00ARSA0052,M,1,125000,315000,0,0,0,0,0,63000,315000,252000
01SCS19E310495,BSC.AR-SC0001,00ARSC0014,M,1,125000,315000,0,0,0,0,0,63000,315000,252000
01SCS19E310495,BSC.AR-SD0064,00ARSD0340,M,1,125000,315000,0,0,0,0,0,63000,315000,252000
01SCS19E310496,BSC.AR-SC0049,00ARSC0309,M,1,44500,159000,0,0,0,0,0,31800,159000,127200
01SCS19E310496,ESH.AR-SB0003,00ARSB0008,M,1,44000,135000,0,0,0,0,0,27000,135000,108000
01SCS19E310497,ESH.AR-SE0008,00ARSE0030,M,1,44500,135000,0,0,0,0,0,27000,135000,108000
01SCS19E310498,AR.HMR-SE019,20ARSE0900,30,1,211250,325000,0,0,0,0,0,113750,325000,211250
01SCS19E310499,AR.MKV-RL002,20ARRL0455,XL,1,204750,315000,0,0,0,0,0,110250,315000,204750
01SCS19E310500,AR.ESB-SE010,20ARSE0275,M,1,227500,350000,2,0,70000,1,0,70000,280000,210000
01SCS19E310501,ESH.AR-RK0004,00ARRK0016,XL,1,220500,315000,0,0,0,0,0,63000,315000,252000
01SCS19E310502,AR.MKV-SC012,20ARSC0110,ALL,1,97500,150000,0,0,0,0,0,52500,150000,97500
01SCS19E310503,AR.PUB-SB033,20ARSB0464,ALL,1,97500,150000,2,0,30000,1,0,30000,120000,90000
01SCS19E310504,ESH.AR-SC0022,00ARSC0162,M,1,125000,315000,0,0,0,0,0,63000,315000,252000
01SCS19E310505,AR.PUB-RL028,20ARRL0436,ALL,1,97500,150000,2,0,30000,1,0,30000,120000,90000
01SCS19E310506,AR.STY-SE004,20ARSE0122,ALL,1,55250,85000,2,0,17000,1,0,17000,68000,51000
01SCS19E310507,AR.HMR-SE017,20ARSE0890,30,1,211250,325000,2,0,65000,1,0,65000,260000,195000
01SCS19E310508,ESH.AR-SE0026,00ARSE0252,M,1,44000,135000,0,0,0,0,0,27000,135000,108000
01SCS19E310509,ESH.AR-SD0043,00ARSD0395,M,1,125000,315000,0,0,0,0,0,63000,315000,252000
01SCS19E310510,AR.CPT-SD007,20ARSD0439,L,1,204750,315000,2,0,63000,1,0,63000,252000,189000
01SCS19E310511,BSC.AR-RL0022,00ARRL0143,L,1,94500,135000,0,0,0,0,0,27000,135000,108000
01SCS19E310512,ESH.AR-SB0030,00ARSB0202,L,1,44000,135000,0,0,0,0,0,27000,135000,108000
01SCS19E310513,BSC.AR-SE0046,00ARSE0398,S,1,44500,159000,0,0,0,0,0,31800,159000,127200
01SCS19E310513,ESH.AR-SE0004,00ARSE0013,S,1,44500,135000,0,0,0,0,0,27000,135000,108000
01SCS19E310514,ESH.AR-SE0027,00ARSE0256,M,1,44500,135000,0,0,0,0,0,27000,135000,108000
01SCS19E310515,AR.STY-SC002,20ARSC0201,ALL,1,77350,119000,2,0,23800,1,0,23800,95200,71400
01SCS19E310515,ESH.AR-SE0028,00ARSE0260,M,1,44000,135000,0,0,0,0,0,27000,135000,108000
01SCS19E310516,ESH.AR-SE0006,00ARSE0021,S,1,44000,135000,0,0,0,0,0,27000,135000,108000
01SCS19E310517,BSC.AR-SA0009,00ARSA0035,NON,1,47500,140000,0,0,0,0,0,28000,140000,112000
01SCS19E310517,BSC.AR-SE0049,00ARSE0410,S,1,52000,155000,0,0,0,0,0,31000,155000,124000
01SCS19E310518,AR.MDS-RL006,20ARRL0377,XL,1,117000,180000,2,0,36000,1,0,36000,144000,108000
01SCS19E310519,AR.TUC-SE019,20ARSE0637,L,1,204750,315000,2,0,63000,1,0,63000,252000,189000
01SCS19E310520,BSC.AR-SC0033,00ARSC0226,L,1,125000,315000,0,0,0,0,0,63000,315000,252000
01SCS19E310521,BSC.AR-SD0055,00ARSD0288,NON,1,50000,150000,0,0,0,0,0,30000,150000,120000
01SCS19E310522,BSC.AR-SD0055,00ARSD0288,NON,1,50000,150000,0,0,0,0,0,30000,150000,120000
01SCS19E310523,BSC.AR-SE0002,00ARSE0062,M,1,44000,159000,0,0,0,0,0,31800,159000,127200
01SCS19E310524,AR.ESB-RH005,20ARRH0194,ALL,1,91000,140000,2,0,70000,1,0,17500,70000,52500
01SCS19E310525,AR.MKV-RL004,20ARRL0247,M,1,253500,390000,0,0,0,0,0,136500,390000,253500
01SCS19E310526,AR.HMR-SD003,20ARSD0535,L,1,243750,375000,2,0,75000,1,0,75000,300000,225000
01SCS19E310527,ESH.AR-SD0025,00ARSD0263,M,1,44000,135000,0,0,0,0,0,27000,135000,108000
01SCS19E310528,AR.CPT-SC004,20ARSC0252,S,1,304850,469000,2,0,93800,1,0,93800,375200,281400
01SCS19E310529,ESH.AR-SC0023,00ARSC0166,M,1,125000,315000,0,0,0,0,0,63000,315000,252000
01SCS19E310530,ESH.AR-RL0016,00ARRL0134,M,1,94500,135000,0,0,0,0,0,27000,135000,108000
01SCS19E310530,ESH.AR-SC0020,00ARSC0153,S,1,44000,135000,0,0,0,0,0,27000,135000,108000
01SCS19E310531,BSC.AR-SC0024,00ARSC0179,L,1,125000,315000,0,0,0,0,0,63000,315000,252000
01SCS19E310532,BSC.AR-SE0015,00ARSE0183,S,1,44000,159000,0,0,0,0,0,31800,159000,127200
01SCS19E310533,AR.STY-SE004,20ARSE0122,ALL,1,55250,85000,2,0,17000,1,0,17000,68000,51000
01SCS19E310533,ESH.AR-SD0031,00ARSD0301,L,1,44000,135000,0,0,0,0,0,27000,135000,108000
01SCS19E310533,ESH.AR-SE0012,00ARSE0047,L,1,44500,135000,0,0,0,0,0,27000,135000,108000
01SCS19E310534,AR.TUC-SE013,20ARSE0413,L,1,94250,145000,2,0,29000,1,0,29000,116000,87000
01SCS19E310535,ESH.AR-SC0034,00ARSC0293,M,1,125000,315000,0,0,0,0,0,63000,315000,252000
01SCS19E310536,AR.HMR-SE002,20ARSE0832,L,1,90350,139000,2,0,27800,1,0,27800,111200,83400
01SCS19E310536,AR.HMR-SE007,20ARSE0852,L,1,90350,139000,2,0,27800,1,0,27800,111200,83400
01SCS19E310536,AR.SMD-SD017,20ARSD0579,ALL,1,97500,150000,2,0,30000,1,0,30000,120000,90000
01SCS19E310537,ESH.AR-SE0006,00ARSE0021,S,1,44000,135000,0,0,0,0,0,27000,135000,108000
01SCS19E310537,ESH.AR-SE0028,00ARSE0261,L,1,44000,135000,0,0,0,0,0,27000,135000,108000
01SCS19E310538,ESH.AR-RK0017,00ARRK0193,NON,1,43000,150000,0,0,0,0,0,30000,150000,120000
01SCS19E310539,BSC.AR-SE0025,00ARSE0223,S,1,44500,159000,0,0,0,0,0,31800,159000,127200
01SCS19E310540,ESH.AR-SE0030,00ARSE0267,S,1,125000,315000,0,0,0,0,0,63000,315000,252000
01SCS19E310541,AR.PCT-SE012,20ARSE0673,L,1,87750,135000,2,0,27000,1,0,27000,108000,81000
01SCS19E310541,AR.TUC-SE022,20ARSE0648,M,1,152750,235000,2,0,47000,1,0,47000,188000,141000
01SCS19E310542,AR.CPT-SC006,20ARSC0260,S,1,94250,145000,2,0,29000,1,0,29000,116000,87000
01SCS19E310543,AR.ESB-SE013,20ARSE0770,M,1,91000,140000,2,0,28000,1,0,28000,112000,84000
01SCS19E310544,BSC.AR-SC0014,00ARSC0098,L,1,44000,159000,0,0,0,0,0,31800,159000,127200
01SCS19E310545,BSC.AR-RL0022,00ARRL0142,M,1,94500,135000,0,0,0,0,0,27000,135000,108000
01SCS19E310546,AR.TUC-SA038,20ARSA0270,ALL,1,87750,135000,2,0,27000,1,0,27000,108000,81000
01SCS19E310547,AR.ASH-RJ010,20ARRJ0487,M,1,91000,140000,2,0,42000,1,0,24500,98000,73500
01SCS19E310547,AR.ASH-RK005,20ARRK0519,S,1,227500,350000,2,0,105000,1,0,61250,245000,183750
01SCS19E310548,ESH.AR-RK0017,00ARRK0193,NON,1,43000,150000,1,0,30000,1,0,24000,120000,96000